"date","city","district","official","personal","commercial","total","formatted_date","year"
"15-Dec",서울,계,11146,2849525,195917,3056588,"2015-12-01",2015
"15-Dec",서울,강남구,345,223960,20482,244787,"2015-12-01",2015
"15-Dec",서울,강동구,215,128966,8481,137662,"2015-12-01",2015
"15-Dec",서울,강북구,280,70638,4842,75760,"2015-12-01",2015
"15-Dec",서울,강서구,293,176167,14612,191072,"2015-12-01",2015
"15-Dec",서울,관악구,255,114745,5789,120789,"2015-12-01",2015
"15-Dec",서울,광진구,267,90449,5376,96092,"2015-12-01",2015
"15-Dec",서울,구로구,214,127055,11003,138272,"2015-12-01",2015
"15-Dec",서울,금천구,121,74691,7872,82684,"2015-12-01",2015
"15-Dec",서울,노원구,249,144649,9747,154645,"2015-12-01",2015
"15-Dec",서울,도봉구,232,87888,7731,95851,"2015-12-01",2015
"15-Dec",서울,동대문구,264,90407,5936,96607,"2015-12-01",2015
"15-Dec",서울,동작구,266,99029,2772,102067,"2015-12-01",2015
"15-Dec",서울,마포구,273,109135,7507,116915,"2015-12-01",2015
"15-Dec",서울,서대문구,404,76900,5023,82327,"2015-12-01",2015
"15-Dec",서울,서초구,624,167845,10378,178847,"2015-12-01",2015
"15-Dec",서울,성동구,265,87847,7655,95767,"2015-12-01",2015
"15-Dec",서울,성북구,219,110867,5458,116544,"2015-12-01",2015
"15-Dec",서울,송파구,332,207009,11601,218942,"2015-12-01",2015
"15-Dec",서울,양천구,296,140201,9224,149721,"2015-12-01",2015
"15-Dec",서울,영등포구,299,135343,10136,145778,"2015-12-01",2015
"15-Dec",서울,용산구,344,73674,2060,76078,"2015-12-01",2015
"15-Dec",서울,은평구,223,119306,6953,126482,"2015-12-01",2015
"15-Dec",서울,종로구,3682,44574,1561,49817,"2015-12-01",2015
"15-Dec",서울,중구,997,47702,4289,52988,"2015-12-01",2015
"15-Dec",서울,중랑구,187,100478,9429,110094,"2015-12-01",2015
"15-Dec",부산,계,4216,1171930,79576,1255722,"2015-12-01",2015
"15-Dec",부산,강서구,289,51594,3468,55351,"2015-12-01",2015
"15-Dec",부산,금정구,272,77740,7486,85498,"2015-12-01",2015
"15-Dec",부산,기장군,202,61521,2093,63816,"2015-12-01",2015
"15-Dec",부산,남구,207,85753,8813,94773,"2015-12-01",2015
"15-Dec",부산,동구,221,23587,6315,30123,"2015-12-01",2015
"15-Dec",부산,동래구,166,84109,4160,88435,"2015-12-01",2015
"15-Dec",부산,부산진구,373,123237,6179,129789,"2015-12-01",2015
"15-Dec",부산,북구,206,97650,3837,101693,"2015-12-01",2015
"15-Dec",부산,사상구,253,84345,6177,90775,"2015-12-01",2015
"15-Dec",부산,사하구,235,104770,7393,112398,"2015-12-01",2015
"15-Dec",부산,서구,127,27352,1344,28823,"2015-12-01",2015
"15-Dec",부산,수영구,142,59280,2933,62355,"2015-12-01",2015
"15-Dec",부산,연제구,770,92530,5116,98416,"2015-12-01",2015
"15-Dec",부산,영도구,205,31460,2676,34341,"2015-12-01",2015
"15-Dec",부산,중구,302,15207,6165,21674,"2015-12-01",2015
"15-Dec",부산,해운대구,246,151795,5421,157462,"2015-12-01",2015
"15-Dec",대구,계,2728,1054536,48738,1106002,"2015-12-01",2015
"15-Dec",대구,남구,180,56523,2086,58789,"2015-12-01",2015
"15-Dec",대구,달서구,409,246499,12186,259094,"2015-12-01",2015
"15-Dec",대구,달성군,380,88707,3359,92446,"2015-12-01",2015
"15-Dec",대구,동구,294,140030,11188,151512,"2015-12-01",2015
"15-Dec",대구,북구,423,181335,8337,190095,"2015-12-01",2015
"15-Dec",대구,서구,191,76442,4375,81008,"2015-12-01",2015
"15-Dec",대구,수성구,481,202719,5212,208412,"2015-12-01",2015
"15-Dec",대구,중구,370,62281,1995,64646,"2015-12-01",2015
"15-Dec",인천,계,3355,1119203,232649,1355207,"2015-12-01",2015
"15-Dec",인천,강화군,278,28841,2410,31529,"2015-12-01",2015
"15-Dec",인천,계양구,234,117514,111638,229386,"2015-12-01",2015
"15-Dec",인천,남구,360,131644,49674,181678,"2015-12-01",2015
"15-Dec",인천,남동구,759,233781,23893,258433,"2015-12-01",2015
"15-Dec",인천,동구,80,25351,2521,27952,"2015-12-01",2015
"15-Dec",인천,부평구,309,191876,8890,201075,"2015-12-01",2015
"15-Dec",인천,서구,342,195920,10597,206859,"2015-12-01",2015
"15-Dec",인천,연수구,280,135054,7169,142503,"2015-12-01",2015
"15-Dec",인천,옹진군,162,10120,165,10447,"2015-12-01",2015
"15-Dec",인천,중구,551,49102,15692,65345,"2015-12-01",2015
"15-Dec",광주,계,1905,576225,33150,611280,"2015-12-01",2015
"15-Dec",광주,광산구,478,164753,9964,175195,"2015-12-01",2015
"15-Dec",광주,남구,161,80397,3353,83911,"2015-12-01",2015
"15-Dec",광주,동구,203,34508,1173,35884,"2015-12-01",2015
"15-Dec",광주,북구,431,169319,9119,178869,"2015-12-01",2015
"15-Dec",광주,서구,632,127248,9541,137421,"2015-12-01",2015
"15-Dec",대전,계,1689,603470,27795,632954,"2015-12-01",2015
"15-Dec",대전,대덕구,256,84392,6448,91096,"2015-12-01",2015
"15-Dec",대전,동구,156,85478,4496,90130,"2015-12-01",2015
"15-Dec",대전,서구,705,190452,6680,197837,"2015-12-01",2015
"15-Dec",대전,유성구,356,149035,4338,153729,"2015-12-01",2015
"15-Dec",대전,중구,216,94113,5833,100162,"2015-12-01",2015
"15-Dec",울산,계,1470,502603,21019,525092,"2015-12-01",2015
"15-Dec",울산,남구,596,147850,7479,155925,"2015-12-01",2015
"15-Dec",울산,동구,183,61451,899,62533,"2015-12-01",2015
"15-Dec",울산,북구,110,87518,4354,91982,"2015-12-01",2015
"15-Dec",울산,울주군,283,105547,5613,111443,"2015-12-01",2015
"15-Dec",울산,중구,298,100237,2674,103209,"2015-12-01",2015
"15-Dec",세종,계,549,90349,2242,93140,"2015-12-01",2015
"15-Dec",세종,세종특별자치시,549,90349,2242,93140,"2015-12-01",2015
"15-Dec",경기,계,14206,4687698,215187,4917091,"2015-12-01",2015
"15-Dec",경기,가평군,318,26040,705,27063,"2015-12-01",2015
"15-Dec",경기,고양시 덕양구,562,145828,3526,149916,"2015-12-01",2015
"15-Dec",경기,고양시 일산동구,256,106199,6248,112703,"2015-12-01",2015
"15-Dec",경기,고양시 일산서구,71,102533,3181,105785,"2015-12-01",2015
"15-Dec",경기,과천시,672,22067,573,23312,"2015-12-01",2015
"15-Dec",경기,광명시,268,100784,4346,105398,"2015-12-01",2015
"15-Dec",경기,광주시,329,143293,7532,151154,"2015-12-01",2015
"15-Dec",경기,구리시,197,58892,2318,61407,"2015-12-01",2015
"15-Dec",경기,군포시,232,91435,4729,96396,"2015-12-01",2015
"15-Dec",경기,김포시,367,145622,5916,151905,"2015-12-01",2015
"15-Dec",경기,남양주시,514,237226,6878,244618,"2015-12-01",2015
"15-Dec",경기,동두천시,187,34284,1190,35661,"2015-12-01",2015
"15-Dec",경기,부천시 소사구,81,65536,2847,68464,"2015-12-01",2015
"15-Dec",경기,부천시 오정구,115,60925,2369,63409,"2015-12-01",2015
"15-Dec",경기,부천시 원미구,436,144538,6058,151032,"2015-12-01",2015
"15-Dec",경기,성남시 분당구,312,177443,5710,183465,"2015-12-01",2015
"15-Dec",경기,성남시 수정구,233,59371,2327,61931,"2015-12-01",2015
"15-Dec",경기,성남시 중원구,245,72902,3967,77114,"2015-12-01",2015
"15-Dec",경기,수원시 권선구,305,146940,7091,154336,"2015-12-01",2015
"15-Dec",경기,수원시 영통구,199,120342,2681,123222,"2015-12-01",2015
"15-Dec",경기,수원시 장안구,485,101586,3663,105734,"2015-12-01",2015
"15-Dec",경기,수원시 팔달구,496,67910,3452,71858,"2015-12-01",2015
"15-Dec",경기,시흥시,399,172611,7119,180129,"2015-12-01",2015
"15-Dec",경기,안산시 단원구,486,138571,8141,147198,"2015-12-01",2015
"15-Dec",경기,안산시 상록구,154,132412,4481,137047,"2015-12-01",2015
"15-Dec",경기,안성시,309,84721,4900,89930,"2015-12-01",2015
"15-Dec",경기,안양시 동안구,365,116355,6408,123128,"2015-12-01",2015
"15-Dec",경기,안양시 만안구,129,76396,3851,80376,"2015-12-01",2015
"15-Dec",경기,양주시,301,82060,2907,85268,"2015-12-01",2015
"15-Dec",경기,양평군,447,48099,1550,50096,"2015-12-01",2015
"15-Dec",경기,여주시,319,54193,7119,61631,"2015-12-01",2015
"15-Dec",경기,연천군,258,20289,5682,26229,"2015-12-01",2015
"15-Dec",경기,오산시,195,80742,2889,83826,"2015-12-01",2015
"15-Dec",경기,용인시 기흥구,117,156911,8092,165120,"2015-12-01",2015
"15-Dec",경기,용인시 수지구,40,122865,1712,124617,"2015-12-01",2015
"15-Dec",경기,용인시 처인구,568,98930,6482,105980,"2015-12-01",2015
"15-Dec",경기,의왕시,249,54774,2834,57857,"2015-12-01",2015
"15-Dec",경기,의정부시,499,133039,4723,138261,"2015-12-01",2015
"15-Dec",경기,이천시,339,92132,5702,98173,"2015-12-01",2015
"15-Dec",경기,파주시,337,169325,10121,179783,"2015-12-01",2015
"15-Dec",경기,평택시,560,205002,9950,215512,"2015-12-01",2015
"15-Dec",경기,포천시,306,75422,10623,86351,"2015-12-01",2015
"15-Dec",경기,하남시,289,63887,2062,66238,"2015-12-01",2015
"15-Dec",경기,화성시,660,277266,10532,288458,"2015-12-01",2015
"15-Dec",강원,계,4880,664757,24403,694040,"2015-12-01",2015
"15-Dec",강원,강릉시,464,93778,4190,98432,"2015-12-01",2015
"15-Dec",강원,고성군,136,12512,248,12896,"2015-12-01",2015
"15-Dec",강원,동해시,263,39531,1338,41132,"2015-12-01",2015
"15-Dec",강원,삼척시,312,28427,697,29436,"2015-12-01",2015
"15-Dec",강원,속초시,269,32014,1267,33550,"2015-12-01",2015
"15-Dec",강원,양구군,123,10430,127,10680,"2015-12-01",2015
"15-Dec",강원,양양군,128,12844,246,13218,"2015-12-01",2015
"15-Dec",강원,영월군,286,18420,386,19092,"2015-12-01",2015
"15-Dec",강원,원주시,488,140616,5751,146855,"2015-12-01",2015
"15-Dec",강원,인제군,179,15729,226,16134,"2015-12-01",2015
"15-Dec",강원,정선군,262,18361,464,19087,"2015-12-01",2015
"15-Dec",강원,철원군,175,21369,315,21859,"2015-12-01",2015
"15-Dec",강원,춘천시,664,112550,5878,119092,"2015-12-01",2015
"15-Dec",강원,태백시,189,19438,865,20492,"2015-12-01",2015
"15-Dec",강원,평창군,253,22990,341,23584,"2015-12-01",2015
"15-Dec",강원,홍천군,315,32972,1103,34390,"2015-12-01",2015
"15-Dec",강원,화천군,165,11011,130,11306,"2015-12-01",2015
"15-Dec",강원,횡성군,209,21765,831,22805,"2015-12-01",2015
"15-Dec",충북,계,3287,694910,31872,730069,"2015-12-01",2015
"15-Dec",충북,괴산군,159,19481,308,19948,"2015-12-01",2015
"15-Dec",충북,단양군,151,13916,821,14888,"2015-12-01",2015
"15-Dec",충북,보은군,180,15751,931,16862,"2015-12-01",2015
"15-Dec",충북,영동군,197,22474,366,23037,"2015-12-01",2015
"15-Dec",충북,옥천군,169,23280,985,24434,"2015-12-01",2015
"15-Dec",충북,음성군,178,50105,1609,51892,"2015-12-01",2015
"15-Dec",충북,제천시,300,59116,3214,62630,"2015-12-01",2015
"15-Dec",충북,증평군,74,15974,748,16796,"2015-12-01",2015
"15-Dec",충북,진천군,175,34516,1067,35758,"2015-12-01",2015
"15-Dec",충북,청원군,1,42,1,44,"2015-12-01",2015
"15-Dec",충북,청주시 상당구,404,71438,2739,74581,"2015-12-01",2015
"15-Dec",충북,청주시 서원구,209,88487,5795,94491,"2015-12-01",2015
"15-Dec",충북,청주시 청원구,276,83090,3789,87155,"2015-12-01",2015
"15-Dec",충북,청주시 흥덕구,321,105224,5942,111487,"2015-12-01",2015
"15-Dec",충북,충주시,493,92016,3557,96066,"2015-12-01",2015
"15-Dec",충남,계,4623,925743,38796,969162,"2015-12-01",2015
"15-Dec",충남,계룡시,123,18357,448,18928,"2015-12-01",2015
"15-Dec",충남,공주시,495,48649,2063,51207,"2015-12-01",2015
"15-Dec",충남,금산군,155,25526,2539,28220,"2015-12-01",2015
"15-Dec",충남,논산시,318,54551,2123,56992,"2015-12-01",2015
"15-Dec",충남,당진시,320,79869,3582,83771,"2015-12-01",2015
"15-Dec",충남,보령시,312,46276,1251,47839,"2015-12-01",2015
"15-Dec",충남,부여군,223,30991,1361,32575,"2015-12-01",2015
"15-Dec",충남,서산시,358,77665,3416,81439,"2015-12-01",2015
"15-Dec",충남,서천군,195,24893,973,26061,"2015-12-01",2015
"15-Dec",충남,아산시,333,133345,6397,140075,"2015-12-01",2015
"15-Dec",충남,예산군,317,38674,1396,40387,"2015-12-01",2015
"15-Dec",충남,천안시 동남구,230,113313,5940,119483,"2015-12-01",2015
"15-Dec",충남,천안시 서북구,481,146961,4782,152224,"2015-12-01",2015
"15-Dec",충남,청양군,200,14706,808,15714,"2015-12-01",2015
"15-Dec",충남,태안군,215,29313,491,30019,"2015-12-01",2015
"15-Dec",충남,홍성군,348,42654,1226,44228,"2015-12-01",2015
"15-Dec",전북,계,4205,797990,36986,839181,"2015-12-01",2015
"15-Dec",전북,고창군,213,27320,519,28052,"2015-12-01",2015
"15-Dec",전북,군산시,415,117192,6759,124366,"2015-12-01",2015
"15-Dec",전북,김제시,242,40628,1868,42738,"2015-12-01",2015
"15-Dec",전북,남원시,363,35848,2608,38819,"2015-12-01",2015
"15-Dec",전북,무주군,151,11238,366,11755,"2015-12-01",2015
"15-Dec",전북,부안군,218,24984,610,25812,"2015-12-01",2015
"15-Dec",전북,순창군,178,12949,224,13351,"2015-12-01",2015
"15-Dec",전북,완주군,278,45042,3556,48876,"2015-12-01",2015
"15-Dec",전북,익산시,426,125661,6020,132107,"2015-12-01",2015
"15-Dec",전북,임실군,167,12756,410,13333,"2015-12-01",2015
"15-Dec",전북,장수군,181,10536,164,10881,"2015-12-01",2015
"15-Dec",전북,전주시 덕진구,348,132191,7435,139974,"2015-12-01",2015
"15-Dec",전북,전주시 완산구,551,141365,3926,145842,"2015-12-01",2015
"15-Dec",전북,정읍시,272,48110,2332,50714,"2015-12-01",2015
"15-Dec",전북,진안군,202,12170,189,12561,"2015-12-01",2015
"15-Dec",전남,계,5205,809187,83263,897655,"2015-12-01",2015
"15-Dec",전남,강진군,180,16595,995,17770,"2015-12-01",2015
"15-Dec",전남,고흥군,224,27216,705,28145,"2015-12-01",2015
"15-Dec",전남,곡성군,138,13038,840,14016,"2015-12-01",2015
"15-Dec",전남,광양시,227,70469,5867,76563,"2015-12-01",2015
"15-Dec",전남,구례군,99,11531,676,12306,"2015-12-01",2015
"15-Dec",전남,나주시,356,46906,3129,50391,"2015-12-01",2015
"15-Dec",전남,담양군,173,22970,1652,24795,"2015-12-01",2015
"15-Dec",전남,목포시,425,87272,5803,93500,"2015-12-01",2015
"15-Dec",전남,무안군,432,36549,909,37890,"2015-12-01",2015
"15-Dec",전남,보성군,201,19313,23072,42586,"2015-12-01",2015
"15-Dec",전남,순천시,429,116136,4685,121250,"2015-12-01",2015
"15-Dec",전남,신안군,180,17929,667,18776,"2015-12-01",2015
"15-Dec",전남,여수시,473,113800,6368,120641,"2015-12-01",2015
"15-Dec",전남,영광군,203,24254,738,25195,"2015-12-01",2015
"15-Dec",전남,영암군,211,29946,21523,51680,"2015-12-01",2015
"15-Dec",전남,완도군,197,21488,497,22182,"2015-12-01",2015
"15-Dec",전남,장성군,131,22225,1272,23628,"2015-12-01",2015
"15-Dec",전남,장흥군,169,18416,436,19021,"2015-12-01",2015
"15-Dec",전남,진도군,139,14439,289,14867,"2015-12-01",2015
"15-Dec",전남,함평군,146,15676,391,16213,"2015-12-01",2015
"15-Dec",전남,해남군,277,34544,583,35404,"2015-12-01",2015
"15-Dec",전남,화순군,195,28475,2166,30836,"2015-12-01",2015
"15-Dec",경북,계,6172,1252782,48541,1307495,"2015-12-01",2015
"15-Dec",경북,경산시,412,118728,4087,123227,"2015-12-01",2015
"15-Dec",경북,경주시,488,124736,5005,130229,"2015-12-01",2015
"15-Dec",경북,고령군,139,19253,432,19824,"2015-12-01",2015
"15-Dec",경북,구미시,432,186962,7613,195007,"2015-12-01",2015
"15-Dec",경북,군위군,104,12662,285,13051,"2015-12-01",2015
"15-Dec",경북,김천시,291,63232,1720,65243,"2015-12-01",2015
"15-Dec",경북,문경시,246,32411,909,33566,"2015-12-01",2015
"15-Dec",경북,봉화군,171,15610,206,15987,"2015-12-01",2015
"15-Dec",경북,상주시,332,46850,1796,48978,"2015-12-01",2015
"15-Dec",경북,성주군,167,26697,1489,28353,"2015-12-01",2015
"15-Dec",경북,안동시,450,74450,2587,77487,"2015-12-01",2015
"15-Dec",경북,영덕군,204,16946,308,17458,"2015-12-01",2015
"15-Dec",경북,영양군,121,8382,108,8611,"2015-12-01",2015
"15-Dec",경북,영주시,300,50701,1654,52655,"2015-12-01",2015
"15-Dec",경북,영천시,228,50997,2541,53766,"2015-12-01",2015
"15-Dec",경북,예천군,169,20233,413,20815,"2015-12-01",2015
"15-Dec",경북,울릉군,129,4448,332,4909,"2015-12-01",2015
"15-Dec",경북,울진군,228,23137,396,23761,"2015-12-01",2015
"15-Dec",경북,의성군,270,26496,1014,27780,"2015-12-01",2015
"15-Dec",경북,청도군,141,21850,643,22634,"2015-12-01",2015
"15-Dec",경북,청송군,182,13483,211,13876,"2015-12-01",2015
"15-Dec",경북,칠곡군,320,62582,1929,64831,"2015-12-01",2015
"15-Dec",경북,포항시 남구,342,112249,8939,121530,"2015-12-01",2015
"15-Dec",경북,포항시 북구,306,119687,3924,123917,"2015-12-01",2015
"15-Dec",경남,계,6076,1482942,75174,1564192,"2015-12-01",2015
"15-Dec",경남,거제시,264,99952,2761,102977,"2015-12-01",2015
"15-Dec",경남,거창군,226,27761,771,28758,"2015-12-01",2015
"15-Dec",경남,고성군,196,24227,703,25126,"2015-12-01",2015
"15-Dec",경남,김해시,558,235342,6487,242387,"2015-12-01",2015
"15-Dec",경남,남해군,195,17189,528,17912,"2015-12-01",2015
"15-Dec",경남,밀양시,278,49424,4320,54022,"2015-12-01",2015
"15-Dec",경남,사천시,264,49533,1568,51365,"2015-12-01",2015
"15-Dec",경남,산청군,173,17068,841,18082,"2015-12-01",2015
"15-Dec",경남,양산시,341,124971,8518,133830,"2015-12-01",2015
"15-Dec",경남,의령군,157,12487,914,13558,"2015-12-01",2015
"15-Dec",경남,진주시,545,142721,6715,149981,"2015-12-01",2015
"15-Dec",경남,창녕군,185,31168,798,32151,"2015-12-01",2015
"15-Dec",경남,창원시 마산합포구,314,85100,3059,88473,"2015-12-01",2015
"15-Dec",경남,창원시 마산회원구,167,96983,5339,102489,"2015-12-01",2015
"15-Dec",경남,창원시 성산구,139,120107,13381,133627,"2015-12-01",2015
"15-Dec",경남,창원시 의창구,845,120399,4776,126020,"2015-12-01",2015
"15-Dec",경남,창원시 진해구,185,75785,1566,77536,"2015-12-01",2015
"15-Dec",경남,통영시,286,49601,1593,51480,"2015-12-01",2015
"15-Dec",경남,하동군,198,22309,447,22954,"2015-12-01",2015
"15-Dec",경남,함안군,165,40787,8374,49326,"2015-12-01",2015
"15-Dec",경남,함양군,172,19293,765,20230,"2015-12-01",2015
"15-Dec",경남,합천군,223,20735,950,21908,"2015-12-01",2015
"15-Dec",제주,계,1845,338719,94451,435015,"2015-12-01",2015
"15-Dec",제주,서귀포시,604,83461,2166,86231,"2015-12-01",2015
"15-Dec",제주,제주시,1241,255258,92285,348784,"2015-12-01",2015
"16-Jan",서울,계,11140,2856048,196059,3063247,"2016-01-01",2016
"16-Jan",서울,강남구,342,224024,20559,244925,"2016-01-01",2016
"16-Jan",서울,강동구,217,129217,8474,137908,"2016-01-01",2016
"16-Jan",서울,강북구,279,70702,4848,75829,"2016-01-01",2016
"16-Jan",서울,강서구,293,176414,14693,191400,"2016-01-01",2016
"16-Jan",서울,관악구,255,115109,5797,121161,"2016-01-01",2016
"16-Jan",서울,광진구,264,90772,5344,96380,"2016-01-01",2016
"16-Jan",서울,구로구,216,127485,10773,138474,"2016-01-01",2016
"16-Jan",서울,금천구,121,75050,7849,83020,"2016-01-01",2016
"16-Jan",서울,노원구,250,144851,9765,154866,"2016-01-01",2016
"16-Jan",서울,도봉구,231,88249,7748,96228,"2016-01-01",2016
"16-Jan",서울,동대문구,265,90717,5848,96830,"2016-01-01",2016
"16-Jan",서울,동작구,268,99286,2782,102336,"2016-01-01",2016
"16-Jan",서울,마포구,271,109240,7508,117019,"2016-01-01",2016
"16-Jan",서울,서대문구,408,77517,5010,82935,"2016-01-01",2016
"16-Jan",서울,서초구,623,168030,10337,178990,"2016-01-01",2016
"16-Jan",서울,성동구,263,87835,7976,96074,"2016-01-01",2016
"16-Jan",서울,성북구,218,111099,5485,116802,"2016-01-01",2016
"16-Jan",서울,송파구,333,207313,11600,219246,"2016-01-01",2016
"16-Jan",서울,양천구,296,140634,9251,150181,"2016-01-01",2016
"16-Jan",서울,영등포구,299,135770,10148,146217,"2016-01-01",2016
"16-Jan",서울,용산구,344,73874,2042,76260,"2016-01-01",2016
"16-Jan",서울,은평구,220,119607,6952,126779,"2016-01-01",2016
"16-Jan",서울,종로구,3686,44766,1587,50039,"2016-01-01",2016
"16-Jan",서울,중구,992,47658,4235,52885,"2016-01-01",2016
"16-Jan",서울,중랑구,186,100829,9448,110463,"2016-01-01",2016
"16-Jan",부산,계,4216,1175567,79729,1259512,"2016-01-01",2016
"16-Jan",부산,강서구,287,52494,3519,56300,"2016-01-01",2016
"16-Jan",부산,금정구,271,77844,7510,85625,"2016-01-01",2016
"16-Jan",부산,기장군,202,61857,2100,64159,"2016-01-01",2016
"16-Jan",부산,남구,209,85844,8852,94905,"2016-01-01",2016
"16-Jan",부산,동구,221,23603,6297,30121,"2016-01-01",2016
"16-Jan",부산,동래구,166,84704,4223,89093,"2016-01-01",2016
"16-Jan",부산,부산진구,373,122826,6118,129317,"2016-01-01",2016
"16-Jan",부산,북구,206,98273,3835,102314,"2016-01-01",2016
"16-Jan",부산,사상구,250,84298,6219,90767,"2016-01-01",2016
"16-Jan",부산,사하구,235,104792,7374,112401,"2016-01-01",2016
"16-Jan",부산,서구,128,27451,1319,28898,"2016-01-01",2016
"16-Jan",부산,수영구,141,59485,2943,62569,"2016-01-01",2016
"16-Jan",부산,연제구,773,93347,5142,99262,"2016-01-01",2016
"16-Jan",부산,영도구,205,31500,2662,34367,"2016-01-01",2016
"16-Jan",부산,중구,302,14870,6163,21335,"2016-01-01",2016
"16-Jan",부산,해운대구,247,152379,5453,158079,"2016-01-01",2016
"16-Jan",대구,계,2732,1056908,48815,1108455,"2016-01-01",2016
"16-Jan",대구,남구,180,56660,2095,58935,"2016-01-01",2016
"16-Jan",대구,달서구,409,247408,12150,259967,"2016-01-01",2016
"16-Jan",대구,달성군,383,89438,3385,93206,"2016-01-01",2016
"16-Jan",대구,동구,293,140434,11233,151960,"2016-01-01",2016
"16-Jan",대구,북구,424,181555,8350,190329,"2016-01-01",2016
"16-Jan",대구,서구,192,76406,4382,80980,"2016-01-01",2016
"16-Jan",대구,수성구,481,202714,5274,208469,"2016-01-01",2016
"16-Jan",대구,중구,370,62293,1946,64609,"2016-01-01",2016
"16-Jan",인천,계,3372,1126969,234160,1364501,"2016-01-01",2016
"16-Jan",인천,강화군,285,28967,2385,31637,"2016-01-01",2016
"16-Jan",인천,계양구,233,118137,113533,231903,"2016-01-01",2016
"16-Jan",인천,남구,362,132297,49243,181902,"2016-01-01",2016
"16-Jan",인천,남동구,774,236012,25083,261869,"2016-01-01",2016
"16-Jan",인천,동구,81,25318,2508,27907,"2016-01-01",2016
"16-Jan",인천,부평구,309,193788,7772,201869,"2016-01-01",2016
"16-Jan",인천,서구,338,196968,10631,207937,"2016-01-01",2016
"16-Jan",인천,연수구,279,136020,7016,143315,"2016-01-01",2016
"16-Jan",인천,옹진군,162,10172,163,10497,"2016-01-01",2016
"16-Jan",인천,중구,549,49290,15826,65665,"2016-01-01",2016
"16-Jan",광주,계,1909,578478,33165,613552,"2016-01-01",2016
"16-Jan",광주,광산구,479,165727,9904,176110,"2016-01-01",2016
"16-Jan",광주,남구,161,80792,3343,84296,"2016-01-01",2016
"16-Jan",광주,동구,207,34549,1169,35925,"2016-01-01",2016
"16-Jan",광주,북구,432,170061,9183,179676,"2016-01-01",2016
"16-Jan",광주,서구,630,127349,9566,137545,"2016-01-01",2016
"16-Jan",대전,계,1692,604933,27840,634465,"2016-01-01",2016
"16-Jan",대전,대덕구,256,84396,6474,91126,"2016-01-01",2016
"16-Jan",대전,동구,155,85619,4490,90264,"2016-01-01",2016
"16-Jan",대전,서구,704,190866,6611,198181,"2016-01-01",2016
"16-Jan",대전,유성구,361,149709,4451,154521,"2016-01-01",2016
"16-Jan",대전,중구,216,94343,5814,100373,"2016-01-01",2016
"16-Jan",울산,계,1472,504935,21042,527449,"2016-01-01",2016
"16-Jan",울산,남구,596,148362,7473,156431,"2016-01-01",2016
"16-Jan",울산,동구,183,61894,892,62969,"2016-01-01",2016
"16-Jan",울산,북구,110,87852,4366,92328,"2016-01-01",2016
"16-Jan",울산,울주군,282,105994,5647,111923,"2016-01-01",2016
"16-Jan",울산,중구,301,100833,2664,103798,"2016-01-01",2016
"16-Jan",세종,계,550,92635,2255,95440,"2016-01-01",2016
"16-Jan",세종,세종특별자치시,550,92635,2255,95440,"2016-01-01",2016
"16-Jan",경기,계,14089,4713197,216596,4943882,"2016-01-01",2016
"16-Jan",경기,가평군,316,26192,705,27213,"2016-01-01",2016
"16-Jan",경기,고양시 덕양구,559,146689,3518,150766,"2016-01-01",2016
"16-Jan",경기,고양시 일산동구,254,106702,6688,113644,"2016-01-01",2016
"16-Jan",경기,고양시 일산서구,71,102827,3195,106093,"2016-01-01",2016
"16-Jan",경기,과천시,671,22123,578,23372,"2016-01-01",2016
"16-Jan",경기,광명시,265,101063,4342,105670,"2016-01-01",2016
"16-Jan",경기,광주시,326,144233,7573,152132,"2016-01-01",2016
"16-Jan",경기,구리시,194,59152,2332,61678,"2016-01-01",2016
"16-Jan",경기,군포시,232,91837,4695,96764,"2016-01-01",2016
"16-Jan",경기,김포시,365,146692,5938,152995,"2016-01-01",2016
"16-Jan",경기,남양주시,506,239267,6870,246643,"2016-01-01",2016
"16-Jan",경기,동두천시,186,34483,1192,35861,"2016-01-01",2016
"16-Jan",경기,부천시 소사구,79,65728,2858,68665,"2016-01-01",2016
"16-Jan",경기,부천시 오정구,112,61251,2367,63730,"2016-01-01",2016
"16-Jan",경기,부천시 원미구,434,144993,6334,151761,"2016-01-01",2016
"16-Jan",경기,성남시 분당구,311,178115,5693,184119,"2016-01-01",2016
"16-Jan",경기,성남시 수정구,231,60034,2340,62605,"2016-01-01",2016
"16-Jan",경기,성남시 중원구,243,73330,3969,77542,"2016-01-01",2016
"16-Jan",경기,수원시 권선구,301,147090,7066,154457,"2016-01-01",2016
"16-Jan",경기,수원시 영통구,199,120827,2673,123699,"2016-01-01",2016
"16-Jan",경기,수원시 장안구,477,101758,3659,105894,"2016-01-01",2016
"16-Jan",경기,수원시 팔달구,490,68438,3448,72376,"2016-01-01",2016
"16-Jan",경기,시흥시,403,173497,7154,181054,"2016-01-01",2016
"16-Jan",경기,안산시 단원구,484,138640,8112,147236,"2016-01-01",2016
"16-Jan",경기,안산시 상록구,153,133080,4500,137733,"2016-01-01",2016
"16-Jan",경기,안성시,309,84955,4903,90167,"2016-01-01",2016
"16-Jan",경기,안양시 동안구,363,116786,6412,123561,"2016-01-01",2016
"16-Jan",경기,안양시 만안구,107,76797,3866,80770,"2016-01-01",2016
"16-Jan",경기,양주시,303,82677,2886,85866,"2016-01-01",2016
"16-Jan",경기,양평군,442,48288,1564,50294,"2016-01-01",2016
"16-Jan",경기,여주시,318,54563,7123,62004,"2016-01-01",2016
"16-Jan",경기,연천군,254,20459,5698,26411,"2016-01-01",2016
"16-Jan",경기,오산시,193,81022,2892,84107,"2016-01-01",2016
"16-Jan",경기,용인시 기흥구,113,157141,8728,165982,"2016-01-01",2016
"16-Jan",경기,용인시 수지구,40,123343,1712,125095,"2016-01-01",2016
"16-Jan",경기,용인시 처인구,564,99391,6524,106479,"2016-01-01",2016
"16-Jan",경기,의왕시,248,55021,2837,58106,"2016-01-01",2016
"16-Jan",경기,의정부시,487,133392,4740,138619,"2016-01-01",2016
"16-Jan",경기,이천시,334,92684,5715,98733,"2016-01-01",2016
"16-Jan",경기,파주시,335,170704,10145,181184,"2016-01-01",2016
"16-Jan",경기,평택시,557,206563,9962,217082,"2016-01-01",2016
"16-Jan",경기,포천시,312,75711,10531,86554,"2016-01-01",2016
"16-Jan",경기,하남시,286,64860,2066,67212,"2016-01-01",2016
"16-Jan",경기,화성시,662,280799,10493,291954,"2016-01-01",2016
"16-Jan",강원,계,4872,668015,24364,697251,"2016-01-01",2016
"16-Jan",강원,강릉시,463,94155,4175,98793,"2016-01-01",2016
"16-Jan",강원,고성군,136,12430,247,12813,"2016-01-01",2016
"16-Jan",강원,동해시,260,39670,1334,41264,"2016-01-01",2016
"16-Jan",강원,삼척시,312,28509,697,29518,"2016-01-01",2016
"16-Jan",강원,속초시,267,32133,1259,33659,"2016-01-01",2016
"16-Jan",강원,양구군,122,10467,127,10716,"2016-01-01",2016
"16-Jan",강원,양양군,129,12873,249,13251,"2016-01-01",2016
"16-Jan",강원,영월군,286,18488,392,19166,"2016-01-01",2016
"16-Jan",강원,원주시,488,141935,5725,148148,"2016-01-01",2016
"16-Jan",강원,인제군,179,15778,223,16180,"2016-01-01",2016
"16-Jan",강원,정선군,265,18420,468,19153,"2016-01-01",2016
"16-Jan",강원,철원군,175,21452,313,21940,"2016-01-01",2016
"16-Jan",강원,춘천시,663,113205,5873,119741,"2016-01-01",2016
"16-Jan",강원,태백시,188,19482,862,20532,"2016-01-01",2016
"16-Jan",강원,평창군,253,22990,351,23594,"2016-01-01",2016
"16-Jan",강원,홍천군,314,33092,1099,34505,"2016-01-01",2016
"16-Jan",강원,화천군,163,11067,131,11361,"2016-01-01",2016
"16-Jan",강원,횡성군,209,21869,839,22917,"2016-01-01",2016
"16-Jan",충북,계,3297,698142,31926,733365,"2016-01-01",2016
"16-Jan",충북,괴산군,159,19480,300,19939,"2016-01-01",2016
"16-Jan",충북,단양군,151,13959,822,14932,"2016-01-01",2016
"16-Jan",충북,보은군,180,15810,932,16922,"2016-01-01",2016
"16-Jan",충북,영동군,197,22541,367,23105,"2016-01-01",2016
"16-Jan",충북,옥천군,169,23366,1021,24556,"2016-01-01",2016
"16-Jan",충북,음성군,178,50553,1621,52352,"2016-01-01",2016
"16-Jan",충북,제천시,294,59316,3233,62843,"2016-01-01",2016
"16-Jan",충북,증평군,74,16121,750,16945,"2016-01-01",2016
"16-Jan",충북,진천군,174,34831,1066,36071,"2016-01-01",2016
"16-Jan",충북,청원군,1,41,1,43,"2016-01-01",2016
"16-Jan",충북,청주시 상당구,404,71566,2727,74697,"2016-01-01",2016
"16-Jan",충북,청주시 서원구,226,88636,5842,94704,"2016-01-01",2016
"16-Jan",충북,청주시 청원구,275,83802,3712,87789,"2016-01-01",2016
"16-Jan",충북,청주시 흥덕구,322,105668,5971,111961,"2016-01-01",2016
"16-Jan",충북,충주시,493,92452,3561,96506,"2016-01-01",2016
"16-Jan",충남,계,4599,930527,38785,973911,"2016-01-01",2016
"16-Jan",충남,계룡시,123,18502,464,19089,"2016-01-01",2016
"16-Jan",충남,공주시,491,48769,2074,51334,"2016-01-01",2016
"16-Jan",충남,금산군,154,25674,2512,28340,"2016-01-01",2016
"16-Jan",충남,논산시,316,54802,2124,57242,"2016-01-01",2016
"16-Jan",충남,당진시,321,80259,3595,84175,"2016-01-01",2016
"16-Jan",충남,보령시,312,46468,1253,48033,"2016-01-01",2016
"16-Jan",충남,부여군,224,31077,1364,32665,"2016-01-01",2016
"16-Jan",충남,서산시,351,78026,3421,81798,"2016-01-01",2016
"16-Jan",충남,서천군,194,24998,968,26160,"2016-01-01",2016
"16-Jan",충남,아산시,331,134437,6364,141132,"2016-01-01",2016
"16-Jan",충남,예산군,308,38800,1446,40554,"2016-01-01",2016
"16-Jan",충남,천안시 동남구,228,113708,5897,119833,"2016-01-01",2016
"16-Jan",충남,천안시 서북구,480,147843,4753,153076,"2016-01-01",2016
"16-Jan",충남,청양군,203,14763,815,15781,"2016-01-01",2016
"16-Jan",충남,태안군,216,29419,492,30127,"2016-01-01",2016
"16-Jan",충남,홍성군,347,42982,1243,44572,"2016-01-01",2016
"16-Jan",전북,계,4166,801464,36957,842587,"2016-01-01",2016
"16-Jan",전북,고창군,213,27327,521,28061,"2016-01-01",2016
"16-Jan",전북,군산시,411,117752,6752,124915,"2016-01-01",2016
"16-Jan",전북,김제시,240,40729,1852,42821,"2016-01-01",2016
"16-Jan",전북,남원시,361,36058,2554,38973,"2016-01-01",2016
"16-Jan",전북,무주군,144,11269,366,11779,"2016-01-01",2016
"16-Jan",전북,부안군,212,25067,602,25881,"2016-01-01",2016
"16-Jan",전북,순창군,176,12887,224,13287,"2016-01-01",2016
"16-Jan",전북,완주군,278,45357,3570,49205,"2016-01-01",2016
"16-Jan",전북,익산시,422,126082,6059,132563,"2016-01-01",2016
"16-Jan",전북,임실군,165,12737,406,13308,"2016-01-01",2016
"16-Jan",전북,장수군,179,10564,165,10908,"2016-01-01",2016
"16-Jan",전북,전주시 덕진구,347,132841,7463,140651,"2016-01-01",2016
"16-Jan",전북,전주시 완산구,548,142240,3917,146705,"2016-01-01",2016
"16-Jan",전북,정읍시,271,48325,2317,50913,"2016-01-01",2016
"16-Jan",전북,진안군,199,12229,189,12617,"2016-01-01",2016
"16-Jan",전남,계,5205,813069,85462,903736,"2016-01-01",2016
"16-Jan",전남,강진군,179,16659,994,17832,"2016-01-01",2016
"16-Jan",전남,고흥군,223,27360,708,28291,"2016-01-01",2016
"16-Jan",전남,곡성군,139,13142,864,14145,"2016-01-01",2016
"16-Jan",전남,광양시,226,70700,5853,76779,"2016-01-01",2016
"16-Jan",전남,구례군,99,11570,676,12345,"2016-01-01",2016
"16-Jan",전남,나주시,355,47238,3114,50707,"2016-01-01",2016
"16-Jan",전남,담양군,173,23097,1659,24929,"2016-01-01",2016
"16-Jan",전남,목포시,427,87794,5868,94089,"2016-01-01",2016
"16-Jan",전남,무안군,434,36743,911,38088,"2016-01-01",2016
"16-Jan",전남,보성군,201,19438,25255,44894,"2016-01-01",2016
"16-Jan",전남,순천시,429,116802,4705,121936,"2016-01-01",2016
"16-Jan",전남,신안군,180,18056,655,18891,"2016-01-01",2016
"16-Jan",전남,여수시,474,114321,6307,121102,"2016-01-01",2016
"16-Jan",전남,영광군,203,24376,737,25316,"2016-01-01",2016
"16-Jan",전남,영암군,210,30039,21541,51790,"2016-01-01",2016
"16-Jan",전남,완도군,197,21635,488,22320,"2016-01-01",2016
"16-Jan",전남,장성군,132,22368,1266,23766,"2016-01-01",2016
"16-Jan",전남,장흥군,169,18077,444,18690,"2016-01-01",2016
"16-Jan",전남,진도군,138,14565,289,14992,"2016-01-01",2016
"16-Jan",전남,함평군,145,15723,378,16246,"2016-01-01",2016
"16-Jan",전남,해남군,276,34741,583,35600,"2016-01-01",2016
"16-Jan",전남,화순군,196,28625,2167,30988,"2016-01-01",2016
"16-Jan",경북,계,6187,1258853,48638,1313678,"2016-01-01",2016
"16-Jan",경북,경산시,409,119858,4112,124379,"2016-01-01",2016
"16-Jan",경북,경주시,491,125274,5015,130780,"2016-01-01",2016
"16-Jan",경북,고령군,139,19387,432,19958,"2016-01-01",2016
"16-Jan",경북,구미시,432,187717,7592,195741,"2016-01-01",2016
"16-Jan",경북,군위군,104,12719,285,13108,"2016-01-01",2016
"16-Jan",경북,김천시,312,63563,1709,65584,"2016-01-01",2016
"16-Jan",경북,문경시,246,32554,906,33706,"2016-01-01",2016
"16-Jan",경북,봉화군,173,15653,206,16032,"2016-01-01",2016
"16-Jan",경북,상주시,332,47062,1801,49195,"2016-01-01",2016
"16-Jan",경북,성주군,165,26818,1486,28469,"2016-01-01",2016
"16-Jan",경북,안동시,453,74651,2602,77706,"2016-01-01",2016
"16-Jan",경북,영덕군,203,17061,298,17562,"2016-01-01",2016
"16-Jan",경북,영양군,121,8441,107,8669,"2016-01-01",2016
"16-Jan",경북,영주시,297,50936,1650,52883,"2016-01-01",2016
"16-Jan",경북,영천시,227,51212,2541,53980,"2016-01-01",2016
"16-Jan",경북,예천군,169,20376,413,20958,"2016-01-01",2016
"16-Jan",경북,울릉군,129,4456,333,4918,"2016-01-01",2016
"16-Jan",경북,울진군,228,23299,393,23920,"2016-01-01",2016
"16-Jan",경북,의성군,270,26647,1009,27926,"2016-01-01",2016
"16-Jan",경북,청도군,141,21950,643,22734,"2016-01-01",2016
"16-Jan",경북,청송군,182,13541,210,13933,"2016-01-01",2016
"16-Jan",경북,칠곡군,320,62935,1978,65233,"2016-01-01",2016
"16-Jan",경북,포항시 남구,341,112638,8951,121930,"2016-01-01",2016
"16-Jan",경북,포항시 북구,303,120105,3966,124374,"2016-01-01",2016
"16-Jan",경남,계,6015,1489163,76786,1571964,"2016-01-01",2016
"16-Jan",경남,거제시,263,100637,2767,103667,"2016-01-01",2016
"16-Jan",경남,거창군,224,27910,780,28914,"2016-01-01",2016
"16-Jan",경남,고성군,196,24356,709,25261,"2016-01-01",2016
"16-Jan",경남,김해시,550,236315,6543,243408,"2016-01-01",2016
"16-Jan",경남,남해군,194,17271,528,17993,"2016-01-01",2016
"16-Jan",경남,밀양시,276,49638,4320,54234,"2016-01-01",2016
"16-Jan",경남,사천시,262,49615,1557,51434,"2016-01-01",2016
"16-Jan",경남,산청군,175,17127,838,18140,"2016-01-01",2016
"16-Jan",경남,양산시,340,125828,8540,134708,"2016-01-01",2016
"16-Jan",경남,의령군,157,12507,915,13579,"2016-01-01",2016
"16-Jan",경남,진주시,540,143686,6717,150943,"2016-01-01",2016
"16-Jan",경남,창녕군,186,31306,804,32296,"2016-01-01",2016
"16-Jan",경남,창원시 마산합포구,308,85770,3076,89154,"2016-01-01",2016
"16-Jan",경남,창원시 마산회원구,160,97397,5335,102892,"2016-01-01",2016
"16-Jan",경남,창원시 성산구,140,120300,13311,133751,"2016-01-01",2016
"16-Jan",경남,창원시 의창구,820,120489,5274,126583,"2016-01-01",2016
"16-Jan",경남,창원시 진해구,183,76337,1561,78081,"2016-01-01",2016
"16-Jan",경남,통영시,284,49845,1588,51717,"2016-01-01",2016
"16-Jan",경남,하동군,196,22328,445,22969,"2016-01-01",2016
"16-Jan",경남,함안군,165,40781,9497,50443,"2016-01-01",2016
"16-Jan",경남,함양군,174,19003,732,19909,"2016-01-01",2016
"16-Jan",경남,합천군,222,20717,949,21888,"2016-01-01",2016
"16-Jan",제주,계,1847,340354,96082,438283,"2016-01-01",2016
"16-Jan",제주,서귀포시,606,84113,2284,87003,"2016-01-01",2016
"16-Jan",제주,제주시,1241,256241,93798,351280,"2016-01-01",2016
"16-Feb",서울,계,11009,2857121,195553,3063683,"2016-02-01",2016
"16-Feb",서울,강남구,342,223879,20031,244252,"2016-02-01",2016
"16-Feb",서울,강동구,220,129154,8467,137841,"2016-02-01",2016
"16-Feb",서울,강북구,278,70783,4843,75904,"2016-02-01",2016
"16-Feb",서울,강서구,296,176169,14712,191177,"2016-02-01",2016
"16-Feb",서울,관악구,255,115253,5806,121314,"2016-02-01",2016
"16-Feb",서울,광진구,266,90737,5616,96619,"2016-02-01",2016
"16-Feb",서울,구로구,218,127620,10516,138354,"2016-02-01",2016
"16-Feb",서울,금천구,123,75293,7814,83230,"2016-02-01",2016
"16-Feb",서울,노원구,250,145030,9776,155056,"2016-02-01",2016
"16-Feb",서울,도봉구,230,88183,7754,96167,"2016-02-01",2016
"16-Feb",서울,동대문구,267,90751,5843,96861,"2016-02-01",2016
"16-Feb",서울,동작구,270,99371,2785,102426,"2016-02-01",2016
"16-Feb",서울,마포구,269,109359,7537,117165,"2016-02-01",2016
"16-Feb",서울,서대문구,406,77864,5023,83293,"2016-02-01",2016
"16-Feb",서울,서초구,620,168020,10305,178945,"2016-02-01",2016
"16-Feb",서울,성동구,263,87676,8209,96148,"2016-02-01",2016
"16-Feb",서울,성북구,218,111117,5523,116858,"2016-02-01",2016
"16-Feb",서울,송파구,330,207237,11631,219198,"2016-02-01",2016
"16-Feb",서울,양천구,296,140655,9141,150092,"2016-02-01",2016
"16-Feb",서울,영등포구,299,136318,10174,146791,"2016-02-01",2016
"16-Feb",서울,용산구,342,73759,2038,76139,"2016-02-01",2016
"16-Feb",서울,은평구,219,119724,6953,126896,"2016-02-01",2016
"16-Feb",서울,종로구,3554,44635,1582,49771,"2016-02-01",2016
"16-Feb",서울,중구,992,47612,4022,52626,"2016-02-01",2016
"16-Feb",서울,중랑구,186,100922,9452,110560,"2016-02-01",2016
"16-Feb",부산,계,4215,1178092,79743,1262050,"2016-02-01",2016
"16-Feb",부산,강서구,290,53221,3538,57049,"2016-02-01",2016
"16-Feb",부산,금정구,271,78061,7519,85851,"2016-02-01",2016
"16-Feb",부산,기장군,204,62143,2097,64444,"2016-02-01",2016
"16-Feb",부산,남구,208,85844,8922,94974,"2016-02-01",2016
"16-Feb",부산,동구,220,36887,6231,43338,"2016-02-01",2016
"16-Feb",부산,동래구,166,84916,4250,89332,"2016-02-01",2016
"16-Feb",부산,부산진구,372,122781,6091,129244,"2016-02-01",2016
"16-Feb",부산,북구,206,98630,3825,102661,"2016-02-01",2016
"16-Feb",부산,사상구,248,84177,6238,90663,"2016-02-01",2016
"16-Feb",부산,사하구,234,104781,7376,112391,"2016-02-01",2016
"16-Feb",부산,서구,128,27474,1323,28925,"2016-02-01",2016
"16-Feb",부산,수영구,142,59626,2980,62748,"2016-02-01",2016
"16-Feb",부산,연제구,770,80406,5144,86320,"2016-02-01",2016
"16-Feb",부산,영도구,206,31510,2572,34288,"2016-02-01",2016
"16-Feb",부산,중구,303,14769,6185,21257,"2016-02-01",2016
"16-Feb",부산,해운대구,247,152866,5452,158565,"2016-02-01",2016
"16-Feb",대구,계,2711,1057579,48714,1109004,"2016-02-01",2016
"16-Feb",대구,남구,175,56750,2104,59029,"2016-02-01",2016
"16-Feb",대구,달서구,405,246821,12136,259362,"2016-02-01",2016
"16-Feb",대구,달성군,383,90665,3392,94440,"2016-02-01",2016
"16-Feb",대구,동구,288,140549,11148,151985,"2016-02-01",2016
"16-Feb",대구,북구,422,181376,8380,190178,"2016-02-01",2016
"16-Feb",대구,서구,191,76206,4365,80762,"2016-02-01",2016
"16-Feb",대구,수성구,479,202754,5258,208491,"2016-02-01",2016
"16-Feb",대구,중구,368,62458,1931,64757,"2016-02-01",2016
"16-Feb",인천,계,3374,1125392,237439,1366205,"2016-02-01",2016
"16-Feb",인천,강화군,282,29068,2358,31708,"2016-02-01",2016
"16-Feb",인천,계양구,236,118236,115183,233655,"2016-02-01",2016
"16-Feb",인천,남구,362,132406,50115,182883,"2016-02-01",2016
"16-Feb",인천,남동구,775,231519,25728,258022,"2016-02-01",2016
"16-Feb",인천,동구,81,25351,2510,27942,"2016-02-01",2016
"16-Feb",인천,부평구,305,194993,7624,202922,"2016-02-01",2016
"16-Feb",인천,서구,336,197265,10629,208230,"2016-02-01",2016
"16-Feb",인천,연수구,283,136962,7174,144419,"2016-02-01",2016
"16-Feb",인천,옹진군,162,10208,163,10533,"2016-02-01",2016
"16-Feb",인천,중구,552,49384,15955,65891,"2016-02-01",2016
"16-Feb",광주,계,1912,579600,33093,614605,"2016-02-01",2016
"16-Feb",광주,광산구,481,166195,9787,176463,"2016-02-01",2016
"16-Feb",광주,남구,161,81015,3405,84581,"2016-02-01",2016
"16-Feb",광주,동구,208,34562,1158,35928,"2016-02-01",2016
"16-Feb",광주,북구,430,170516,9194,180140,"2016-02-01",2016
"16-Feb",광주,서구,632,127312,9549,137493,"2016-02-01",2016
"16-Feb",대전,계,1682,605403,27841,634926,"2016-02-01",2016
"16-Feb",대전,대덕구,254,84322,6375,90951,"2016-02-01",2016
"16-Feb",대전,동구,154,85657,4498,90309,"2016-02-01",2016
"16-Feb",대전,서구,701,191082,6615,198398,"2016-02-01",2016
"16-Feb",대전,유성구,360,150006,4563,154929,"2016-02-01",2016
"16-Feb",대전,중구,213,94336,5790,100339,"2016-02-01",2016
"16-Feb",울산,계,1470,506076,21059,528605,"2016-02-01",2016
"16-Feb",울산,남구,594,148674,7416,156684,"2016-02-01",2016
"16-Feb",울산,동구,182,62204,900,63286,"2016-02-01",2016
"16-Feb",울산,북구,110,87884,4365,92359,"2016-02-01",2016
"16-Feb",울산,울주군,282,106292,5728,112302,"2016-02-01",2016
"16-Feb",울산,중구,302,101022,2650,103974,"2016-02-01",2016
"16-Feb",세종,계,547,94582,2261,97390,"2016-02-01",2016
"16-Feb",세종,세종특별자치시,547,94582,2261,97390,"2016-02-01",2016
"16-Feb",경기,계,14088,4726244,216366,4956698,"2016-02-01",2016
"16-Feb",경기,가평군,317,26302,755,27374,"2016-02-01",2016
"16-Feb",경기,고양시 덕양구,556,147162,3527,151245,"2016-02-01",2016
"16-Feb",경기,고양시 일산동구,254,107013,6591,113858,"2016-02-01",2016
"16-Feb",경기,고양시 일산서구,71,102913,3218,106202,"2016-02-01",2016
"16-Feb",경기,과천시,669,22139,560,23368,"2016-02-01",2016
"16-Feb",경기,광명시,267,101022,4352,105641,"2016-02-01",2016
"16-Feb",경기,광주시,327,144903,7592,152822,"2016-02-01",2016
"16-Feb",경기,구리시,192,59119,2344,61655,"2016-02-01",2016
"16-Feb",경기,군포시,232,91945,4713,96890,"2016-02-01",2016
"16-Feb",경기,김포시,368,147288,5946,153602,"2016-02-01",2016
"16-Feb",경기,남양주시,506,240105,6882,247493,"2016-02-01",2016
"16-Feb",경기,동두천시,186,34514,1201,35901,"2016-02-01",2016
"16-Feb",경기,부천시 소사구,79,65811,2854,68744,"2016-02-01",2016
"16-Feb",경기,부천시 오정구,111,61292,2375,63778,"2016-02-01",2016
"16-Feb",경기,부천시 원미구,431,144872,6302,151605,"2016-02-01",2016
"16-Feb",경기,성남시 분당구,312,178493,5723,184528,"2016-02-01",2016
"16-Feb",경기,성남시 수정구,231,60782,2341,63354,"2016-02-01",2016
"16-Feb",경기,성남시 중원구,241,73526,3967,77734,"2016-02-01",2016
"16-Feb",경기,수원시 권선구,304,146577,7184,154065,"2016-02-01",2016
"16-Feb",경기,수원시 영통구,193,121207,2632,124032,"2016-02-01",2016
"16-Feb",경기,수원시 장안구,476,101664,3651,105791,"2016-02-01",2016
"16-Feb",경기,수원시 팔달구,487,68735,3435,72657,"2016-02-01",2016
"16-Feb",경기,시흥시,404,173847,7136,181387,"2016-02-01",2016
"16-Feb",경기,안산시 단원구,487,138787,8130,147404,"2016-02-01",2016
"16-Feb",경기,안산시 상록구,155,133126,4520,137801,"2016-02-01",2016
"16-Feb",경기,안성시,310,85234,4921,90465,"2016-02-01",2016
"16-Feb",경기,안양시 동안구,364,116778,6416,123558,"2016-02-01",2016
"16-Feb",경기,안양시 만안구,107,76877,3862,80846,"2016-02-01",2016
"16-Feb",경기,양주시,298,82922,2883,86103,"2016-02-01",2016
"16-Feb",경기,양평군,440,48431,1569,50440,"2016-02-01",2016
"16-Feb",경기,여주시,316,54712,7193,62221,"2016-02-01",2016
"16-Feb",경기,연천군,257,20496,5685,26438,"2016-02-01",2016
"16-Feb",경기,오산시,193,81379,2903,84475,"2016-02-01",2016
"16-Feb",경기,용인시 기흥구,113,157609,8626,166348,"2016-02-01",2016
"16-Feb",경기,용인시 수지구,40,123514,1722,125276,"2016-02-01",2016
"16-Feb",경기,용인시 처인구,560,99493,6534,106587,"2016-02-01",2016
"16-Feb",경기,의왕시,249,55105,2831,58185,"2016-02-01",2016
"16-Feb",경기,의정부시,488,133557,4754,138799,"2016-02-01",2016
"16-Feb",경기,이천시,336,93154,5718,99208,"2016-02-01",2016
"16-Feb",경기,파주시,337,171423,10100,181860,"2016-02-01",2016
"16-Feb",경기,평택시,559,207440,10001,218000,"2016-02-01",2016
"16-Feb",경기,포천시,315,75800,10284,86399,"2016-02-01",2016
"16-Feb",경기,하남시,288,65918,2055,68261,"2016-02-01",2016
"16-Feb",경기,화성시,662,283258,10378,294298,"2016-02-01",2016
"16-Feb",강원,계,4875,669962,24373,699210,"2016-02-01",2016
"16-Feb",강원,강릉시,462,94414,4190,99066,"2016-02-01",2016
"16-Feb",강원,고성군,136,12402,243,12781,"2016-02-01",2016
"16-Feb",강원,동해시,261,39685,1338,41284,"2016-02-01",2016
"16-Feb",강원,삼척시,310,28550,695,29555,"2016-02-01",2016
"16-Feb",강원,속초시,266,32288,1259,33813,"2016-02-01",2016
"16-Feb",강원,양구군,122,10529,125,10776,"2016-02-01",2016
"16-Feb",강원,양양군,131,12901,249,13281,"2016-02-01",2016
"16-Feb",강원,영월군,286,18536,391,19213,"2016-02-01",2016
"16-Feb",강원,원주시,488,142486,5724,148698,"2016-02-01",2016
"16-Feb",강원,인제군,179,15799,218,16196,"2016-02-01",2016
"16-Feb",강원,정선군,267,18427,468,19162,"2016-02-01",2016
"16-Feb",강원,철원군,173,21502,312,21987,"2016-02-01",2016
"16-Feb",강원,춘천시,667,113584,5853,120104,"2016-02-01",2016
"16-Feb",강원,태백시,188,19569,866,20623,"2016-02-01",2016
"16-Feb",강원,평창군,253,23034,354,23641,"2016-02-01",2016
"16-Feb",강원,홍천군,314,33224,1108,34646,"2016-02-01",2016
"16-Feb",강원,화천군,164,11082,131,11377,"2016-02-01",2016
"16-Feb",강원,횡성군,208,21950,849,23007,"2016-02-01",2016
"16-Feb",충북,계,3283,700219,31868,735370,"2016-02-01",2016
"16-Feb",충북,괴산군,158,19485,304,19947,"2016-02-01",2016
"16-Feb",충북,단양군,151,14023,822,14996,"2016-02-01",2016
"16-Feb",충북,보은군,178,15895,929,17002,"2016-02-01",2016
"16-Feb",충북,영동군,195,22554,376,23125,"2016-02-01",2016
"16-Feb",충북,옥천군,169,23481,1019,24669,"2016-02-01",2016
"16-Feb",충북,음성군,178,50786,1643,52607,"2016-02-01",2016
"16-Feb",충북,제천시,291,59348,3240,62879,"2016-02-01",2016
"16-Feb",충북,증평군,75,16271,750,17096,"2016-02-01",2016
"16-Feb",충북,진천군,171,35094,1063,36328,"2016-02-01",2016
"16-Feb",충북,청원군,1,39,1,41,"2016-02-01",2016
"16-Feb",충북,청주시 상당구,403,71605,2670,74678,"2016-02-01",2016
"16-Feb",충북,청주시 서원구,224,88652,5900,94776,"2016-02-01",2016
"16-Feb",충북,청주시 청원구,275,84357,3706,88338,"2016-02-01",2016
"16-Feb",충북,청주시 흥덕구,324,105988,5881,112193,"2016-02-01",2016
"16-Feb",충북,충주시,490,92641,3564,96695,"2016-02-01",2016
"16-Feb",충남,계,4593,934323,38825,977741,"2016-02-01",2016
"16-Feb",충남,계룡시,124,18629,466,19219,"2016-02-01",2016
"16-Feb",충남,공주시,490,48832,2074,51396,"2016-02-01",2016
"16-Feb",충남,금산군,153,25756,2468,28377,"2016-02-01",2016
"16-Feb",충남,논산시,316,55013,2125,57454,"2016-02-01",2016
"16-Feb",충남,당진시,320,80568,3626,84514,"2016-02-01",2016
"16-Feb",충남,보령시,309,46596,1246,48151,"2016-02-01",2016
"16-Feb",충남,부여군,223,31209,1375,32807,"2016-02-01",2016
"16-Feb",충남,서산시,349,78305,3443,82097,"2016-02-01",2016
"16-Feb",충남,서천군,194,25110,969,26273,"2016-02-01",2016
"16-Feb",충남,아산시,332,135354,6365,142051,"2016-02-01",2016
"16-Feb",충남,예산군,307,38815,1453,40575,"2016-02-01",2016
"16-Feb",충남,천안시 동남구,229,113775,5910,119914,"2016-02-01",2016
"16-Feb",충남,천안시 서북구,482,148702,4764,153948,"2016-02-01",2016
"16-Feb",충남,청양군,203,14784,813,15800,"2016-02-01",2016
"16-Feb",충남,태안군,216,29511,486,30213,"2016-02-01",2016
"16-Feb",충남,홍성군,346,43364,1242,44952,"2016-02-01",2016
"16-Feb",전북,계,4169,803520,36922,844611,"2016-02-01",2016
"16-Feb",전북,고창군,212,27360,518,28090,"2016-02-01",2016
"16-Feb",전북,군산시,409,118015,6762,125186,"2016-02-01",2016
"16-Feb",전북,김제시,238,40903,1854,42995,"2016-02-01",2016
"16-Feb",전북,남원시,362,36206,2501,39069,"2016-02-01",2016
"16-Feb",전북,무주군,144,11287,362,11793,"2016-02-01",2016
"16-Feb",전북,부안군,213,25156,599,25968,"2016-02-01",2016
"16-Feb",전북,순창군,176,12879,222,13277,"2016-02-01",2016
"16-Feb",전북,완주군,277,45560,3591,49428,"2016-02-01",2016
"16-Feb",전북,익산시,423,126299,6065,132787,"2016-02-01",2016
"16-Feb",전북,임실군,167,12710,407,13284,"2016-02-01",2016
"16-Feb",전북,장수군,180,10621,165,10966,"2016-02-01",2016
"16-Feb",전북,전주시 덕진구,347,133002,7540,140889,"2016-02-01",2016
"16-Feb",전북,전주시 완산구,551,142795,3856,147202,"2016-02-01",2016
"16-Feb",전북,정읍시,271,48461,2286,51018,"2016-02-01",2016
"16-Feb",전북,진안군,199,12266,194,12659,"2016-02-01",2016
"16-Feb",전남,계,5217,815657,86499,907373,"2016-02-01",2016
"16-Feb",전남,강진군,179,16701,965,17845,"2016-02-01",2016
"16-Feb",전남,고흥군,223,27452,663,28338,"2016-02-01",2016
"16-Feb",전남,곡성군,138,13174,861,14173,"2016-02-01",2016
"16-Feb",전남,광양시,226,70782,5855,76863,"2016-02-01",2016
"16-Feb",전남,구례군,98,11598,684,12380,"2016-02-01",2016
"16-Feb",전남,나주시,355,47649,3166,51170,"2016-02-01",2016
"16-Feb",전남,담양군,173,23182,1655,25010,"2016-02-01",2016
"16-Feb",전남,목포시,437,88047,5938,94422,"2016-02-01",2016
"16-Feb",전남,무안군,434,36898,920,38252,"2016-02-01",2016
"16-Feb",전남,보성군,207,19499,26603,46309,"2016-02-01",2016
"16-Feb",전남,순천시,429,117200,4698,122327,"2016-02-01",2016
"16-Feb",전남,신안군,180,18151,653,18984,"2016-02-01",2016
"16-Feb",전남,여수시,472,114698,6329,121499,"2016-02-01",2016
"16-Feb",전남,영광군,200,24410,719,25329,"2016-02-01",2016
"16-Feb",전남,영암군,210,30136,21198,51544,"2016-02-01",2016
"16-Feb",전남,완도군,197,21695,478,22370,"2016-02-01",2016
"16-Feb",전남,장성군,132,22454,1265,23851,"2016-02-01",2016
"16-Feb",전남,장흥군,168,18038,445,18651,"2016-02-01",2016
"16-Feb",전남,진도군,134,14599,292,15025,"2016-02-01",2016
"16-Feb",전남,함평군,145,15778,381,16304,"2016-02-01",2016
"16-Feb",전남,해남군,282,34817,581,35680,"2016-02-01",2016
"16-Feb",전남,화순군,198,28699,2150,31047,"2016-02-01",2016
"16-Feb",경북,계,6186,1262733,48674,1317593,"2016-02-01",2016
"16-Feb",경북,경산시,407,120262,4084,124753,"2016-02-01",2016
"16-Feb",경북,경주시,491,125534,5030,131055,"2016-02-01",2016
"16-Feb",경북,고령군,139,19444,429,20012,"2016-02-01",2016
"16-Feb",경북,구미시,432,187987,7652,196071,"2016-02-01",2016
"16-Feb",경북,군위군,104,12810,284,13198,"2016-02-01",2016
"16-Feb",경북,김천시,311,63946,1708,65965,"2016-02-01",2016
"16-Feb",경북,문경시,246,32670,907,33823,"2016-02-01",2016
"16-Feb",경북,봉화군,173,15654,208,16035,"2016-02-01",2016
"16-Feb",경북,상주시,334,47220,1819,49373,"2016-02-01",2016
"16-Feb",경북,성주군,167,26867,1477,28511,"2016-02-01",2016
"16-Feb",경북,안동시,455,75126,2594,78175,"2016-02-01",2016
"16-Feb",경북,영덕군,202,17142,300,17644,"2016-02-01",2016
"16-Feb",경북,영양군,121,8445,107,8673,"2016-02-01",2016
"16-Feb",경북,영주시,295,51069,1652,53016,"2016-02-01",2016
"16-Feb",경북,영천시,227,51381,2546,54154,"2016-02-01",2016
"16-Feb",경북,예천군,169,20628,412,21209,"2016-02-01",2016
"16-Feb",경북,울릉군,131,4472,334,4937,"2016-02-01",2016
"16-Feb",경북,울진군,227,23311,393,23931,"2016-02-01",2016
"16-Feb",경북,의성군,269,26762,982,28013,"2016-02-01",2016
"16-Feb",경북,청도군,140,22062,639,22841,"2016-02-01",2016
"16-Feb",경북,청송군,181,13556,204,13941,"2016-02-01",2016
"16-Feb",경북,칠곡군,319,63105,1991,65415,"2016-02-01",2016
"16-Feb",경북,포항시 남구,343,112925,8995,122263,"2016-02-01",2016
"16-Feb",경북,포항시 북구,303,120355,3927,124585,"2016-02-01",2016
"16-Feb",경남,계,6023,1498457,77182,1581662,"2016-02-01",2016
"16-Feb",경남,거제시,274,101010,2744,104028,"2016-02-01",2016
"16-Feb",경남,거창군,224,27963,782,28969,"2016-02-01",2016
"16-Feb",경남,고성군,199,24441,688,25328,"2016-02-01",2016
"16-Feb",경남,김해시,550,236627,6516,243693,"2016-02-01",2016
"16-Feb",경남,남해군,194,17310,529,18033,"2016-02-01",2016
"16-Feb",경남,밀양시,275,49798,4326,54399,"2016-02-01",2016
"16-Feb",경남,사천시,262,49722,1553,51537,"2016-02-01",2016
"16-Feb",경남,산청군,175,17217,814,18206,"2016-02-01",2016
"16-Feb",경남,양산시,339,126474,8548,135361,"2016-02-01",2016
"16-Feb",경남,의령군,156,12518,913,13587,"2016-02-01",2016
"16-Feb",경남,진주시,537,144362,6726,151625,"2016-02-01",2016
"16-Feb",경남,창녕군,190,31399,810,32399,"2016-02-01",2016
"16-Feb",경남,창원시 마산합포구,305,92002,3131,95438,"2016-02-01",2016
"16-Feb",경남,창원시 마산회원구,160,97545,5323,103028,"2016-02-01",2016
"16-Feb",경남,창원시 성산구,139,120269,13681,134089,"2016-02-01",2016
"16-Feb",경남,창원시 의창구,823,120599,5297,126719,"2016-02-01",2016
"16-Feb",경남,창원시 진해구,183,76674,1571,78428,"2016-02-01",2016
"16-Feb",경남,통영시,279,49948,1580,51807,"2016-02-01",2016
"16-Feb",경남,하동군,196,22421,444,23061,"2016-02-01",2016
"16-Feb",경남,함안군,166,40705,9543,50414,"2016-02-01",2016
"16-Feb",경남,함양군,175,18707,709,19591,"2016-02-01",2016
"16-Feb",경남,합천군,222,20746,954,21922,"2016-02-01",2016
"16-Feb",제주,계,1852,341416,97116,440384,"2016-02-01",2016
"16-Feb",제주,서귀포시,608,84648,2277,87533,"2016-02-01",2016
"16-Feb",제주,제주시,1244,256768,94839,352851,"2016-02-01",2016
"16-Mar",서울,계,11063,2859611,195376,3066050,"2016-03-01",2016
"16-Mar",서울,강남구,354,223553,19811,243718,"2016-03-01",2016
"16-Mar",서울,강동구,218,129054,8464,137736,"2016-03-01",2016
"16-Mar",서울,강북구,282,70899,4852,76033,"2016-03-01",2016
"16-Mar",서울,강서구,295,176634,14743,191672,"2016-03-01",2016
"16-Mar",서울,관악구,254,115343,5784,121381,"2016-03-01",2016
"16-Mar",서울,광진구,269,90901,5564,96734,"2016-03-01",2016
"16-Mar",서울,구로구,224,127915,10759,138898,"2016-03-01",2016
"16-Mar",서울,금천구,121,75474,7725,83320,"2016-03-01",2016
"16-Mar",서울,노원구,252,145221,9757,155230,"2016-03-01",2016
"16-Mar",서울,도봉구,228,88241,7766,96235,"2016-03-01",2016
"16-Mar",서울,동대문구,269,90852,5826,96947,"2016-03-01",2016
"16-Mar",서울,동작구,279,99545,2823,102647,"2016-03-01",2016
"16-Mar",서울,마포구,276,109487,7508,117271,"2016-03-01",2016
"16-Mar",서울,서대문구,406,78280,5013,83699,"2016-03-01",2016
"16-Mar",서울,서초구,624,167709,10309,178642,"2016-03-01",2016
"16-Mar",서울,성동구,263,87760,8135,96158,"2016-03-01",2016
"16-Mar",서울,성북구,221,111134,5535,116890,"2016-03-01",2016
"16-Mar",서울,송파구,330,207232,11749,219311,"2016-03-01",2016
"16-Mar",서울,양천구,307,140573,9138,150018,"2016-03-01",2016
"16-Mar",서울,영등포구,306,137052,10155,147513,"2016-03-01",2016
"16-Mar",서울,용산구,346,73732,2020,76098,"2016-03-01",2016
"16-Mar",서울,은평구,222,119809,6952,126983,"2016-03-01",2016
"16-Mar",서울,종로구,3542,44528,1596,49666,"2016-03-01",2016
"16-Mar",서울,중구,987,47594,3943,52524,"2016-03-01",2016
"16-Mar",서울,중랑구,188,101089,9449,110726,"2016-03-01",2016
"16-Mar",부산,계,4276,1185931,79758,1269965,"2016-03-01",2016
"16-Mar",부산,강서구,293,54066,3537,57896,"2016-03-01",2016
"16-Mar",부산,금정구,273,78208,7212,85693,"2016-03-01",2016
"16-Mar",부산,기장군,212,62449,2095,64756,"2016-03-01",2016
"16-Mar",부산,남구,210,85999,8923,95132,"2016-03-01",2016
"16-Mar",부산,동구,222,36835,6181,43238,"2016-03-01",2016
"16-Mar",부산,동래구,168,85012,4547,89727,"2016-03-01",2016
"16-Mar",부산,부산진구,372,122768,6085,129225,"2016-03-01",2016
"16-Mar",부산,북구,210,99072,3823,103105,"2016-03-01",2016
"16-Mar",부산,사상구,250,84270,6231,90751,"2016-03-01",2016
"16-Mar",부산,사하구,239,104813,7379,112431,"2016-03-01",2016
"16-Mar",부산,서구,133,27448,1319,28900,"2016-03-01",2016
"16-Mar",부산,수영구,149,64796,2970,67915,"2016-03-01",2016
"16-Mar",부산,연제구,775,80758,5236,86769,"2016-03-01",2016
"16-Mar",부산,영도구,209,31508,2567,34284,"2016-03-01",2016
"16-Mar",부산,중구,307,14659,6194,21160,"2016-03-01",2016
"16-Mar",부산,해운대구,254,153270,5459,158983,"2016-03-01",2016
"16-Mar",대구,계,2726,1060440,48694,1111860,"2016-03-01",2016
"16-Mar",대구,남구,179,56768,2071,59018,"2016-03-01",2016
"16-Mar",대구,달서구,407,246832,11892,259131,"2016-03-01",2016
"16-Mar",대구,달성군,385,92262,3438,96085,"2016-03-01",2016
"16-Mar",대구,동구,288,141363,11172,152823,"2016-03-01",2016
"16-Mar",대구,북구,425,181536,8581,190542,"2016-03-01",2016
"16-Mar",대구,서구,194,76274,4311,80779,"2016-03-01",2016
"16-Mar",대구,수성구,479,202789,5292,208560,"2016-03-01",2016
"16-Mar",대구,중구,369,62616,1937,64922,"2016-03-01",2016
"16-Mar",인천,계,3353,1127492,241111,1371956,"2016-03-01",2016
"16-Mar",인천,강화군,286,29200,2388,31874,"2016-03-01",2016
"16-Mar",인천,계양구,234,118516,117165,235915,"2016-03-01",2016
"16-Mar",인천,남구,356,132507,50807,183670,"2016-03-01",2016
"16-Mar",인천,남동구,756,228901,26717,256374,"2016-03-01",2016
"16-Mar",인천,동구,82,25517,2524,28123,"2016-03-01",2016
"16-Mar",인천,부평구,299,196695,7608,204602,"2016-03-01",2016
"16-Mar",인천,서구,336,198441,10562,209339,"2016-03-01",2016
"16-Mar",인천,연수구,281,137846,7207,145334,"2016-03-01",2016
"16-Mar",인천,옹진군,162,10282,165,10609,"2016-03-01",2016
"16-Mar",인천,중구,561,49587,15968,66116,"2016-03-01",2016
"16-Mar",광주,계,1915,581478,33263,616656,"2016-03-01",2016
"16-Mar",광주,광산구,477,167033,9741,177251,"2016-03-01",2016
"16-Mar",광주,남구,162,81258,3441,84861,"2016-03-01",2016
"16-Mar",광주,동구,209,34582,1145,35936,"2016-03-01",2016
"16-Mar",광주,북구,431,170792,9215,180438,"2016-03-01",2016
"16-Mar",광주,서구,636,127813,9721,138170,"2016-03-01",2016
"16-Mar",대전,계,1696,606857,27834,636387,"2016-03-01",2016
"16-Mar",대전,대덕구,255,84345,6392,90992,"2016-03-01",2016
"16-Mar",대전,동구,155,85725,4381,90261,"2016-03-01",2016
"16-Mar",대전,서구,706,191662,6650,199018,"2016-03-01",2016
"16-Mar",대전,유성구,366,150705,4660,155731,"2016-03-01",2016
"16-Mar",대전,중구,214,94420,5751,100385,"2016-03-01",2016
"16-Mar",울산,계,1483,507386,21168,530037,"2016-03-01",2016
"16-Mar",울산,남구,601,148855,7386,156842,"2016-03-01",2016
"16-Mar",울산,동구,182,62446,908,63536,"2016-03-01",2016
"16-Mar",울산,북구,110,88091,4439,92640,"2016-03-01",2016
"16-Mar",울산,울주군,289,106789,5732,112810,"2016-03-01",2016
"16-Mar",울산,중구,301,101205,2703,104209,"2016-03-01",2016
"16-Mar",세종,계,550,96474,2282,99306,"2016-03-01",2016
"16-Mar",세종,세종특별자치시,550,96474,2282,99306,"2016-03-01",2016
"16-Mar",경기,계,14212,4747023,216138,4977373,"2016-03-01",2016
"16-Mar",경기,가평군,329,26473,756,27558,"2016-03-01",2016
"16-Mar",경기,고양시 덕양구,563,147744,3512,151819,"2016-03-01",2016
"16-Mar",경기,고양시 일산동구,254,107444,6531,114229,"2016-03-01",2016
"16-Mar",경기,고양시 일산서구,71,103097,3217,106385,"2016-03-01",2016
"16-Mar",경기,과천시,667,22161,564,23392,"2016-03-01",2016
"16-Mar",경기,광명시,268,101203,4367,105838,"2016-03-01",2016
"16-Mar",경기,광주시,326,145830,7563,153719,"2016-03-01",2016
"16-Mar",경기,구리시,195,59134,2349,61678,"2016-03-01",2016
"16-Mar",경기,군포시,235,92167,4733,97135,"2016-03-01",2016
"16-Mar",경기,김포시,365,148028,5961,154354,"2016-03-01",2016
"16-Mar",경기,남양주시,507,241455,6857,248819,"2016-03-01",2016
"16-Mar",경기,동두천시,187,34646,1203,36036,"2016-03-01",2016
"16-Mar",경기,부천시 소사구,79,66034,2841,68954,"2016-03-01",2016
"16-Mar",경기,부천시 오정구,110,61418,2368,63896,"2016-03-01",2016
"16-Mar",경기,부천시 원미구,436,145173,6202,151811,"2016-03-01",2016
"16-Mar",경기,성남시 분당구,310,178961,5688,184959,"2016-03-01",2016
"16-Mar",경기,성남시 수정구,230,61414,2358,64002,"2016-03-01",2016
"16-Mar",경기,성남시 중원구,243,73676,3987,77906,"2016-03-01",2016
"16-Mar",경기,수원시 권선구,313,147417,7313,155043,"2016-03-01",2016
"16-Mar",경기,수원시 영통구,195,121767,2651,124613,"2016-03-01",2016
"16-Mar",경기,수원시 장안구,481,101761,3659,105901,"2016-03-01",2016
"16-Mar",경기,수원시 팔달구,488,69065,3438,72991,"2016-03-01",2016
"16-Mar",경기,시흥시,403,174501,7167,182071,"2016-03-01",2016
"16-Mar",경기,안산시 단원구,490,139231,8201,147922,"2016-03-01",2016
"16-Mar",경기,안산시 상록구,157,133320,4525,138002,"2016-03-01",2016
"16-Mar",경기,안성시,311,85964,4933,91208,"2016-03-01",2016
"16-Mar",경기,안양시 동안구,367,116891,6409,123667,"2016-03-01",2016
"16-Mar",경기,안양시 만안구,107,77079,3876,81062,"2016-03-01",2016
"16-Mar",경기,양주시,299,83166,2843,86308,"2016-03-01",2016
"16-Mar",경기,양평군,443,48780,1576,50799,"2016-03-01",2016
"16-Mar",경기,여주시,325,54963,7159,62447,"2016-03-01",2016
"16-Mar",경기,연천군,257,20638,5685,26580,"2016-03-01",2016
"16-Mar",경기,오산시,193,81746,2925,84864,"2016-03-01",2016
"16-Mar",경기,용인시 기흥구,113,158395,8488,166996,"2016-03-01",2016
"16-Mar",경기,용인시 수지구,42,123665,1766,125473,"2016-03-01",2016
"16-Mar",경기,용인시 처인구,568,99797,6461,106826,"2016-03-01",2016
"16-Mar",경기,의왕시,247,55342,2819,58408,"2016-03-01",2016
"16-Mar",경기,의정부시,485,134081,4813,139379,"2016-03-01",2016
"16-Mar",경기,이천시,344,93747,5744,99835,"2016-03-01",2016
"16-Mar",경기,파주시,356,172170,10028,182554,"2016-03-01",2016
"16-Mar",경기,평택시,563,208239,10102,218904,"2016-03-01",2016
"16-Mar",경기,포천시,320,76063,10105,86488,"2016-03-01",2016
"16-Mar",경기,하남시,291,67226,2052,69569,"2016-03-01",2016
"16-Mar",경기,화성시,679,285951,10343,296973,"2016-03-01",2016
"16-Mar",강원,계,4930,672864,24320,702114,"2016-03-01",2016
"16-Mar",강원,강릉시,468,94879,4178,99525,"2016-03-01",2016
"16-Mar",강원,고성군,137,12427,246,12810,"2016-03-01",2016
"16-Mar",강원,동해시,264,39820,1345,41429,"2016-03-01",2016
"16-Mar",강원,삼척시,314,28629,691,29634,"2016-03-01",2016
"16-Mar",강원,속초시,269,32456,1251,33976,"2016-03-01",2016
"16-Mar",강원,양구군,123,10555,124,10802,"2016-03-01",2016
"16-Mar",강원,양양군,135,12953,247,13335,"2016-03-01",2016
"16-Mar",강원,영월군,292,18572,392,19256,"2016-03-01",2016
"16-Mar",강원,원주시,488,143136,5742,149366,"2016-03-01",2016
"16-Mar",강원,인제군,176,15867,212,16255,"2016-03-01",2016
"16-Mar",강원,정선군,272,18538,470,19280,"2016-03-01",2016
"16-Mar",강원,철원군,178,21602,310,22090,"2016-03-01",2016
"16-Mar",강원,춘천시,670,114004,5851,120525,"2016-03-01",2016
"16-Mar",강원,태백시,190,19698,858,20746,"2016-03-01",2016
"16-Mar",강원,평창군,258,23151,414,23823,"2016-03-01",2016
"16-Mar",강원,홍천군,321,33347,1104,34772,"2016-03-01",2016
"16-Mar",강원,화천군,164,11176,134,11474,"2016-03-01",2016
"16-Mar",강원,횡성군,211,22054,751,23016,"2016-03-01",2016
"16-Mar",충북,계,3315,703486,31955,738756,"2016-03-01",2016
"16-Mar",충북,괴산군,164,19554,309,20027,"2016-03-01",2016
"16-Mar",충북,단양군,151,14117,825,15093,"2016-03-01",2016
"16-Mar",충북,보은군,179,15945,923,17047,"2016-03-01",2016
"16-Mar",충북,영동군,199,22666,377,23242,"2016-03-01",2016
"16-Mar",충북,옥천군,172,23542,1017,24731,"2016-03-01",2016
"16-Mar",충북,음성군,183,51218,1649,53050,"2016-03-01",2016
"16-Mar",충북,제천시,298,59477,3242,63017,"2016-03-01",2016
"16-Mar",충북,증평군,74,16403,750,17227,"2016-03-01",2016
"16-Mar",충북,진천군,172,35287,1066,36525,"2016-03-01",2016
"16-Mar",충북,청원군,1,39,1,41,"2016-03-01",2016
"16-Mar",충북,청주시 상당구,401,71822,2654,74877,"2016-03-01",2016
"16-Mar",충북,청주시 서원구,225,88922,5984,95131,"2016-03-01",2016
"16-Mar",충북,청주시 청원구,274,85052,3677,89003,"2016-03-01",2016
"16-Mar",충북,청주시 흥덕구,329,106377,5893,112599,"2016-03-01",2016
"16-Mar",충북,충주시,493,93065,3588,97146,"2016-03-01",2016
"16-Mar",충남,계,4633,938881,38819,982333,"2016-03-01",2016
"16-Mar",충남,계룡시,123,18697,471,19291,"2016-03-01",2016
"16-Mar",충남,공주시,497,49022,2087,51606,"2016-03-01",2016
"16-Mar",충남,금산군,157,25858,2427,28442,"2016-03-01",2016
"16-Mar",충남,논산시,316,55250,2136,57702,"2016-03-01",2016
"16-Mar",충남,당진시,323,80963,3638,84924,"2016-03-01",2016
"16-Mar",충남,보령시,316,46824,1251,48391,"2016-03-01",2016
"16-Mar",충남,부여군,222,31300,1383,32905,"2016-03-01",2016
"16-Mar",충남,서산시,352,78597,3470,82419,"2016-03-01",2016
"16-Mar",충남,서천군,195,25186,968,26349,"2016-03-01",2016
"16-Mar",충남,아산시,337,136363,6308,143008,"2016-03-01",2016
"16-Mar",충남,예산군,310,38959,1446,40715,"2016-03-01",2016
"16-Mar",충남,천안시 동남구,230,114071,5902,120203,"2016-03-01",2016
"16-Mar",충남,천안시 서북구,483,149645,4766,154894,"2016-03-01",2016
"16-Mar",충남,청양군,207,14822,826,15855,"2016-03-01",2016
"16-Mar",충남,태안군,218,29644,494,30356,"2016-03-01",2016
"16-Mar",충남,홍성군,347,43680,1246,45273,"2016-03-01",2016
"16-Mar",전북,계,4205,806603,36904,847712,"2016-03-01",2016
"16-Mar",전북,고창군,211,27412,512,28135,"2016-03-01",2016
"16-Mar",전북,군산시,418,118441,6761,125620,"2016-03-01",2016
"16-Mar",전북,김제시,239,41038,1867,43144,"2016-03-01",2016
"16-Mar",전북,남원시,364,36333,2456,39153,"2016-03-01",2016
"16-Mar",전북,무주군,144,11335,361,11840,"2016-03-01",2016
"16-Mar",전북,부안군,214,25313,604,26131,"2016-03-01",2016
"16-Mar",전북,순창군,178,12906,227,13311,"2016-03-01",2016
"16-Mar",전북,완주군,285,45920,3594,49799,"2016-03-01",2016
"16-Mar",전북,익산시,426,126840,6085,133351,"2016-03-01",2016
"16-Mar",전북,임실군,170,12745,408,13323,"2016-03-01",2016
"16-Mar",전북,장수군,180,10680,165,11025,"2016-03-01",2016
"16-Mar",전북,전주시 덕진구,349,133428,7533,141310,"2016-03-01",2016
"16-Mar",전북,전주시 완산구,554,143302,3878,147734,"2016-03-01",2016
"16-Mar",전북,정읍시,274,48598,2261,51133,"2016-03-01",2016
"16-Mar",전북,진안군,199,12312,192,12703,"2016-03-01",2016
"16-Mar",전남,계,5233,819352,87836,912421,"2016-03-01",2016
"16-Mar",전남,강진군,182,16744,967,17893,"2016-03-01",2016
"16-Mar",전남,고흥군,224,27603,665,28492,"2016-03-01",2016
"16-Mar",전남,곡성군,141,13250,852,14243,"2016-03-01",2016
"16-Mar",전남,광양시,227,71016,5837,77080,"2016-03-01",2016
"16-Mar",전남,구례군,101,11698,686,12485,"2016-03-01",2016
"16-Mar",전남,나주시,356,48018,3189,51563,"2016-03-01",2016
"16-Mar",전남,담양군,175,23370,1646,25191,"2016-03-01",2016
"16-Mar",전남,목포시,437,88496,5946,94879,"2016-03-01",2016
"16-Mar",전남,무안군,436,37048,926,38410,"2016-03-01",2016
"16-Mar",전남,보성군,211,19560,28276,48047,"2016-03-01",2016
"16-Mar",전남,순천시,431,117700,4725,122856,"2016-03-01",2016
"16-Mar",전남,신안군,183,18245,652,19080,"2016-03-01",2016
"16-Mar",전남,여수시,474,115256,6313,122043,"2016-03-01",2016
"16-Mar",전남,영광군,199,24547,716,25462,"2016-03-01",2016
"16-Mar",전남,영암군,212,30230,20901,51343,"2016-03-01",2016
"16-Mar",전남,완도군,194,21772,475,22441,"2016-03-01",2016
"16-Mar",전남,장성군,132,22485,1256,23873,"2016-03-01",2016
"16-Mar",전남,장흥군,168,18031,446,18645,"2016-03-01",2016
"16-Mar",전남,진도군,134,14652,290,15076,"2016-03-01",2016
"16-Mar",전남,함평군,142,15844,373,16359,"2016-03-01",2016
"16-Mar",전남,해남군,282,34973,573,35828,"2016-03-01",2016
"16-Mar",전남,화순군,192,28814,2126,31132,"2016-03-01",2016
"16-Mar",경북,계,6201,1268279,48780,1323260,"2016-03-01",2016
"16-Mar",경북,경산시,398,120684,4122,125204,"2016-03-01",2016
"16-Mar",경북,경주시,489,126395,5069,131953,"2016-03-01",2016
"16-Mar",경북,고령군,141,19508,429,20078,"2016-03-01",2016
"16-Mar",경북,구미시,432,188908,7634,196974,"2016-03-01",2016
"16-Mar",경북,군위군,104,12869,283,13256,"2016-03-01",2016
"16-Mar",경북,김천시,313,64344,1719,66376,"2016-03-01",2016
"16-Mar",경북,문경시,247,32835,909,33991,"2016-03-01",2016
"16-Mar",경북,봉화군,170,15734,205,16109,"2016-03-01",2016
"16-Mar",경북,상주시,337,47379,1810,49526,"2016-03-01",2016
"16-Mar",경북,성주군,172,27034,1477,28683,"2016-03-01",2016
"16-Mar",경북,안동시,467,75555,2602,78624,"2016-03-01",2016
"16-Mar",경북,영덕군,205,17258,299,17762,"2016-03-01",2016
"16-Mar",경북,영양군,123,8458,107,8688,"2016-03-01",2016
"16-Mar",경북,영주시,303,51168,1651,53122,"2016-03-01",2016
"16-Mar",경북,영천시,229,51582,2554,54365,"2016-03-01",2016
"16-Mar",경북,예천군,168,20831,410,21409,"2016-03-01",2016
"16-Mar",경북,울릉군,132,4492,334,4958,"2016-03-01",2016
"16-Mar",경북,울진군,230,23389,395,24014,"2016-03-01",2016
"16-Mar",경북,의성군,268,26879,982,28129,"2016-03-01",2016
"16-Mar",경북,청도군,145,22121,644,22910,"2016-03-01",2016
"16-Mar",경북,청송군,179,13623,205,14007,"2016-03-01",2016
"16-Mar",경북,칠곡군,304,63233,1994,65531,"2016-03-01",2016
"16-Mar",경북,포항시 남구,342,113220,9030,122592,"2016-03-01",2016
"16-Mar",경북,포항시 북구,303,120780,3916,124999,"2016-03-01",2016
"16-Mar",경남,계,6086,1503810,78111,1588007,"2016-03-01",2016
"16-Mar",경남,거제시,280,101321,2719,104320,"2016-03-01",2016
"16-Mar",경남,거창군,225,28100,786,29111,"2016-03-01",2016
"16-Mar",경남,고성군,202,24567,714,25483,"2016-03-01",2016
"16-Mar",경남,김해시,562,237531,6546,244639,"2016-03-01",2016
"16-Mar",경남,남해군,196,17350,527,18073,"2016-03-01",2016
"16-Mar",경남,밀양시,278,50034,4331,54643,"2016-03-01",2016
"16-Mar",경남,사천시,265,49871,1552,51688,"2016-03-01",2016
"16-Mar",경남,산청군,177,17318,821,18316,"2016-03-01",2016
"16-Mar",경남,양산시,341,127334,8584,136259,"2016-03-01",2016
"16-Mar",경남,의령군,160,12543,920,13623,"2016-03-01",2016
"16-Mar",경남,진주시,538,145095,6731,152364,"2016-03-01",2016
"16-Mar",경남,창녕군,193,31583,803,32579,"2016-03-01",2016
"16-Mar",경남,창원시 마산합포구,306,92553,3095,95954,"2016-03-01",2016
"16-Mar",경남,창원시 마산회원구,163,97623,5391,103177,"2016-03-01",2016
"16-Mar",경남,창원시 성산구,141,120612,14385,135138,"2016-03-01",2016
"16-Mar",경남,창원시 의창구,824,120847,5431,127102,"2016-03-01",2016
"16-Mar",경남,창원시 진해구,182,77035,1538,78755,"2016-03-01",2016
"16-Mar",경남,통영시,281,50158,1580,52019,"2016-03-01",2016
"16-Mar",경남,하동군,201,22426,441,23068,"2016-03-01",2016
"16-Mar",경남,함안군,166,40723,9572,50461,"2016-03-01",2016
"16-Mar",경남,함양군,179,18423,688,19290,"2016-03-01",2016
"16-Mar",경남,합천군,226,20763,956,21945,"2016-03-01",2016
"16-Mar",제주,계,1863,343002,98481,443346,"2016-03-01",2016
"16-Mar",제주,서귀포시,614,85455,2258,88327,"2016-03-01",2016
"16-Mar",제주,제주시,1249,257547,96223,355019,"2016-03-01",2016
"16-Apr",서울,계,11155,2863211,195228,3069594,"2016-04-01",2016
"16-Apr",서울,강남구,356,223405,19589,243350,"2016-04-01",2016
"16-Apr",서울,강동구,221,128774,8466,137461,"2016-04-01",2016
"16-Apr",서울,강북구,285,71082,4862,76229,"2016-04-01",2016
"16-Apr",서울,강서구,298,176832,14791,191921,"2016-04-01",2016
"16-Apr",서울,관악구,260,115466,5796,121522,"2016-04-01",2016
"16-Apr",서울,광진구,277,90990,5588,96855,"2016-04-01",2016
"16-Apr",서울,구로구,229,128185,10622,139036,"2016-04-01",2016
"16-Apr",서울,금천구,124,75688,7612,83424,"2016-04-01",2016
"16-Apr",서울,노원구,254,145605,9723,155582,"2016-04-01",2016
"16-Apr",서울,도봉구,234,88521,7732,96487,"2016-04-01",2016
"16-Apr",서울,동대문구,271,90964,5824,97059,"2016-04-01",2016
"16-Apr",서울,동작구,278,99763,2799,102840,"2016-04-01",2016
"16-Apr",서울,마포구,280,109511,7471,117262,"2016-04-01",2016
"16-Apr",서울,서대문구,405,78591,5080,84076,"2016-04-01",2016
"16-Apr",서울,서초구,627,167990,10395,179012,"2016-04-01",2016
"16-Apr",서울,성동구,266,87899,8460,96625,"2016-04-01",2016
"16-Apr",서울,성북구,228,111178,5517,116923,"2016-04-01",2016
"16-Apr",서울,송파구,343,207372,11607,219322,"2016-04-01",2016
"16-Apr",서울,양천구,309,140580,9114,150003,"2016-04-01",2016
"16-Apr",서울,영등포구,301,137515,10205,148021,"2016-04-01",2016
"16-Apr",서울,용산구,349,73700,2033,76082,"2016-04-01",2016
"16-Apr",서울,은평구,227,119918,6878,127023,"2016-04-01",2016
"16-Apr",서울,종로구,3546,44540,1600,49686,"2016-04-01",2016
"16-Apr",서울,중구,997,47743,3915,52655,"2016-04-01",2016
"16-Apr",서울,중랑구,190,101399,9549,111138,"2016-04-01",2016
"16-Apr",부산,계,4286,1188749,80070,1273105,"2016-04-01",2016
"16-Apr",부산,강서구,293,54745,3678,58716,"2016-04-01",2016
"16-Apr",부산,금정구,275,78328,7216,85819,"2016-04-01",2016
"16-Apr",부산,기장군,213,62948,2108,65269,"2016-04-01",2016
"16-Apr",부산,남구,209,86055,8972,95236,"2016-04-01",2016
"16-Apr",부산,동구,220,36881,6111,43212,"2016-04-01",2016
"16-Apr",부산,동래구,167,85098,4549,89814,"2016-04-01",2016
"16-Apr",부산,부산진구,375,122695,6067,129137,"2016-04-01",2016
"16-Apr",부산,북구,205,99370,3835,103410,"2016-04-01",2016
"16-Apr",부산,사상구,246,84317,6252,90815,"2016-04-01",2016
"16-Apr",부산,사하구,247,104963,7363,112573,"2016-04-01",2016
"16-Apr",부산,서구,132,27498,1319,28949,"2016-04-01",2016
"16-Apr",부산,수영구,148,64841,2965,67954,"2016-04-01",2016
"16-Apr",부산,연제구,781,81316,5458,87555,"2016-04-01",2016
"16-Apr",부산,영도구,209,31581,2560,34350,"2016-04-01",2016
"16-Apr",부산,중구,310,14612,6197,21119,"2016-04-01",2016
"16-Apr",부산,해운대구,256,153501,5420,159177,"2016-04-01",2016
"16-Apr",대구,계,2742,1063191,48785,1114718,"2016-04-01",2016
"16-Apr",대구,남구,179,56670,2072,58921,"2016-04-01",2016
"16-Apr",대구,달서구,414,246672,11840,258926,"2016-04-01",2016
"16-Apr",대구,달성군,389,93924,3447,97760,"2016-04-01",2016
"16-Apr",대구,동구,296,141969,11164,153429,"2016-04-01",2016
"16-Apr",대구,북구,416,181992,8563,190971,"2016-04-01",2016
"16-Apr",대구,서구,196,76590,4388,81174,"2016-04-01",2016
"16-Apr",대구,수성구,483,202691,5377,208551,"2016-04-01",2016
"16-Apr",대구,중구,369,62683,1934,64986,"2016-04-01",2016
"16-Apr",인천,계,3403,1133722,244034,1381159,"2016-04-01",2016
"16-Apr",인천,강화군,289,29321,2409,32019,"2016-04-01",2016
"16-Apr",인천,계양구,236,118937,118993,238166,"2016-04-01",2016
"16-Apr",인천,남구,359,133139,51118,184616,"2016-04-01",2016
"16-Apr",인천,남동구,774,230426,27451,258651,"2016-04-01",2016
"16-Apr",인천,동구,83,25541,2519,28143,"2016-04-01",2016
"16-Apr",인천,부평구,303,197957,7567,205827,"2016-04-01",2016
"16-Apr",인천,서구,347,199279,10568,210194,"2016-04-01",2016
"16-Apr",인천,연수구,283,139004,7302,146589,"2016-04-01",2016
"16-Apr",인천,옹진군,161,10344,165,10670,"2016-04-01",2016
"16-Apr",인천,중구,568,49774,15942,66284,"2016-04-01",2016
"16-Apr",광주,계,1921,582295,33313,617529,"2016-04-01",2016
"16-Apr",광주,광산구,476,166565,9685,176726,"2016-04-01",2016
"16-Apr",광주,남구,163,81361,3458,84982,"2016-04-01",2016
"16-Apr",광주,동구,209,34471,1143,35823,"2016-04-01",2016
"16-Apr",광주,북구,433,170825,9192,180450,"2016-04-01",2016
"16-Apr",광주,서구,640,129073,9835,139548,"2016-04-01",2016
"16-Apr",대전,계,1711,608385,27856,637952,"2016-04-01",2016
"16-Apr",대전,대덕구,260,84573,6493,91326,"2016-04-01",2016
"16-Apr",대전,동구,157,85809,4293,90259,"2016-04-01",2016
"16-Apr",대전,서구,715,192227,6612,199554,"2016-04-01",2016
"16-Apr",대전,유성구,366,151206,4786,156358,"2016-04-01",2016
"16-Apr",대전,중구,213,94570,5672,100455,"2016-04-01",2016
"16-Apr",울산,계,1512,508523,21340,531375,"2016-04-01",2016
"16-Apr",울산,남구,605,148934,7486,157025,"2016-04-01",2016
"16-Apr",울산,동구,184,62520,911,63615,"2016-04-01",2016
"16-Apr",울산,북구,110,88462,4441,93013,"2016-04-01",2016
"16-Apr",울산,울주군,308,107121,5789,113218,"2016-04-01",2016
"16-Apr",울산,중구,305,101486,2713,104504,"2016-04-01",2016
"16-Apr",세종,계,554,97741,2286,100581,"2016-04-01",2016
"16-Apr",세종,세종특별자치시,554,97741,2286,100581,"2016-04-01",2016
"16-Apr",경기,계,14346,4767367,215762,4997475,"2016-04-01",2016
"16-Apr",경기,가평군,339,26542,699,27580,"2016-04-01",2016
"16-Apr",경기,고양시 덕양구,567,148307,3569,152443,"2016-04-01",2016
"16-Apr",경기,고양시 일산동구,257,107666,6459,114382,"2016-04-01",2016
"16-Apr",경기,고양시 일산서구,71,103503,3246,106820,"2016-04-01",2016
"16-Apr",경기,과천시,672,22044,564,23280,"2016-04-01",2016
"16-Apr",경기,광명시,267,101522,4373,106162,"2016-04-01",2016
"16-Apr",경기,광주시,333,146740,7617,154690,"2016-04-01",2016
"16-Apr",경기,구리시,199,59278,2336,61813,"2016-04-01",2016
"16-Apr",경기,군포시,236,92374,4733,97343,"2016-04-01",2016
"16-Apr",경기,김포시,362,148640,5929,154931,"2016-04-01",2016
"16-Apr",경기,남양주시,507,242700,6855,250062,"2016-04-01",2016
"16-Apr",경기,동두천시,194,34744,1202,36140,"2016-04-01",2016
"16-Apr",경기,부천시 소사구,78,66227,2837,69142,"2016-04-01",2016
"16-Apr",경기,부천시 오정구,110,61716,2363,64189,"2016-04-01",2016
"16-Apr",경기,부천시 원미구,437,145586,6217,152240,"2016-04-01",2016
"16-Apr",경기,성남시 분당구,311,179512,5710,185533,"2016-04-01",2016
"16-Apr",경기,성남시 수정구,231,61827,2343,64401,"2016-04-01",2016
"16-Apr",경기,성남시 중원구,254,73831,3998,78083,"2016-04-01",2016
"16-Apr",경기,수원시 권선구,313,148351,7285,155949,"2016-04-01",2016
"16-Apr",경기,수원시 영통구,203,122324,2654,125181,"2016-04-01",2016
"16-Apr",경기,수원시 장안구,498,102083,3671,106252,"2016-04-01",2016
"16-Apr",경기,수원시 팔달구,503,69368,3440,73311,"2016-04-01",2016
"16-Apr",경기,시흥시,403,174919,7130,182452,"2016-04-01",2016
"16-Apr",경기,안산시 단원구,487,139798,8150,148435,"2016-04-01",2016
"16-Apr",경기,안산시 상록구,154,133510,4495,138159,"2016-04-01",2016
"16-Apr",경기,안성시,319,86532,4931,91782,"2016-04-01",2016
"16-Apr",경기,안양시 동안구,367,117058,6391,123816,"2016-04-01",2016
"16-Apr",경기,안양시 만안구,104,77404,3881,81389,"2016-04-01",2016
"16-Apr",경기,양주시,308,83449,2857,86614,"2016-04-01",2016
"16-Apr",경기,양평군,451,49067,1575,51093,"2016-04-01",2016
"16-Apr",경기,여주시,328,55222,7052,62602,"2016-04-01",2016
"16-Apr",경기,연천군,258,20766,5666,26690,"2016-04-01",2016
"16-Apr",경기,오산시,196,82187,3005,85388,"2016-04-01",2016
"16-Apr",경기,용인시 기흥구,88,158984,8431,167503,"2016-04-01",2016
"16-Apr",경기,용인시 수지구,43,123951,1761,125755,"2016-04-01",2016
"16-Apr",경기,용인시 처인구,571,100116,6501,107188,"2016-04-01",2016
"16-Apr",경기,의왕시,254,55447,2820,58521,"2016-04-01",2016
"16-Apr",경기,의정부시,496,134559,4796,139851,"2016-04-01",2016
"16-Apr",경기,이천시,351,94292,5698,100341,"2016-04-01",2016
"16-Apr",경기,파주시,366,172836,9963,183165,"2016-04-01",2016
"16-Apr",경기,평택시,564,209342,10144,220050,"2016-04-01",2016
"16-Apr",경기,포천시,324,76382,9946,86652,"2016-04-01",2016
"16-Apr",경기,하남시,298,68415,2064,70777,"2016-04-01",2016
"16-Apr",경기,화성시,674,288246,10405,299325,"2016-04-01",2016
"16-Apr",강원,계,4965,675565,24324,704854,"2016-04-01",2016
"16-Apr",강원,강릉시,467,95246,4169,99882,"2016-04-01",2016
"16-Apr",강원,고성군,137,12461,245,12843,"2016-04-01",2016
"16-Apr",강원,동해시,262,39908,1352,41522,"2016-04-01",2016
"16-Apr",강원,삼척시,318,28680,694,29692,"2016-04-01",2016
"16-Apr",강원,속초시,274,32619,1252,34145,"2016-04-01",2016
"16-Apr",강원,양구군,125,10581,123,10829,"2016-04-01",2016
"16-Apr",강원,양양군,138,13027,247,13412,"2016-04-01",2016
"16-Apr",강원,영월군,295,18632,396,19323,"2016-04-01",2016
"16-Apr",강원,원주시,491,143841,5732,150064,"2016-04-01",2016
"16-Apr",강원,인제군,176,15925,215,16316,"2016-04-01",2016
"16-Apr",강원,정선군,274,18595,470,19339,"2016-04-01",2016
"16-Apr",강원,철원군,179,21669,308,22156,"2016-04-01",2016
"16-Apr",강원,춘천시,676,114477,5879,121032,"2016-04-01",2016
"16-Apr",강원,태백시,192,19781,845,20818,"2016-04-01",2016
"16-Apr",강원,평창군,261,23254,418,23933,"2016-04-01",2016
"16-Apr",강원,홍천군,321,33505,1082,34908,"2016-04-01",2016
"16-Apr",강원,화천군,165,11205,134,11504,"2016-04-01",2016
"16-Apr",강원,횡성군,214,22159,763,23136,"2016-04-01",2016
"16-Apr",충북,계,3337,706248,31976,741561,"2016-04-01",2016
"16-Apr",충북,괴산군,163,19601,310,20074,"2016-04-01",2016
"16-Apr",충북,단양군,150,14129,829,15108,"2016-04-01",2016
"16-Apr",충북,보은군,180,16001,920,17101,"2016-04-01",2016
"16-Apr",충북,영동군,198,22787,379,23364,"2016-04-01",2016
"16-Apr",충북,옥천군,185,23653,1012,24850,"2016-04-01",2016
"16-Apr",충북,음성군,182,51515,1654,53351,"2016-04-01",2016
"16-Apr",충북,제천시,302,59717,3247,63266,"2016-04-01",2016
"16-Apr",충북,증평군,74,16465,749,17288,"2016-04-01",2016
"16-Apr",충북,진천군,173,35465,1068,36706,"2016-04-01",2016
"16-Apr",충북,청원군,1,39,1,41,"2016-04-01",2016
"16-Apr",충북,청주시 상당구,414,72040,2656,75110,"2016-04-01",2016
"16-Apr",충북,청주시 서원구,222,89197,5945,95364,"2016-04-01",2016
"16-Apr",충북,청주시 청원구,275,85545,3682,89502,"2016-04-01",2016
"16-Apr",충북,청주시 흥덕구,327,106656,5885,112868,"2016-04-01",2016
"16-Apr",충북,충주시,491,93438,3639,97568,"2016-04-01",2016
"16-Apr",충남,계,4675,943295,38754,986724,"2016-04-01",2016
"16-Apr",충남,계룡시,122,18790,472,19384,"2016-04-01",2016
"16-Apr",충남,공주시,500,49162,2095,51757,"2016-04-01",2016
"16-Apr",충남,금산군,158,25981,2422,28561,"2016-04-01",2016
"16-Apr",충남,논산시,316,55484,2134,57934,"2016-04-01",2016
"16-Apr",충남,당진시,328,81347,3588,85263,"2016-04-01",2016
"16-Apr",충남,보령시,316,46994,1248,48558,"2016-04-01",2016
"16-Apr",충남,부여군,223,31423,1384,33030,"2016-04-01",2016
"16-Apr",충남,서산시,353,78963,3475,82791,"2016-04-01",2016
"16-Apr",충남,서천군,193,25260,970,26423,"2016-04-01",2016
"16-Apr",충남,아산시,364,137192,6297,143853,"2016-04-01",2016
"16-Apr",충남,예산군,315,39098,1449,40862,"2016-04-01",2016
"16-Apr",충남,천안시 동남구,233,114486,5038,119757,"2016-04-01",2016
"16-Apr",충남,천안시 서북구,482,150471,5608,156561,"2016-04-01",2016
"16-Apr",충남,청양군,207,14902,838,15947,"2016-04-01",2016
"16-Apr",충남,태안군,214,29810,494,30518,"2016-04-01",2016
"16-Apr",충남,홍성군,351,43932,1242,45525,"2016-04-01",2016
"16-Apr",전북,계,4244,809267,36916,850427,"2016-04-01",2016
"16-Apr",전북,고창군,212,27537,514,28263,"2016-04-01",2016
"16-Apr",전북,군산시,422,118938,6816,126176,"2016-04-01",2016
"16-Apr",전북,김제시,239,41100,1805,43144,"2016-04-01",2016
"16-Apr",전북,남원시,368,36444,2431,39243,"2016-04-01",2016
"16-Apr",전북,무주군,148,11340,360,11848,"2016-04-01",2016
"16-Apr",전북,부안군,214,25371,604,26189,"2016-04-01",2016
"16-Apr",전북,순창군,181,12930,229,13340,"2016-04-01",2016
"16-Apr",전북,완주군,291,46109,3624,50024,"2016-04-01",2016
"16-Apr",전북,익산시,429,127220,6095,133744,"2016-04-01",2016
"16-Apr",전북,임실군,172,12768,403,13343,"2016-04-01",2016
"16-Apr",전북,장수군,181,10708,162,11051,"2016-04-01",2016
"16-Apr",전북,전주시 덕진구,348,133940,7536,141824,"2016-04-01",2016
"16-Apr",전북,전주시 완산구,560,143685,3919,148164,"2016-04-01",2016
"16-Apr",전북,정읍시,276,48788,2228,51292,"2016-04-01",2016
"16-Apr",전북,진안군,203,12389,190,12782,"2016-04-01",2016
"16-Apr",전남,계,5275,822544,89567,917386,"2016-04-01",2016
"16-Apr",전남,강진군,181,16809,970,17960,"2016-04-01",2016
"16-Apr",전남,고흥군,227,27736,664,28627,"2016-04-01",2016
"16-Apr",전남,곡성군,141,13285,854,14280,"2016-04-01",2016
"16-Apr",전남,광양시,230,71173,5871,77274,"2016-04-01",2016
"16-Apr",전남,구례군,102,11745,733,12580,"2016-04-01",2016
"16-Apr",전남,나주시,352,48341,3164,51857,"2016-04-01",2016
"16-Apr",전남,담양군,176,23455,1574,25205,"2016-04-01",2016
"16-Apr",전남,목포시,440,88807,6000,95247,"2016-04-01",2016
"16-Apr",전남,무안군,436,37234,982,38652,"2016-04-01",2016
"16-Apr",전남,보성군,215,19651,30140,50006,"2016-04-01",2016
"16-Apr",전남,순천시,434,118255,4760,123449,"2016-04-01",2016
"16-Apr",전남,신안군,194,18314,650,19158,"2016-04-01",2016
"16-Apr",전남,여수시,478,115670,6339,122487,"2016-04-01",2016
"16-Apr",전남,영광군,200,24622,717,25539,"2016-04-01",2016
"16-Apr",전남,영암군,212,30340,20597,51149,"2016-04-01",2016
"16-Apr",전남,완도군,193,21865,475,22533,"2016-04-01",2016
"16-Apr",전남,장성군,134,22600,1245,23979,"2016-04-01",2016
"16-Apr",전남,장흥군,173,18059,444,18676,"2016-04-01",2016
"16-Apr",전남,진도군,132,14677,290,15099,"2016-04-01",2016
"16-Apr",전남,함평군,145,15900,393,16438,"2016-04-01",2016
"16-Apr",전남,해남군,286,35087,572,35945,"2016-04-01",2016
"16-Apr",전남,화순군,194,28919,2133,31246,"2016-04-01",2016
"16-Apr",경북,계,6255,1272811,48944,1328010,"2016-04-01",2016
"16-Apr",경북,경산시,374,121295,4120,125789,"2016-04-01",2016
"16-Apr",경북,경주시,496,126845,5142,132483,"2016-04-01",2016
"16-Apr",경북,고령군,140,19543,432,20115,"2016-04-01",2016
"16-Apr",경북,구미시,434,189521,7637,197592,"2016-04-01",2016
"16-Apr",경북,군위군,103,12920,285,13308,"2016-04-01",2016
"16-Apr",경북,김천시,315,64553,1734,66602,"2016-04-01",2016
"16-Apr",경북,문경시,246,32941,916,34103,"2016-04-01",2016
"16-Apr",경북,봉화군,173,15836,205,16214,"2016-04-01",2016
"16-Apr",경북,상주시,336,47574,1801,49711,"2016-04-01",2016
"16-Apr",경북,성주군,168,27113,1419,28700,"2016-04-01",2016
"16-Apr",경북,안동시,511,75839,2590,78940,"2016-04-01",2016
"16-Apr",경북,영덕군,207,17298,300,17805,"2016-04-01",2016
"16-Apr",경북,영양군,124,8454,106,8684,"2016-04-01",2016
"16-Apr",경북,영주시,305,51370,1653,53328,"2016-04-01",2016
"16-Apr",경북,영천시,231,51767,2611,54609,"2016-04-01",2016
"16-Apr",경북,예천군,170,21012,412,21594,"2016-04-01",2016
"16-Apr",경북,울릉군,130,4583,400,5113,"2016-04-01",2016
"16-Apr",경북,울진군,241,23474,395,24110,"2016-04-01",2016
"16-Apr",경북,의성군,277,26975,978,28230,"2016-04-01",2016
"16-Apr",경북,청도군,145,22213,637,22995,"2016-04-01",2016
"16-Apr",경북,청송군,179,13635,205,14019,"2016-04-01",2016
"16-Apr",경북,칠곡군,306,63369,2010,65685,"2016-04-01",2016
"16-Apr",경북,포항시 남구,340,113590,9044,122974,"2016-04-01",2016
"16-Apr",경북,포항시 북구,304,121091,3912,125307,"2016-04-01",2016
"16-Apr",경남,계,6145,1508424,78606,1593175,"2016-04-01",2016
"16-Apr",경남,거제시,283,101788,2701,104772,"2016-04-01",2016
"16-Apr",경남,거창군,226,28227,789,29242,"2016-04-01",2016
"16-Apr",경남,고성군,207,24638,718,25563,"2016-04-01",2016
"16-Apr",경남,김해시,568,238267,6540,245375,"2016-04-01",2016
"16-Apr",경남,남해군,203,17413,527,18143,"2016-04-01",2016
"16-Apr",경남,밀양시,284,50251,4330,54865,"2016-04-01",2016
"16-Apr",경남,사천시,269,50022,1552,51843,"2016-04-01",2016
"16-Apr",경남,산청군,179,17396,788,18363,"2016-04-01",2016
"16-Apr",경남,양산시,343,127948,8809,137100,"2016-04-01",2016
"16-Apr",경남,의령군,163,12571,757,13491,"2016-04-01",2016
"16-Apr",경남,진주시,547,145592,6717,152856,"2016-04-01",2016
"16-Apr",경남,창녕군,197,31739,802,32738,"2016-04-01",2016
"16-Apr",경남,창원시 마산합포구,311,92922,3094,96327,"2016-04-01",2016
"16-Apr",경남,창원시 마산회원구,162,97767,5397,103326,"2016-04-01",2016
"16-Apr",경남,창원시 성산구,140,120809,15044,135993,"2016-04-01",2016
"16-Apr",경남,창원시 의창구,824,121201,5321,127346,"2016-04-01",2016
"16-Apr",경남,창원시 진해구,183,77305,1538,79026,"2016-04-01",2016
"16-Apr",경남,통영시,279,50259,1552,52090,"2016-04-01",2016
"16-Apr",경남,하동군,199,22496,443,23138,"2016-04-01",2016
"16-Apr",경남,함안군,165,40703,9559,50427,"2016-04-01",2016
"16-Apr",경남,함양군,185,18261,670,19116,"2016-04-01",2016
"16-Apr",경남,합천군,228,20849,958,22035,"2016-04-01",2016
"16-Apr",제주,계,1877,344537,100483,446897,"2016-04-01",2016
"16-Apr",제주,서귀포시,616,86228,2354,89198,"2016-04-01",2016
"16-Apr",제주,제주시,1261,258309,98129,357699,"2016-04-01",2016
"16-May",서울,계,11150,2866614,195499,3073263,"2016-05-01",2016
"16-May",서울,강남구,358,223276,19380,243014,"2016-05-01",2016
"16-May",서울,강동구,219,128485,8465,137169,"2016-05-01",2016
"16-May",서울,강북구,279,71190,4847,76316,"2016-05-01",2016
"16-May",서울,강서구,294,177437,14841,192572,"2016-05-01",2016
"16-May",서울,관악구,271,115627,5820,121718,"2016-05-01",2016
"16-May",서울,광진구,277,91060,5589,96926,"2016-05-01",2016
"16-May",서울,구로구,232,128514,11196,139942,"2016-05-01",2016
"16-May",서울,금천구,123,75839,7549,83511,"2016-05-01",2016
"16-May",서울,노원구,255,145879,9763,155897,"2016-05-01",2016
"16-May",서울,도봉구,236,88676,7731,96643,"2016-05-01",2016
"16-May",서울,동대문구,268,91061,5835,97164,"2016-05-01",2016
"16-May",서울,동작구,275,100029,2797,103101,"2016-05-01",2016
"16-May",서울,마포구,281,109517,7450,117248,"2016-05-01",2016
"16-May",서울,서대문구,409,78686,5070,84165,"2016-05-01",2016
"16-May",서울,서초구,596,168239,10319,179154,"2016-05-01",2016
"16-May",서울,성동구,270,88155,8425,96850,"2016-05-01",2016
"16-May",서울,성북구,230,111168,5512,116910,"2016-05-01",2016
"16-May",서울,송파구,343,207716,11725,219784,"2016-05-01",2016
"16-May",서울,양천구,306,140754,9060,150120,"2016-05-01",2016
"16-May",서울,영등포구,299,137808,10181,148288,"2016-05-01",2016
"16-May",서울,용산구,365,73625,2062,76052,"2016-05-01",2016
"16-May",서울,은평구,226,120125,6883,127234,"2016-05-01",2016
"16-May",서울,종로구,3558,44450,1606,49614,"2016-05-01",2016
"16-May",서울,중구,990,47634,3889,52513,"2016-05-01",2016
"16-May",서울,중랑구,190,101664,9504,111358,"2016-05-01",2016
"16-May",부산,계,4251,1191995,80173,1276419,"2016-05-01",2016
"16-May",부산,강서구,295,55567,3647,59509,"2016-05-01",2016
"16-May",부산,금정구,270,78427,7189,85886,"2016-05-01",2016
"16-May",부산,기장군,212,63362,2133,65707,"2016-05-01",2016
"16-May",부산,남구,204,86287,8974,95465,"2016-05-01",2016
"16-May",부산,동구,217,36863,6041,43121,"2016-05-01",2016
"16-May",부산,동래구,166,85227,4579,89972,"2016-05-01",2016
"16-May",부산,부산진구,363,122563,6057,128983,"2016-05-01",2016
"16-May",부산,북구,206,99667,3844,103717,"2016-05-01",2016
"16-May",부산,사상구,245,84462,6254,90961,"2016-05-01",2016
"16-May",부산,사하구,246,105240,7364,112850,"2016-05-01",2016
"16-May",부산,서구,127,27533,1321,28981,"2016-05-01",2016
"16-May",부산,수영구,148,64889,2963,68000,"2016-05-01",2016
"16-May",부산,연제구,785,81664,5600,88049,"2016-05-01",2016
"16-May",부산,영도구,209,31585,2564,34358,"2016-05-01",2016
"16-May",부산,중구,306,14662,6208,21176,"2016-05-01",2016
"16-May",부산,해운대구,252,153997,5435,159684,"2016-05-01",2016
"16-May",대구,계,2754,1065169,48699,1116622,"2016-05-01",2016
"16-May",대구,남구,292,56693,2139,59124,"2016-05-01",2016
"16-May",대구,달서구,413,246848,11974,259235,"2016-05-01",2016
"16-May",대구,달성군,394,95013,3460,98867,"2016-05-01",2016
"16-May",대구,동구,299,142394,11081,153774,"2016-05-01",2016
"16-May",대구,북구,415,182624,8365,191404,"2016-05-01",2016
"16-May",대구,서구,194,76424,4449,81067,"2016-05-01",2016
"16-May",대구,수성구,489,202553,5325,208367,"2016-05-01",2016
"16-May",대구,중구,258,62620,1906,64784,"2016-05-01",2016
"16-May",인천,계,3396,1141036,246855,1391287,"2016-05-01",2016
"16-May",인천,강화군,285,29392,2874,32551,"2016-05-01",2016
"16-May",인천,계양구,235,119162,120847,240244,"2016-05-01",2016
"16-May",인천,남구,359,133893,51155,185407,"2016-05-01",2016
"16-May",인천,남동구,770,232647,28082,261499,"2016-05-01",2016
"16-May",인천,동구,83,25675,2529,28287,"2016-05-01",2016
"16-May",인천,부평구,303,199540,7369,207212,"2016-05-01",2016
"16-May",인천,서구,348,200268,10536,211152,"2016-05-01",2016
"16-May",인천,연수구,273,140077,7346,147696,"2016-05-01",2016
"16-May",인천,옹진군,164,10456,167,10787,"2016-05-01",2016
"16-May",인천,중구,576,49926,15950,66452,"2016-05-01",2016
"16-May",광주,계,1915,584061,33219,619195,"2016-05-01",2016
"16-May",광주,광산구,477,167232,9611,177320,"2016-05-01",2016
"16-May",광주,남구,162,81448,3399,85009,"2016-05-01",2016
"16-May",광주,동구,213,34535,1151,35899,"2016-05-01",2016
"16-May",광주,북구,431,171173,9319,180923,"2016-05-01",2016
"16-May",광주,서구,632,129673,9739,140044,"2016-05-01",2016
"16-May",대전,계,1719,610004,27883,639606,"2016-05-01",2016
"16-May",대전,대덕구,262,84822,6488,91572,"2016-05-01",2016
"16-May",대전,동구,159,85943,4310,90412,"2016-05-01",2016
"16-May",대전,서구,724,192742,6619,200085,"2016-05-01",2016
"16-May",대전,유성구,361,151752,4792,156905,"2016-05-01",2016
"16-May",대전,중구,213,94745,5674,100632,"2016-05-01",2016
"16-May",울산,계,1500,509922,21380,532802,"2016-05-01",2016
"16-May",울산,남구,599,149268,7517,157384,"2016-05-01",2016
"16-May",울산,동구,183,62477,911,63571,"2016-05-01",2016
"16-May",울산,북구,109,89193,4465,93767,"2016-05-01",2016
"16-May",울산,울주군,304,107475,5803,113582,"2016-05-01",2016
"16-May",울산,중구,305,101509,2684,104498,"2016-05-01",2016
"16-May",세종,계,560,99028,2288,101876,"2016-05-01",2016
"16-May",세종,세종특별자치시,560,99028,2288,101876,"2016-05-01",2016
"16-May",경기,계,14546,4787772,216246,5018564,"2016-05-01",2016
"16-May",경기,가평군,338,26655,697,27690,"2016-05-01",2016
"16-May",경기,고양시 덕양구,574,148708,3598,152880,"2016-05-01",2016
"16-May",경기,고양시 일산동구,260,108032,6322,114614,"2016-05-01",2016
"16-May",경기,고양시 일산서구,71,103864,3315,107250,"2016-05-01",2016
"16-May",경기,과천시,710,21937,565,23212,"2016-05-01",2016
"16-May",경기,광명시,266,101769,4356,106391,"2016-05-01",2016
"16-May",경기,광주시,337,147609,7698,155644,"2016-05-01",2016
"16-May",경기,구리시,200,59385,2366,61951,"2016-05-01",2016
"16-May",경기,군포시,234,92588,4730,97552,"2016-05-01",2016
"16-May",경기,김포시,361,149332,5960,155653,"2016-05-01",2016
"16-May",경기,남양주시,507,243825,6886,251218,"2016-05-01",2016
"16-May",경기,동두천시,193,34865,1211,36269,"2016-05-01",2016
"16-May",경기,부천시 소사구,78,66434,2832,69344,"2016-05-01",2016
"16-May",경기,부천시 오정구,110,61932,2381,64423,"2016-05-01",2016
"16-May",경기,부천시 원미구,438,145905,6233,152576,"2016-05-01",2016
"16-May",경기,성남시 분당구,312,179772,5872,185956,"2016-05-01",2016
"16-May",경기,성남시 수정구,295,62294,2384,64973,"2016-05-01",2016
"16-May",경기,성남시 중원구,253,74038,4020,78311,"2016-05-01",2016
"16-May",경기,수원시 권선구,307,149375,7296,156978,"2016-05-01",2016
"16-May",경기,수원시 영통구,204,122938,2660,125802,"2016-05-01",2016
"16-May",경기,수원시 장안구,547,102425,3678,106650,"2016-05-01",2016
"16-May",경기,수원시 팔달구,464,69681,3419,73564,"2016-05-01",2016
"16-May",경기,시흥시,412,175620,7183,183215,"2016-05-01",2016
"16-May",경기,안산시 단원구,491,140134,8333,148958,"2016-05-01",2016
"16-May",경기,안산시 상록구,154,133948,4465,138567,"2016-05-01",2016
"16-May",경기,안성시,320,86995,4919,92234,"2016-05-01",2016
"16-May",경기,안양시 동안구,368,117291,6372,124031,"2016-05-01",2016
"16-May",경기,안양시 만안구,134,77637,3879,81650,"2016-05-01",2016
"16-May",경기,양주시,308,83727,2863,86898,"2016-05-01",2016
"16-May",경기,양평군,453,49387,1578,51418,"2016-05-01",2016
"16-May",경기,여주시,337,55352,7081,62770,"2016-05-01",2016
"16-May",경기,연천군,265,20914,5663,26842,"2016-05-01",2016
"16-May",경기,오산시,199,82692,3012,85903,"2016-05-01",2016
"16-May",경기,용인시 기흥구,88,159380,8389,167857,"2016-05-01",2016
"16-May",경기,용인시 수지구,42,124361,1761,126164,"2016-05-01",2016
"16-May",경기,용인시 처인구,576,100558,6513,107647,"2016-05-01",2016
"16-May",경기,의왕시,254,55566,2816,58636,"2016-05-01",2016
"16-May",경기,의정부시,499,135135,4784,140418,"2016-05-01",2016
"16-May",경기,이천시,350,94785,5678,100813,"2016-05-01",2016
"16-May",경기,파주시,368,173468,9966,183802,"2016-05-01",2016
"16-May",경기,평택시,572,210238,10174,220984,"2016-05-01",2016
"16-May",경기,포천시,326,76734,9842,86902,"2016-05-01",2016
"16-May",경기,하남시,295,70019,2059,72373,"2016-05-01",2016
"16-May",경기,화성시,676,290468,10437,301581,"2016-05-01",2016
"16-May",강원,계,4977,678245,24348,707570,"2016-05-01",2016
"16-May",강원,강릉시,471,95499,4173,100143,"2016-05-01",2016
"16-May",강원,고성군,137,12510,244,12891,"2016-05-01",2016
"16-May",강원,동해시,264,40046,1359,41669,"2016-05-01",2016
"16-May",강원,삼척시,321,28797,697,29815,"2016-05-01",2016
"16-May",강원,속초시,277,32765,1240,34282,"2016-05-01",2016
"16-May",강원,양구군,123,10600,121,10844,"2016-05-01",2016
"16-May",강원,양양군,136,13117,247,13500,"2016-05-01",2016
"16-May",강원,영월군,296,18692,396,19384,"2016-05-01",2016
"16-May",강원,원주시,493,144454,5750,150697,"2016-05-01",2016
"16-May",강원,인제군,177,16027,213,16417,"2016-05-01",2016
"16-May",강원,정선군,276,18643,473,19392,"2016-05-01",2016
"16-May",강원,철원군,178,21741,308,22227,"2016-05-01",2016
"16-May",강원,춘천시,674,114967,5869,121510,"2016-05-01",2016
"16-May",강원,태백시,192,19872,840,20904,"2016-05-01",2016
"16-May",강원,평창군,261,23315,418,23994,"2016-05-01",2016
"16-May",강원,홍천군,321,33660,1094,35075,"2016-05-01",2016
"16-May",강원,화천군,167,11278,134,11579,"2016-05-01",2016
"16-May",강원,횡성군,213,22262,772,23247,"2016-05-01",2016
"16-May",충북,계,3341,708897,32087,744325,"2016-05-01",2016
"16-May",충북,괴산군,164,19686,322,20172,"2016-05-01",2016
"16-May",충북,단양군,151,14211,829,15191,"2016-05-01",2016
"16-May",충북,보은군,180,16073,921,17174,"2016-05-01",2016
"16-May",충북,영동군,199,22861,379,23439,"2016-05-01",2016
"16-May",충북,옥천군,182,23724,1006,24912,"2016-05-01",2016
"16-May",충북,음성군,182,51782,1658,53622,"2016-05-01",2016
"16-May",충북,제천시,302,59918,3255,63475,"2016-05-01",2016
"16-May",충북,증평군,73,16530,748,17351,"2016-05-01",2016
"16-May",충북,진천군,172,35636,1072,36880,"2016-05-01",2016
"16-May",충북,청원군,1,39,1,41,"2016-05-01",2016
"16-May",충북,청주시 상당구,413,72235,2626,75274,"2016-05-01",2016
"16-May",충북,청주시 서원구,221,89444,6005,95670,"2016-05-01",2016
"16-May",충북,청주시 청원구,280,85957,3696,89933,"2016-05-01",2016
"16-May",충북,청주시 흥덕구,331,106924,5936,113191,"2016-05-01",2016
"16-May",충북,충주시,490,93877,3633,98000,"2016-05-01",2016
"16-May",충남,계,4659,947876,38764,991299,"2016-05-01",2016
"16-May",충남,계룡시,122,18881,471,19474,"2016-05-01",2016
"16-May",충남,공주시,493,49354,2087,51934,"2016-05-01",2016
"16-May",충남,금산군,157,26096,2406,28659,"2016-05-01",2016
"16-May",충남,논산시,315,55662,2126,58103,"2016-05-01",2016
"16-May",충남,당진시,329,81631,3595,85555,"2016-05-01",2016
"16-May",충남,보령시,314,47095,1295,48704,"2016-05-01",2016
"16-May",충남,부여군,222,31511,1388,33121,"2016-05-01",2016
"16-May",충남,서산시,357,79249,3496,83102,"2016-05-01",2016
"16-May",충남,서천군,187,25369,964,26520,"2016-05-01",2016
"16-May",충남,아산시,360,137941,6253,144554,"2016-05-01",2016
"16-May",충남,예산군,312,39025,1444,40781,"2016-05-01",2016
"16-May",충남,천안시 동남구,229,114915,5037,120181,"2016-05-01",2016
"16-May",충남,천안시 서북구,485,151664,5599,157748,"2016-05-01",2016
"16-May",충남,청양군,208,14952,855,16015,"2016-05-01",2016
"16-May",충남,태안군,211,29952,489,30652,"2016-05-01",2016
"16-May",충남,홍성군,358,44579,1259,46196,"2016-05-01",2016
"16-May",전북,계,4286,812248,36870,853404,"2016-05-01",2016
"16-May",전북,고창군,215,27602,513,28330,"2016-05-01",2016
"16-May",전북,군산시,424,119281,6829,126534,"2016-05-01",2016
"16-May",전북,김제시,242,41285,1808,43335,"2016-05-01",2016
"16-May",전북,남원시,367,36626,2372,39365,"2016-05-01",2016
"16-May",전북,무주군,149,11379,361,11889,"2016-05-01",2016
"16-May",전북,부안군,229,25430,594,26253,"2016-05-01",2016
"16-May",전북,순창군,182,12937,226,13345,"2016-05-01",2016
"16-May",전북,완주군,297,46318,3608,50223,"2016-05-01",2016
"16-May",전북,익산시,434,127636,6122,134192,"2016-05-01",2016
"16-May",전북,임실군,169,12855,403,13427,"2016-05-01",2016
"16-May",전북,장수군,182,10755,160,11097,"2016-05-01",2016
"16-May",전북,전주시 덕진구,353,134691,7550,142594,"2016-05-01",2016
"16-May",전북,전주시 완산구,565,144028,3915,148508,"2016-05-01",2016
"16-May",전북,정읍시,276,48973,2220,51469,"2016-05-01",2016
"16-May",전북,진안군,202,12452,189,12843,"2016-05-01",2016
"16-May",전남,계,5224,825404,91154,921782,"2016-05-01",2016
"16-May",전남,강진군,181,16846,971,17998,"2016-05-01",2016
"16-May",전남,고흥군,231,27861,667,28759,"2016-05-01",2016
"16-May",전남,곡성군,141,13358,892,14391,"2016-05-01",2016
"16-May",전남,광양시,222,71361,5894,77477,"2016-05-01",2016
"16-May",전남,구례군,103,11788,695,12586,"2016-05-01",2016
"16-May",전남,나주시,353,48499,3134,51986,"2016-05-01",2016
"16-May",전남,담양군,169,23525,1582,25276,"2016-05-01",2016
"16-May",전남,목포시,441,89063,6025,95529,"2016-05-01",2016
"16-May",전남,무안군,415,37433,1124,38972,"2016-05-01",2016
"16-May",전남,보성군,207,19713,31857,51777,"2016-05-01",2016
"16-May",전남,순천시,442,118743,4777,123962,"2016-05-01",2016
"16-May",전남,신안군,191,18381,645,19217,"2016-05-01",2016
"16-May",전남,여수시,465,116109,6402,122976,"2016-05-01",2016
"16-May",전남,영광군,197,24677,713,25587,"2016-05-01",2016
"16-May",전남,영암군,213,30375,20191,50779,"2016-05-01",2016
"16-May",전남,완도군,192,21983,463,22638,"2016-05-01",2016
"16-May",전남,장성군,134,22681,1228,24043,"2016-05-01",2016
"16-May",전남,장흥군,171,18113,439,18723,"2016-05-01",2016
"16-May",전남,진도군,131,14711,288,15130,"2016-05-01",2016
"16-May",전남,함평군,145,15956,392,16493,"2016-05-01",2016
"16-May",전남,해남군,285,35216,617,36118,"2016-05-01",2016
"16-May",전남,화순군,195,29012,2158,31365,"2016-05-01",2016
"16-May",경북,계,6276,1277283,49057,1332616,"2016-05-01",2016
"16-May",경북,경산시,380,121951,4139,126470,"2016-05-01",2016
"16-May",경북,경주시,498,127241,5160,132899,"2016-05-01",2016
"16-May",경북,고령군,140,19626,432,20198,"2016-05-01",2016
"16-May",경북,구미시,437,190215,7671,198323,"2016-05-01",2016
"16-May",경북,군위군,105,12998,284,13387,"2016-05-01",2016
"16-May",경북,김천시,319,64824,1749,66892,"2016-05-01",2016
"16-May",경북,문경시,245,33017,918,34180,"2016-05-01",2016
"16-May",경북,봉화군,175,15860,203,16238,"2016-05-01",2016
"16-May",경북,상주시,334,47689,1807,49830,"2016-05-01",2016
"16-May",경북,성주군,165,27207,1445,28817,"2016-05-01",2016
"16-May",경북,안동시,521,76005,2585,79111,"2016-05-01",2016
"16-May",경북,영덕군,204,17345,301,17850,"2016-05-01",2016
"16-May",경북,영양군,122,8467,106,8695,"2016-05-01",2016
"16-May",경북,영주시,305,51503,1648,53456,"2016-05-01",2016
"16-May",경북,영천시,231,51980,2632,54843,"2016-05-01",2016
"16-May",경북,예천군,170,21182,414,21766,"2016-05-01",2016
"16-May",경북,울릉군,130,4614,398,5142,"2016-05-01",2016
"16-May",경북,울진군,237,23581,400,24218,"2016-05-01",2016
"16-May",경북,의성군,277,27083,977,28337,"2016-05-01",2016
"16-May",경북,청도군,146,22285,636,23067,"2016-05-01",2016
"16-May",경북,청송군,179,13672,206,14057,"2016-05-01",2016
"16-May",경북,칠곡군,306,63674,2029,66009,"2016-05-01",2016
"16-May",경북,포항시 남구,342,113745,9032,123119,"2016-05-01",2016
"16-May",경북,포항시 북구,308,121519,3885,125712,"2016-05-01",2016
"16-May",경남,계,6173,1512737,79276,1598186,"2016-05-01",2016
"16-May",경남,거제시,290,101923,2692,104905,"2016-05-01",2016
"16-May",경남,거창군,224,28338,787,29349,"2016-05-01",2016
"16-May",경남,고성군,206,24697,716,25619,"2016-05-01",2016
"16-May",경남,김해시,573,238989,6539,246101,"2016-05-01",2016
"16-May",경남,남해군,202,17460,522,18184,"2016-05-01",2016
"16-May",경남,밀양시,282,50461,4314,55057,"2016-05-01",2016
"16-May",경남,사천시,272,50159,1548,51979,"2016-05-01",2016
"16-May",경남,산청군,176,17460,779,18415,"2016-05-01",2016
"16-May",경남,양산시,341,128905,8821,138067,"2016-05-01",2016
"16-May",경남,의령군,162,12576,760,13498,"2016-05-01",2016
"16-May",경남,진주시,550,146159,6736,153445,"2016-05-01",2016
"16-May",경남,창녕군,197,31823,789,32809,"2016-05-01",2016
"16-May",경남,창원시 마산합포구,314,93104,3141,96559,"2016-05-01",2016
"16-May",경남,창원시 마산회원구,165,97846,5403,103414,"2016-05-01",2016
"16-May",경남,창원시 성산구,142,120931,15600,136673,"2016-05-01",2016
"16-May",경남,창원시 의창구,834,121555,5375,127764,"2016-05-01",2016
"16-May",경남,창원시 진해구,186,77492,1546,79224,"2016-05-01",2016
"16-May",경남,통영시,281,50442,1545,52268,"2016-05-01",2016
"16-May",경남,하동군,198,22561,446,23205,"2016-05-01",2016
"16-May",경남,함안군,166,40836,9636,50638,"2016-05-01",2016
"16-May",경남,함양군,185,18127,613,18925,"2016-05-01",2016
"16-May",경남,합천군,227,20893,968,22088,"2016-05-01",2016
"16-May",제주,계,1891,345887,101904,449682,"2016-05-01",2016
"16-May",제주,서귀포시,621,86887,2345,89853,"2016-05-01",2016
"16-May",제주,제주시,1270,259000,99559,359829,"2016-05-01",2016
"16-Jun",서울,계,11286,2871808,195947,3079041,"2016-06-01",2016
"16-Jun",서울,강남구,359,223428,19223,243010,"2016-06-01",2016
"16-Jun",서울,강동구,220,128396,8491,137107,"2016-06-01",2016
"16-Jun",서울,강북구,282,71339,4897,76518,"2016-06-01",2016
"16-Jun",서울,강서구,283,178108,14809,193200,"2016-06-01",2016
"16-Jun",서울,관악구,272,115869,5823,121964,"2016-06-01",2016
"16-Jun",서울,광진구,278,91195,5601,97074,"2016-06-01",2016
"16-Jun",서울,구로구,232,128668,11295,140195,"2016-06-01",2016
"16-Jun",서울,금천구,123,75984,7474,83581,"2016-06-01",2016
"16-Jun",서울,노원구,257,146184,9770,156211,"2016-06-01",2016
"16-Jun",서울,도봉구,230,88871,7736,96837,"2016-06-01",2016
"16-Jun",서울,동대문구,271,91241,5884,97396,"2016-06-01",2016
"16-Jun",서울,동작구,277,100555,2811,103643,"2016-06-01",2016
"16-Jun",서울,마포구,278,109573,7554,117405,"2016-06-01",2016
"16-Jun",서울,서대문구,432,78789,5244,84465,"2016-06-01",2016
"16-Jun",서울,서초구,594,168411,10280,179285,"2016-06-01",2016
"16-Jun",서울,성동구,272,88781,8635,97688,"2016-06-01",2016
"16-Jun",서울,성북구,230,111210,5520,116960,"2016-06-01",2016
"16-Jun",서울,송파구,347,208158,11653,220158,"2016-06-01",2016
"16-Jun",서울,양천구,303,141193,9145,150641,"2016-06-01",2016
"16-Jun",서울,영등포구,299,138053,10156,148508,"2016-06-01",2016
"16-Jun",서울,용산구,365,73594,2060,76019,"2016-06-01",2016
"16-Jun",서울,은평구,226,120346,6896,127468,"2016-06-01",2016
"16-Jun",서울,종로구,3624,44414,1607,49645,"2016-06-01",2016
"16-Jun",서울,중구,1041,47524,3869,52434,"2016-06-01",2016
"16-Jun",서울,중랑구,191,101924,9514,111629,"2016-06-01",2016
"16-Jun",부산,계,4315,1196644,80387,1281346,"2016-06-01",2016
"16-Jun",부산,강서구,303,56375,3672,60350,"2016-06-01",2016
"16-Jun",부산,금정구,270,78598,7297,86165,"2016-06-01",2016
"16-Jun",부산,기장군,217,63810,2141,66168,"2016-06-01",2016
"16-Jun",부산,남구,204,86623,8933,95760,"2016-06-01",2016
"16-Jun",부산,동구,221,36736,6020,42977,"2016-06-01",2016
"16-Jun",부산,동래구,166,85467,4545,90178,"2016-06-01",2016
"16-Jun",부산,부산진구,367,122782,5989,129138,"2016-06-01",2016
"16-Jun",부산,북구,211,99894,3845,103950,"2016-06-01",2016
"16-Jun",부산,사상구,262,84655,6253,91170,"2016-06-01",2016
"16-Jun",부산,사하구,250,105593,7135,112978,"2016-06-01",2016
"16-Jun",부산,서구,125,27568,1337,29030,"2016-06-01",2016
"16-Jun",부산,수영구,151,64898,2987,68036,"2016-06-01",2016
"16-Jun",부산,연제구,792,82593,6016,89401,"2016-06-01",2016
"16-Jun",부산,영도구,217,31619,2560,34396,"2016-06-01",2016
"16-Jun",부산,중구,308,15007,6211,21526,"2016-06-01",2016
"16-Jun",부산,해운대구,251,154426,5446,160123,"2016-06-01",2016
"16-Jun",대구,계,2791,1069797,48697,1121285,"2016-06-01",2016
"16-Jun",대구,남구,294,56665,2132,59091,"2016-06-01",2016
"16-Jun",대구,달서구,419,251561,12029,264009,"2016-06-01",2016
"16-Jun",대구,달성군,397,95857,3466,99720,"2016-06-01",2016
"16-Jun",대구,동구,305,143101,10949,154355,"2016-06-01",2016
"16-Jun",대구,북구,424,183791,8386,192601,"2016-06-01",2016
"16-Jun",대구,서구,196,76676,4474,81346,"2016-06-01",2016
"16-Jun",대구,수성구,494,203554,5352,209400,"2016-06-01",2016
"16-Jun",대구,중구,262,58592,1909,60763,"2016-06-01",2016
"16-Jun",인천,계,3426,1147918,250712,1402056,"2016-06-01",2016
"16-Jun",인천,강화군,286,29541,2896,32723,"2016-06-01",2016
"16-Jun",인천,계양구,239,119567,122958,242764,"2016-06-01",2016
"16-Jun",인천,남구,361,134708,51277,186346,"2016-06-01",2016
"16-Jun",인천,남동구,779,234095,29330,264204,"2016-06-01",2016
"16-Jun",인천,동구,84,25765,2554,28403,"2016-06-01",2016
"16-Jun",인천,부평구,304,201223,7392,208919,"2016-06-01",2016
"16-Jun",인천,서구,349,201375,10651,212375,"2016-06-01",2016
"16-Jun",인천,연수구,276,140958,7204,148438,"2016-06-01",2016
"16-Jun",인천,옹진군,165,10536,164,10865,"2016-06-01",2016
"16-Jun",인천,중구,583,50150,16286,67019,"2016-06-01",2016
"16-Jun",광주,계,1938,586472,33273,621683,"2016-06-01",2016
"16-Jun",광주,광산구,476,167905,9629,178010,"2016-06-01",2016
"16-Jun",광주,남구,167,81646,3380,85193,"2016-06-01",2016
"16-Jun",광주,동구,218,34676,1231,36125,"2016-06-01",2016
"16-Jun",광주,북구,442,171633,9344,181419,"2016-06-01",2016
"16-Jun",광주,서구,635,130612,9689,140936,"2016-06-01",2016
"16-Jun",대전,계,1732,612142,27972,641846,"2016-06-01",2016
"16-Jun",대전,대덕구,270,85152,6464,91886,"2016-06-01",2016
"16-Jun",대전,동구,159,86049,4322,90530,"2016-06-01",2016
"16-Jun",대전,서구,726,193295,6695,200716,"2016-06-01",2016
"16-Jun",대전,유성구,364,152762,4769,157895,"2016-06-01",2016
"16-Jun",대전,중구,213,94884,5722,100819,"2016-06-01",2016
"16-Jun",울산,계,1510,511614,21398,534522,"2016-06-01",2016
"16-Jun",울산,남구,600,149633,7505,157738,"2016-06-01",2016
"16-Jun",울산,동구,186,62482,916,63584,"2016-06-01",2016
"16-Jun",울산,북구,110,90051,4475,94636,"2016-06-01",2016
"16-Jun",울산,울주군,304,107777,5823,113904,"2016-06-01",2016
"16-Jun",울산,중구,310,101671,2679,104660,"2016-06-01",2016
"16-Jun",세종,계,592,100484,2309,103385,"2016-06-01",2016
"16-Jun",세종,세종특별자치시,592,100484,2309,103385,"2016-06-01",2016
"16-Jun",경기,계,14658,4813261,217041,5044960,"2016-06-01",2016
"16-Jun",경기,가평군,338,26813,705,27856,"2016-06-01",2016
"16-Jun",경기,고양시 덕양구,580,149229,3588,153397,"2016-06-01",2016
"16-Jun",경기,고양시 일산동구,270,108604,6434,115308,"2016-06-01",2016
"16-Jun",경기,고양시 일산서구,71,104350,3330,107751,"2016-06-01",2016
"16-Jun",경기,과천시,690,21864,564,23118,"2016-06-01",2016
"16-Jun",경기,광명시,272,102047,4341,106660,"2016-06-01",2016
"16-Jun",경기,광주시,344,148421,7789,156554,"2016-06-01",2016
"16-Jun",경기,구리시,201,59949,2376,62526,"2016-06-01",2016
"16-Jun",경기,군포시,233,92869,4743,97845,"2016-06-01",2016
"16-Jun",경기,김포시,365,150261,5994,156620,"2016-06-01",2016
"16-Jun",경기,남양주시,530,244838,6922,252290,"2016-06-01",2016
"16-Jun",경기,동두천시,191,35043,1234,36468,"2016-06-01",2016
"16-Jun",경기,부천시 소사구,78,66759,2829,69666,"2016-06-01",2016
"16-Jun",경기,부천시 오정구,108,62266,2385,64759,"2016-06-01",2016
"16-Jun",경기,부천시 원미구,440,146579,6195,153214,"2016-06-01",2016
"16-Jun",경기,성남시 분당구,318,180281,5831,186430,"2016-06-01",2016
"16-Jun",경기,성남시 수정구,294,63028,2383,65705,"2016-06-01",2016
"16-Jun",경기,성남시 중원구,255,74261,4014,78530,"2016-06-01",2016
"16-Jun",경기,수원시 권선구,308,151624,7275,159207,"2016-06-01",2016
"16-Jun",경기,수원시 영통구,204,123441,2702,126347,"2016-06-01",2016
"16-Jun",경기,수원시 장안구,558,102836,3700,107094,"2016-06-01",2016
"16-Jun",경기,수원시 팔달구,457,70045,3522,74024,"2016-06-01",2016
"16-Jun",경기,시흥시,413,176110,7223,183746,"2016-06-01",2016
"16-Jun",경기,안산시 단원구,493,140786,8415,149694,"2016-06-01",2016
"16-Jun",경기,안산시 상록구,157,134488,4482,139127,"2016-06-01",2016
"16-Jun",경기,안성시,319,87360,4944,92623,"2016-06-01",2016
"16-Jun",경기,안양시 동안구,368,117561,6438,124367,"2016-06-01",2016
"16-Jun",경기,안양시 만안구,138,77846,3893,81877,"2016-06-01",2016
"16-Jun",경기,양주시,311,83979,2870,87160,"2016-06-01",2016
"16-Jun",경기,양평군,448,49710,1585,51743,"2016-06-01",2016
"16-Jun",경기,여주시,341,55567,7064,62972,"2016-06-01",2016
"16-Jun",경기,연천군,269,21052,5691,27012,"2016-06-01",2016
"16-Jun",경기,오산시,206,83191,3031,86428,"2016-06-01",2016
"16-Jun",경기,용인시 기흥구,88,160140,8396,168624,"2016-06-01",2016
"16-Jun",경기,용인시 수지구,42,124669,1769,126480,"2016-06-01",2016
"16-Jun",경기,용인시 처인구,577,100987,6565,108129,"2016-06-01",2016
"16-Jun",경기,의왕시,256,55820,2826,58902,"2016-06-01",2016
"16-Jun",경기,의정부시,510,135944,4812,141266,"2016-06-01",2016
"16-Jun",경기,이천시,351,95262,5678,101291,"2016-06-01",2016
"16-Jun",경기,파주시,372,174348,10010,184730,"2016-06-01",2016
"16-Jun",경기,평택시,583,211553,10239,222375,"2016-06-01",2016
"16-Jun",경기,포천시,331,77004,9725,87060,"2016-06-01",2016
"16-Jun",경기,하남시,299,71415,2077,73791,"2016-06-01",2016
"16-Jun",경기,화성시,681,293061,10452,304194,"2016-06-01",2016
"16-Jun",경기,부천시,,,,,"2016-06-01",2016
"16-Jun",강원,계,5038,681227,24372,710637,"2016-06-01",2016
"16-Jun",강원,강릉시,467,95853,4153,100473,"2016-06-01",2016
"16-Jun",강원,고성군,144,12581,245,12970,"2016-06-01",2016
"16-Jun",강원,동해시,271,40194,1360,41825,"2016-06-01",2016
"16-Jun",강원,삼척시,326,28935,702,29963,"2016-06-01",2016
"16-Jun",강원,속초시,264,32954,1247,34465,"2016-06-01",2016
"16-Jun",강원,양구군,127,10680,123,10930,"2016-06-01",2016
"16-Jun",강원,양양군,152,13201,246,13599,"2016-06-01",2016
"16-Jun",강원,영월군,296,18770,398,19464,"2016-06-01",2016
"16-Jun",강원,원주시,500,145168,5753,151421,"2016-06-01",2016
"16-Jun",강원,인제군,178,16044,212,16434,"2016-06-01",2016
"16-Jun",강원,정선군,278,18722,473,19473,"2016-06-01",2016
"16-Jun",강원,철원군,181,21798,310,22289,"2016-06-01",2016
"16-Jun",강원,춘천시,682,115432,5874,121988,"2016-06-01",2016
"16-Jun",강원,태백시,193,19955,845,20993,"2016-06-01",2016
"16-Jun",강원,평창군,270,23382,424,24076,"2016-06-01",2016
"16-Jun",강원,홍천군,327,33863,1096,35286,"2016-06-01",2016
"16-Jun",강원,화천군,167,11373,136,11676,"2016-06-01",2016
"16-Jun",강원,횡성군,215,22322,775,23312,"2016-06-01",2016
"16-Jun",충북,계,3385,712096,32196,747677,"2016-06-01",2016
"16-Jun",충북,괴산군,163,19701,343,20207,"2016-06-01",2016
"16-Jun",충북,단양군,150,14269,832,15251,"2016-06-01",2016
"16-Jun",충북,보은군,181,16116,924,17221,"2016-06-01",2016
"16-Jun",충북,영동군,202,22952,385,23539,"2016-06-01",2016
"16-Jun",충북,옥천군,182,23781,1011,24974,"2016-06-01",2016
"16-Jun",충북,음성군,189,52067,1663,53919,"2016-06-01",2016
"16-Jun",충북,제천시,308,60148,3256,63712,"2016-06-01",2016
"16-Jun",충북,증평군,77,16664,749,17490,"2016-06-01",2016
"16-Jun",충북,진천군,172,35872,1079,37123,"2016-06-01",2016
"16-Jun",충북,청원군,1,38,1,40,"2016-06-01",2016
"16-Jun",충북,청주시 상당구,421,72464,2629,75514,"2016-06-01",2016
"16-Jun",충북,청주시 서원구,221,89685,6030,95936,"2016-06-01",2016
"16-Jun",충북,청주시 청원구,281,86546,3692,90519,"2016-06-01",2016
"16-Jun",충북,청주시 흥덕구,336,107441,5951,113728,"2016-06-01",2016
"16-Jun",충북,충주시,501,94352,3651,98504,"2016-06-01",2016
"16-Jun",충남,계,4703,952393,38797,995893,"2016-06-01",2016
"16-Jun",충남,계룡시,122,18939,479,19540,"2016-06-01",2016
"16-Jun",충남,공주시,491,49451,2079,52021,"2016-06-01",2016
"16-Jun",충남,금산군,157,26153,2403,28713,"2016-06-01",2016
"16-Jun",충남,논산시,317,55779,2143,58239,"2016-06-01",2016
"16-Jun",충남,당진시,335,81906,3603,85844,"2016-06-01",2016
"16-Jun",충남,보령시,319,47279,1284,48882,"2016-06-01",2016
"16-Jun",충남,부여군,225,31626,1387,33238,"2016-06-01",2016
"16-Jun",충남,서산시,363,79512,3489,83364,"2016-06-01",2016
"16-Jun",충남,서천군,194,25494,964,26652,"2016-06-01",2016
"16-Jun",충남,아산시,365,138793,6206,145364,"2016-06-01",2016
"16-Jun",충남,예산군,316,39080,1436,40832,"2016-06-01",2016
"16-Jun",충남,천안시 동남구,231,115368,5062,120661,"2016-06-01",2016
"16-Jun",충남,천안시 서북구,489,152796,5627,158912,"2016-06-01",2016
"16-Jun",충남,청양군,208,15000,867,16075,"2016-06-01",2016
"16-Jun",충남,태안군,213,30169,498,30880,"2016-06-01",2016
"16-Jun",충남,홍성군,358,45048,1270,46676,"2016-06-01",2016
"16-Jun",전북,계,4320,815089,37209,856618,"2016-06-01",2016
"16-Jun",전북,고창군,218,27817,529,28564,"2016-06-01",2016
"16-Jun",전북,군산시,438,119707,6839,126984,"2016-06-01",2016
"16-Jun",전북,김제시,247,41290,1791,43328,"2016-06-01",2016
"16-Jun",전북,남원시,370,36776,2811,39957,"2016-06-01",2016
"16-Jun",전북,무주군,154,11440,362,11956,"2016-06-01",2016
"16-Jun",전북,부안군,230,25685,591,26506,"2016-06-01",2016
"16-Jun",전북,순창군,182,13025,224,13431,"2016-06-01",2016
"16-Jun",전북,완주군,294,46545,3579,50418,"2016-06-01",2016
"16-Jun",전북,익산시,434,128137,6100,134671,"2016-06-01",2016
"16-Jun",전북,임실군,166,12889,404,13459,"2016-06-01",2016
"16-Jun",전북,장수군,185,10781,162,11128,"2016-06-01",2016
"16-Jun",전북,전주시 덕진구,353,135291,7491,143135,"2016-06-01",2016
"16-Jun",전북,전주시 완산구,575,144156,3935,148666,"2016-06-01",2016
"16-Jun",전북,정읍시,274,49070,2202,51546,"2016-06-01",2016
"16-Jun",전북,진안군,200,12480,189,12869,"2016-06-01",2016
"16-Jun",전남,계,5282,828921,94380,928583,"2016-06-01",2016
"16-Jun",전남,강진군,184,16917,974,18075,"2016-06-01",2016
"16-Jun",전남,고흥군,234,27967,672,28873,"2016-06-01",2016
"16-Jun",전남,곡성군,136,13475,885,14496,"2016-06-01",2016
"16-Jun",전남,광양시,228,71588,5901,77717,"2016-06-01",2016
"16-Jun",전남,구례군,103,11838,685,12626,"2016-06-01",2016
"16-Jun",전남,나주시,356,48739,3138,52233,"2016-06-01",2016
"16-Jun",전남,담양군,170,23638,1586,25394,"2016-06-01",2016
"16-Jun",전남,목포시,428,89294,6034,95756,"2016-06-01",2016
"16-Jun",전남,무안군,439,37587,1170,39196,"2016-06-01",2016
"16-Jun",전남,보성군,207,19741,34389,54337,"2016-06-01",2016
"16-Jun",전남,순천시,448,119241,4761,124450,"2016-06-01",2016
"16-Jun",전남,신안군,196,18471,640,19307,"2016-06-01",2016
"16-Jun",전남,여수시,467,116963,6445,123875,"2016-06-01",2016
"16-Jun",전남,영광군,204,24788,703,25695,"2016-06-01",2016
"16-Jun",전남,영암군,210,30447,20762,51419,"2016-06-01",2016
"16-Jun",전남,완도군,196,22127,463,22786,"2016-06-01",2016
"16-Jun",전남,장성군,136,22770,1227,24133,"2016-06-01",2016
"16-Jun",전남,장흥군,176,18131,441,18748,"2016-06-01",2016
"16-Jun",전남,진도군,134,14756,290,15180,"2016-06-01",2016
"16-Jun",전남,함평군,145,15998,407,16550,"2016-06-01",2016
"16-Jun",전남,해남군,288,35345,666,36299,"2016-06-01",2016
"16-Jun",전남,화순군,197,29100,2141,31438,"2016-06-01",2016
"16-Jun",경북,계,6368,1282146,49158,1337672,"2016-06-01",2016
"16-Jun",경북,경산시,390,122586,4158,127134,"2016-06-01",2016
"16-Jun",경북,경주시,499,127671,5159,133329,"2016-06-01",2016
"16-Jun",경북,고령군,141,19697,432,20270,"2016-06-01",2016
"16-Jun",경북,구미시,442,190758,7695,198895,"2016-06-01",2016
"16-Jun",경북,군위군,109,13037,287,13433,"2016-06-01",2016
"16-Jun",경북,김천시,323,65267,1756,67346,"2016-06-01",2016
"16-Jun",경북,문경시,248,33096,919,34263,"2016-06-01",2016
"16-Jun",경북,봉화군,178,15909,207,16294,"2016-06-01",2016
"16-Jun",경북,상주시,335,47861,1825,50021,"2016-06-01",2016
"16-Jun",경북,성주군,167,27379,1429,28975,"2016-06-01",2016
"16-Jun",경북,안동시,527,76243,2576,79346,"2016-06-01",2016
"16-Jun",경북,영덕군,210,17387,301,17898,"2016-06-01",2016
"16-Jun",경북,영양군,123,8499,105,8727,"2016-06-01",2016
"16-Jun",경북,영주시,309,51723,1644,53676,"2016-06-01",2016
"16-Jun",경북,영천시,235,52132,2629,54996,"2016-06-01",2016
"16-Jun",경북,예천군,173,21315,421,21909,"2016-06-01",2016
"16-Jun",경북,울릉군,129,4649,406,5184,"2016-06-01",2016
"16-Jun",경북,울진군,242,23716,399,24357,"2016-06-01",2016
"16-Jun",경북,의성군,287,27206,983,28476,"2016-06-01",2016
"16-Jun",경북,청도군,146,22322,634,23102,"2016-06-01",2016
"16-Jun",경북,청송군,181,13721,203,14105,"2016-06-01",2016
"16-Jun",경북,칠곡군,303,63965,2031,66299,"2016-06-01",2016
"16-Jun",경북,포항시 남구,355,114069,9007,123431,"2016-06-01",2016
"16-Jun",경북,포항시 북구,316,121938,3952,126206,"2016-06-01",2016
"16-Jun",경남,계,6244,1517190,79808,1603242,"2016-06-01",2016
"16-Jun",경남,거제시,292,101997,2691,104980,"2016-06-01",2016
"16-Jun",경남,거창군,226,28474,790,29490,"2016-06-01",2016
"16-Jun",경남,고성군,208,24740,718,25666,"2016-06-01",2016
"16-Jun",경남,김해시,581,239800,6565,246946,"2016-06-01",2016
"16-Jun",경남,남해군,204,17542,520,18266,"2016-06-01",2016
"16-Jun",경남,밀양시,284,50651,4300,55235,"2016-06-01",2016
"16-Jun",경남,사천시,276,50299,1558,52133,"2016-06-01",2016
"16-Jun",경남,산청군,175,17542,778,18495,"2016-06-01",2016
"16-Jun",경남,양산시,343,130011,8808,139162,"2016-06-01",2016
"16-Jun",경남,의령군,162,12620,764,13546,"2016-06-01",2016
"16-Jun",경남,진주시,551,146609,6755,153915,"2016-06-01",2016
"16-Jun",경남,창녕군,199,31934,789,32922,"2016-06-01",2016
"16-Jun",경남,창원시 마산합포구,315,93540,3132,96987,"2016-06-01",2016
"16-Jun",경남,창원시 마산회원구,164,97966,5432,103562,"2016-06-01",2016
"16-Jun",경남,창원시 성산구,145,120823,16222,137190,"2016-06-01",2016
"16-Jun",경남,창원시 의창구,849,121710,5400,127959,"2016-06-01",2016
"16-Jun",경남,창원시 진해구,190,77846,1561,79597,"2016-06-01",2016
"16-Jun",경남,통영시,288,50607,1534,52429,"2016-06-01",2016
"16-Jun",경남,하동군,203,22682,444,23329,"2016-06-01",2016
"16-Jun",경남,함안군,170,40760,9576,50506,"2016-06-01",2016
"16-Jun",경남,함양군,189,18094,490,18773,"2016-06-01",2016
"16-Jun",경남,합천군,230,20943,981,22154,"2016-06-01",2016
"16-Jun",제주,계,1909,347694,104175,453778,"2016-06-01",2016
"16-Jun",제주,서귀포시,630,87492,2324,90446,"2016-06-01",2016
"16-Jun",제주,제주시,1279,260202,101851,363332,"2016-06-01",2016
"16-Jul",서울,계,11354,2872491,196083,3079928,"2016-07-01",2016
"16-Jul",서울,강남구,355,222532,18980,241867,"2016-07-01",2016
"16-Jul",서울,강동구,224,128482,8539,137245,"2016-07-01",2016
"16-Jul",서울,강북구,285,71493,4884,76662,"2016-07-01",2016
"16-Jul",서울,강서구,286,178321,14845,193452,"2016-07-01",2016
"16-Jul",서울,관악구,274,116042,5804,122120,"2016-07-01",2016
"16-Jul",서울,광진구,276,91266,5633,97175,"2016-07-01",2016
"16-Jul",서울,구로구,235,128940,11354,140529,"2016-07-01",2016
"16-Jul",서울,금천구,124,76259,7457,83840,"2016-07-01",2016
"16-Jul",서울,노원구,256,146246,9756,156258,"2016-07-01",2016
"16-Jul",서울,도봉구,232,88869,7724,96825,"2016-07-01",2016
"16-Jul",서울,동대문구,270,91305,5836,97411,"2016-07-01",2016
"16-Jul",서울,동작구,276,100647,2798,103721,"2016-07-01",2016
"16-Jul",서울,마포구,277,109593,7560,117430,"2016-07-01",2016
"16-Jul",서울,서대문구,430,78855,5256,84541,"2016-07-01",2016
"16-Jul",서울,서초구,595,168332,10280,179207,"2016-07-01",2016
"16-Jul",서울,성동구,274,88903,8812,97989,"2016-07-01",2016
"16-Jul",서울,성북구,229,111204,5507,116940,"2016-07-01",2016
"16-Jul",서울,송파구,342,208636,11670,220648,"2016-07-01",2016
"16-Jul",서울,양천구,303,141351,9050,150704,"2016-07-01",2016
"16-Jul",서울,영등포구,300,137561,10247,148108,"2016-07-01",2016
"16-Jul",서울,용산구,358,73456,2069,75883,"2016-07-01",2016
"16-Jul",서울,은평구,224,120526,6904,127654,"2016-07-01",2016
"16-Jul",서울,종로구,3698,44633,1653,49984,"2016-07-01",2016
"16-Jul",서울,중구,1041,47099,3810,51950,"2016-07-01",2016
"16-Jul",서울,중랑구,190,101940,9655,111785,"2016-07-01",2016
"16-Jul",부산,계,4338,1200724,80596,1285658,"2016-07-01",2016
"16-Jul",부산,강서구,303,56929,4060,61292,"2016-07-01",2016
"16-Jul",부산,금정구,274,78631,7328,86233,"2016-07-01",2016
"16-Jul",부산,기장군,220,64228,2134,66582,"2016-07-01",2016
"16-Jul",부산,남구,207,86808,8911,95926,"2016-07-01",2016
"16-Jul",부산,동구,219,36697,6001,42917,"2016-07-01",2016
"16-Jul",부산,동래구,166,85624,4434,90224,"2016-07-01",2016
"16-Jul",부산,부산진구,367,122770,6079,129216,"2016-07-01",2016
"16-Jul",부산,북구,215,100076,3415,103706,"2016-07-01",2016
"16-Jul",부산,사상구,262,84855,6370,91487,"2016-07-01",2016
"16-Jul",부산,사하구,250,105827,7187,113264,"2016-07-01",2016
"16-Jul",부산,서구,127,27570,1348,29045,"2016-07-01",2016
"16-Jul",부산,수영구,151,64760,2996,67907,"2016-07-01",2016
"16-Jul",부산,연제구,794,84275,6127,91196,"2016-07-01",2016
"16-Jul",부산,영도구,218,31678,2557,34453,"2016-07-01",2016
"16-Jul",부산,중구,306,15348,6246,21900,"2016-07-01",2016
"16-Jul",부산,해운대구,259,154648,5403,160310,"2016-07-01",2016
"16-Jul",대구,계,2807,1070425,48696,1121928,"2016-07-01",2016
"16-Jul",대구,남구,298,56581,2152,59031,"2016-07-01",2016
"16-Jul",대구,달서구,420,252208,11893,264521,"2016-07-01",2016
"16-Jul",대구,달성군,401,96986,3490,100877,"2016-07-01",2016
"16-Jul",대구,동구,315,143271,10969,154555,"2016-07-01",2016
"16-Jul",대구,북구,413,184095,8384,192892,"2016-07-01",2016
"16-Jul",대구,서구,201,76535,4574,81310,"2016-07-01",2016
"16-Jul",대구,수성구,497,203336,5357,209190,"2016-07-01",2016
"16-Jul",대구,중구,262,57413,1877,59552,"2016-07-01",2016
"16-Jul",인천,계,3437,1147037,254124,1404598,"2016-07-01",2016
"16-Jul",인천,강화군,286,29650,2868,32804,"2016-07-01",2016
"16-Jul",인천,계양구,245,119680,125392,245317,"2016-07-01",2016
"16-Jul",인천,남구,359,136454,51503,188316,"2016-07-01",2016
"16-Jul",인천,남동구,778,228795,30021,259594,"2016-07-01",2016
"16-Jul",인천,동구,84,25708,2594,28386,"2016-07-01",2016
"16-Jul",인천,부평구,308,202555,7370,210233,"2016-07-01",2016
"16-Jul",인천,서구,350,201906,10686,212942,"2016-07-01",2016
"16-Jul",인천,연수구,276,141453,7231,148960,"2016-07-01",2016
"16-Jul",인천,옹진군,164,10605,161,10930,"2016-07-01",2016
"16-Jul",인천,중구,587,50231,16298,67116,"2016-07-01",2016
"16-Jul",광주,계,1935,592963,33351,628249,"2016-07-01",2016
"16-Jul",광주,광산구,474,168482,9708,178664,"2016-07-01",2016
"16-Jul",광주,남구,170,81695,3366,85231,"2016-07-01",2016
"16-Jul",광주,동구,215,34798,1198,36211,"2016-07-01",2016
"16-Jul",광주,북구,440,172030,9490,181960,"2016-07-01",2016
"16-Jul",광주,서구,636,135958,9589,146183,"2016-07-01",2016
"16-Jul",대전,계,1756,613655,27887,643298,"2016-07-01",2016
"16-Jul",대전,대덕구,268,85267,6487,92022,"2016-07-01",2016
"16-Jul",대전,동구,160,86082,4292,90534,"2016-07-01",2016
"16-Jul",대전,서구,751,193994,6827,201572,"2016-07-01",2016
"16-Jul",대전,유성구,363,153368,4615,158346,"2016-07-01",2016
"16-Jul",대전,중구,214,94944,5666,100824,"2016-07-01",2016
"16-Jul",울산,계,1512,512744,21441,535697,"2016-07-01",2016
"16-Jul",울산,남구,598,149737,7465,157800,"2016-07-01",2016
"16-Jul",울산,동구,186,62572,889,63647,"2016-07-01",2016
"16-Jul",울산,북구,110,90501,4490,95101,"2016-07-01",2016
"16-Jul",울산,울주군,307,108102,5850,114259,"2016-07-01",2016
"16-Jul",울산,중구,311,101832,2747,104890,"2016-07-01",2016
"16-Jul",세종,계,591,101642,2299,104532,"2016-07-01",2016
"16-Jul",세종,세종특별자치시,591,101642,2299,104532,"2016-07-01",2016
"16-Jul",경기,계,14732,4832163,217979,5064874,"2016-07-01",2016
"16-Jul",경기,가평군,337,26986,709,28032,"2016-07-01",2016
"16-Jul",경기,고양시 덕양구,591,149514,3721,153826,"2016-07-01",2016
"16-Jul",경기,고양시 일산동구,271,109390,6734,116395,"2016-07-01",2016
"16-Jul",경기,고양시 일산서구,72,104541,3294,107907,"2016-07-01",2016
"16-Jul",경기,과천시,683,21701,563,22947,"2016-07-01",2016
"16-Jul",경기,광명시,273,102028,4346,106647,"2016-07-01",2016
"16-Jul",경기,광주시,353,149063,7884,157300,"2016-07-01",2016
"16-Jul",경기,구리시,202,60804,2389,63395,"2016-07-01",2016
"16-Jul",경기,군포시,233,93032,4751,98016,"2016-07-01",2016
"16-Jul",경기,김포시,371,151907,6063,158341,"2016-07-01",2016
"16-Jul",경기,남양주시,539,245734,6938,253211,"2016-07-01",2016
"16-Jul",경기,동두천시,192,35141,1242,36575,"2016-07-01",2016
"16-Jul",경기,부천시,590,272402,10599,283591,"2016-07-01",2016
"16-Jul",경기,부천시 소사구,6,761,165,932,"2016-07-01",2016
"16-Jul",경기,부천시 오정구,8,1058,67,1133,"2016-07-01",2016
"16-Jul",경기,부천시 원미구,37,1967,587,2591,"2016-07-01",2016
"16-Jul",경기,성남시 분당구,320,180580,5842,186742,"2016-07-01",2016
"16-Jul",경기,성남시 수정구,296,63922,2396,66614,"2016-07-01",2016
"16-Jul",경기,성남시 중원구,255,73988,3984,78227,"2016-07-01",2016
"16-Jul",경기,수원시 권선구,310,152600,7246,160156,"2016-07-01",2016
"16-Jul",경기,수원시 영통구,202,123816,2690,126708,"2016-07-01",2016
"16-Jul",경기,수원시 장안구,562,102929,3758,107249,"2016-07-01",2016
"16-Jul",경기,수원시 팔달구,454,70257,3602,74313,"2016-07-01",2016
"16-Jul",경기,시흥시,415,177135,7237,184787,"2016-07-01",2016
"16-Jul",경기,안산시 단원구,491,141125,8520,150136,"2016-07-01",2016
"16-Jul",경기,안산시 상록구,161,134725,4464,139350,"2016-07-01",2016
"16-Jul",경기,안성시,324,87946,4946,93216,"2016-07-01",2016
"16-Jul",경기,안양시 동안구,365,118012,6472,124849,"2016-07-01",2016
"16-Jul",경기,안양시 만안구,143,77834,3798,81775,"2016-07-01",2016
"16-Jul",경기,양주시,308,84233,2876,87417,"2016-07-01",2016
"16-Jul",경기,양평군,441,50006,1594,52041,"2016-07-01",2016
"16-Jul",경기,여주시,344,55725,7125,63194,"2016-07-01",2016
"16-Jul",경기,연천군,264,21110,5698,27072,"2016-07-01",2016
"16-Jul",경기,오산시,210,83369,3059,86638,"2016-07-01",2016
"16-Jul",경기,용인시 기흥구,91,160416,8355,168862,"2016-07-01",2016
"16-Jul",경기,용인시 수지구,42,124866,1773,126681,"2016-07-01",2016
"16-Jul",경기,용인시 처인구,573,101302,6525,108400,"2016-07-01",2016
"16-Jul",경기,의왕시,256,55854,2834,58944,"2016-07-01",2016
"16-Jul",경기,의정부시,514,136434,4818,141766,"2016-07-01",2016
"16-Jul",경기,이천시,351,95561,5668,101580,"2016-07-01",2016
"16-Jul",경기,파주시,374,175045,10060,185479,"2016-07-01",2016
"16-Jul",경기,평택시,589,212677,10324,223590,"2016-07-01",2016
"16-Jul",경기,포천시,332,77260,9542,87134,"2016-07-01",2016
"16-Jul",경기,하남시,304,72608,2089,75001,"2016-07-01",2016
"16-Jul",경기,화성시,683,294799,10632,306114,"2016-07-01",2016
"16-Jul",강원,계,5095,683595,24388,713078,"2016-07-01",2016
"16-Jul",강원,강릉시,479,96115,4197,100791,"2016-07-01",2016
"16-Jul",강원,고성군,143,12633,245,13021,"2016-07-01",2016
"16-Jul",강원,동해시,274,40344,1358,41976,"2016-07-01",2016
"16-Jul",강원,삼척시,328,28963,704,29995,"2016-07-01",2016
"16-Jul",강원,속초시,270,33089,1253,34612,"2016-07-01",2016
"16-Jul",강원,양구군,130,10750,122,11002,"2016-07-01",2016
"16-Jul",강원,양양군,153,13239,249,13641,"2016-07-01",2016
"16-Jul",강원,영월군,297,18880,400,19577,"2016-07-01",2016
"16-Jul",강원,원주시,507,145815,5751,152073,"2016-07-01",2016
"16-Jul",강원,인제군,179,16090,208,16477,"2016-07-01",2016
"16-Jul",강원,정선군,282,18807,472,19561,"2016-07-01",2016
"16-Jul",강원,철원군,182,21827,313,22322,"2016-07-01",2016
"16-Jul",강원,춘천시,689,115710,5860,122259,"2016-07-01",2016
"16-Jul",강원,태백시,194,19967,827,20988,"2016-07-01",2016
"16-Jul",강원,평창군,270,23492,422,24184,"2016-07-01",2016
"16-Jul",강원,홍천군,333,33972,1101,35406,"2016-07-01",2016
"16-Jul",강원,화천군,167,11422,130,11719,"2016-07-01",2016
"16-Jul",강원,횡성군,218,22480,776,23474,"2016-07-01",2016
"16-Jul",충북,계,3418,714742,32321,750481,"2016-07-01",2016
"16-Jul",충북,괴산군,165,19778,348,20291,"2016-07-01",2016
"16-Jul",충북,단양군,154,14337,837,15328,"2016-07-01",2016
"16-Jul",충북,보은군,182,16192,923,17297,"2016-07-01",2016
"16-Jul",충북,영동군,206,23040,384,23630,"2016-07-01",2016
"16-Jul",충북,옥천군,188,23828,1012,25028,"2016-07-01",2016
"16-Jul",충북,음성군,192,52355,1666,54213,"2016-07-01",2016
"16-Jul",충북,제천시,311,60321,3282,63914,"2016-07-01",2016
"16-Jul",충북,증평군,75,16749,744,17568,"2016-07-01",2016
"16-Jul",충북,진천군,176,36056,1085,37317,"2016-07-01",2016
"16-Jul",충북,청원군,1,37,1,39,"2016-07-01",2016
"16-Jul",충북,청주시 상당구,393,72653,2655,75701,"2016-07-01",2016
"16-Jul",충북,청주시 서원구,221,89804,6056,96081,"2016-07-01",2016
"16-Jul",충북,청주시 청원구,307,87341,3692,91340,"2016-07-01",2016
"16-Jul",충북,청주시 흥덕구,340,107625,5972,113937,"2016-07-01",2016
"16-Jul",충북,충주시,507,94626,3664,98797,"2016-07-01",2016
"16-Jul",충남,계,4727,955703,39009,999439,"2016-07-01",2016
"16-Jul",충남,계룡시,127,18972,487,19586,"2016-07-01",2016
"16-Jul",충남,공주시,492,49526,2132,52150,"2016-07-01",2016
"16-Jul",충남,금산군,160,26163,2401,28724,"2016-07-01",2016
"16-Jul",충남,논산시,313,55875,2122,58310,"2016-07-01",2016
"16-Jul",충남,당진시,341,82241,3624,86206,"2016-07-01",2016
"16-Jul",충남,보령시,322,47395,1296,49013,"2016-07-01",2016
"16-Jul",충남,부여군,226,31679,1386,33291,"2016-07-01",2016
"16-Jul",충남,서산시,368,79722,3523,83613,"2016-07-01",2016
"16-Jul",충남,서천군,193,25566,960,26719,"2016-07-01",2016
"16-Jul",충남,아산시,370,139376,6209,145955,"2016-07-01",2016
"16-Jul",충남,예산군,315,39197,1404,40916,"2016-07-01",2016
"16-Jul",충남,천안시 동남구,232,115801,5034,121067,"2016-07-01",2016
"16-Jul",충남,천안시 서북구,487,153475,5782,159744,"2016-07-01",2016
"16-Jul",충남,청양군,207,15040,876,16123,"2016-07-01",2016
"16-Jul",충남,태안군,215,30302,499,31016,"2016-07-01",2016
"16-Jul",충남,홍성군,359,45373,1274,47006,"2016-07-01",2016
"16-Jul",전북,계,4343,817810,37289,859442,"2016-07-01",2016
"16-Jul",전북,고창군,223,27851,548,28622,"2016-07-01",2016
"16-Jul",전북,군산시,435,120097,6900,127432,"2016-07-01",2016
"16-Jul",전북,김제시,245,41404,1776,43425,"2016-07-01",2016
"16-Jul",전북,남원시,372,36827,2774,39973,"2016-07-01",2016
"16-Jul",전북,무주군,156,11452,364,11972,"2016-07-01",2016
"16-Jul",전북,부안군,236,25747,596,26579,"2016-07-01",2016
"16-Jul",전북,순창군,178,13084,224,13486,"2016-07-01",2016
"16-Jul",전북,완주군,292,46839,3575,50706,"2016-07-01",2016
"16-Jul",전북,익산시,433,128565,6135,135133,"2016-07-01",2016
"16-Jul",전북,임실군,174,12872,402,13448,"2016-07-01",2016
"16-Jul",전북,장수군,186,10841,164,11191,"2016-07-01",2016
"16-Jul",전북,전주시 덕진구,356,136192,7496,144044,"2016-07-01",2016
"16-Jul",전북,전주시 완산구,575,144303,3953,148831,"2016-07-01",2016
"16-Jul",전북,정읍시,279,49207,2192,51678,"2016-07-01",2016
"16-Jul",전북,진안군,203,12529,190,12922,"2016-07-01",2016
"16-Jul",전남,계,5337,831236,95296,931869,"2016-07-01",2016
"16-Jul",전남,강진군,188,16934,963,18085,"2016-07-01",2016
"16-Jul",전남,고흥군,232,28000,672,28904,"2016-07-01",2016
"16-Jul",전남,곡성군,137,13492,882,14511,"2016-07-01",2016
"16-Jul",전남,광양시,234,71759,5880,77873,"2016-07-01",2016
"16-Jul",전남,구례군,103,11858,688,12649,"2016-07-01",2016
"16-Jul",전남,나주시,365,49085,3155,52605,"2016-07-01",2016
"16-Jul",전남,담양군,172,23694,1570,25436,"2016-07-01",2016
"16-Jul",전남,목포시,424,89542,6087,96053,"2016-07-01",2016
"16-Jul",전남,무안군,443,37680,1196,39319,"2016-07-01",2016
"16-Jul",전남,보성군,209,19786,35778,55773,"2016-07-01",2016
"16-Jul",전남,순천시,449,119734,4772,124955,"2016-07-01",2016
"16-Jul",전남,신안군,192,18530,634,19356,"2016-07-01",2016
"16-Jul",전남,여수시,474,117044,6483,124001,"2016-07-01",2016
"16-Jul",전남,영광군,206,24911,696,25813,"2016-07-01",2016
"16-Jul",전남,영암군,214,30496,20310,51020,"2016-07-01",2016
"16-Jul",전남,완도군,201,22192,461,22854,"2016-07-01",2016
"16-Jul",전남,장성군,138,22891,1220,24249,"2016-07-01",2016
"16-Jul",전남,장흥군,178,18151,442,18771,"2016-07-01",2016
"16-Jul",전남,진도군,136,14810,290,15236,"2016-07-01",2016
"16-Jul",전남,함평군,145,16046,400,16591,"2016-07-01",2016
"16-Jul",전남,해남군,297,35434,567,36298,"2016-07-01",2016
"16-Jul",전남,화순군,200,29167,2150,31517,"2016-07-01",2016
"16-Jul",경북,계,6424,1285704,49209,1341337,"2016-07-01",2016
"16-Jul",경북,경산시,393,122934,4178,127505,"2016-07-01",2016
"16-Jul",경북,경주시,495,127953,5172,133620,"2016-07-01",2016
"16-Jul",경북,고령군,140,19761,417,20318,"2016-07-01",2016
"16-Jul",경북,구미시,447,190956,7646,199049,"2016-07-01",2016
"16-Jul",경북,군위군,110,13112,256,13478,"2016-07-01",2016
"16-Jul",경북,김천시,327,65575,1739,67641,"2016-07-01",2016
"16-Jul",경북,문경시,252,33118,918,34288,"2016-07-01",2016
"16-Jul",경북,봉화군,179,15982,205,16366,"2016-07-01",2016
"16-Jul",경북,상주시,337,48103,1819,50259,"2016-07-01",2016
"16-Jul",경북,성주군,170,27587,1502,29259,"2016-07-01",2016
"16-Jul",경북,안동시,533,76353,2581,79467,"2016-07-01",2016
"16-Jul",경북,영덕군,210,17448,304,17962,"2016-07-01",2016
"16-Jul",경북,영양군,123,8522,105,8750,"2016-07-01",2016
"16-Jul",경북,영주시,317,51903,1644,53864,"2016-07-01",2016
"16-Jul",경북,영천시,237,52317,2660,55214,"2016-07-01",2016
"16-Jul",경북,예천군,179,21480,422,22081,"2016-07-01",2016
"16-Jul",경북,울릉군,131,4689,408,5228,"2016-07-01",2016
"16-Jul",경북,울진군,245,23778,392,24415,"2016-07-01",2016
"16-Jul",경북,의성군,284,27260,989,28533,"2016-07-01",2016
"16-Jul",경북,청도군,146,22426,630,23202,"2016-07-01",2016
"16-Jul",경북,청송군,183,13746,200,14129,"2016-07-01",2016
"16-Jul",경북,칠곡군,306,64176,2050,66532,"2016-07-01",2016
"16-Jul",경북,포항시 남구,358,114268,9020,123646,"2016-07-01",2016
"16-Jul",경북,포항시 북구,322,122257,3952,126531,"2016-07-01",2016
"16-Jul",경남,계,6285,1521852,81245,1609382,"2016-07-01",2016
"16-Jul",경남,거제시,318,102168,2687,105173,"2016-07-01",2016
"16-Jul",경남,거창군,228,28558,790,29576,"2016-07-01",2016
"16-Jul",경남,고성군,211,24762,719,25692,"2016-07-01",2016
"16-Jul",경남,김해시,585,240375,6587,247547,"2016-07-01",2016
"16-Jul",경남,남해군,210,17591,514,18315,"2016-07-01",2016
"16-Jul",경남,밀양시,287,50802,4288,55377,"2016-07-01",2016
"16-Jul",경남,사천시,289,50546,1563,52398,"2016-07-01",2016
"16-Jul",경남,산청군,179,17623,771,18573,"2016-07-01",2016
"16-Jul",경남,양산시,343,130818,8839,140000,"2016-07-01",2016
"16-Jul",경남,의령군,162,12690,773,13625,"2016-07-01",2016
"16-Jul",경남,진주시,545,147063,6819,154427,"2016-07-01",2016
"16-Jul",경남,창녕군,206,32069,762,33037,"2016-07-01",2016
"16-Jul",경남,창원시 마산합포구,309,93876,3141,97326,"2016-07-01",2016
"16-Jul",경남,창원시 마산회원구,162,97912,5419,103493,"2016-07-01",2016
"16-Jul",경남,창원시 성산구,142,121899,16757,138798,"2016-07-01",2016
"16-Jul",경남,창원시 의창구,834,121807,5831,128472,"2016-07-01",2016
"16-Jul",경남,창원시 진해구,186,78114,1567,79867,"2016-07-01",2016
"16-Jul",경남,통영시,292,50605,1524,52421,"2016-07-01",2016
"16-Jul",경남,하동군,204,22730,446,23380,"2016-07-01",2016
"16-Jul",경남,함안군,169,40751,9987,50907,"2016-07-01",2016
"16-Jul",경남,함양군,188,18078,473,18739,"2016-07-01",2016
"16-Jul",경남,합천군,236,21015,988,22239,"2016-07-01",2016
"16-Jul",제주,계,1951,348802,106577,457330,"2016-07-01",2016
"16-Jul",제주,서귀포시,645,88059,2410,91114,"2016-07-01",2016
"16-Jul",제주,제주시,1306,260743,104167,366216,"2016-07-01",2016
"16-Aug",서울,계,11345,2870324,196376,3078045,"2016-08-01",2016
"16-Aug",서울,강남구,348,222274,19067,241689,"2016-08-01",2016
"16-Aug",서울,강동구,222,128114,8517,136853,"2016-08-01",2016
"16-Aug",서울,강북구,280,71605,4946,76831,"2016-08-01",2016
"16-Aug",서울,강서구,283,178141,14855,193279,"2016-08-01",2016
"16-Aug",서울,관악구,276,116034,5746,122056,"2016-08-01",2016
"16-Aug",서울,광진구,277,91255,5685,97217,"2016-08-01",2016
"16-Aug",서울,구로구,230,128850,11284,140364,"2016-08-01",2016
"16-Aug",서울,금천구,128,76332,7382,83842,"2016-08-01",2016
"16-Aug",서울,노원구,257,146160,9690,156107,"2016-08-01",2016
"16-Aug",서울,도봉구,229,88876,7727,96832,"2016-08-01",2016
"16-Aug",서울,동대문구,269,91251,5762,97282,"2016-08-01",2016
"16-Aug",서울,동작구,277,100737,2797,103811,"2016-08-01",2016
"16-Aug",서울,마포구,278,109501,7534,117313,"2016-08-01",2016
"16-Aug",서울,서대문구,424,78654,5236,84314,"2016-08-01",2016
"16-Aug",서울,서초구,610,168005,10357,178972,"2016-08-01",2016
"16-Aug",서울,성동구,271,88824,9257,98352,"2016-08-01",2016
"16-Aug",서울,성북구,232,111078,5509,116819,"2016-08-01",2016
"16-Aug",서울,송파구,339,208655,11632,220626,"2016-08-01",2016
"16-Aug",서울,양천구,301,141382,9031,150714,"2016-08-01",2016
"16-Aug",서울,영등포구,303,137119,10298,147720,"2016-08-01",2016
"16-Aug",서울,용산구,360,73437,2055,75852,"2016-08-01",2016
"16-Aug",서울,은평구,228,120480,6897,127605,"2016-08-01",2016
"16-Aug",서울,종로구,3696,44266,1649,49611,"2016-08-01",2016
"16-Aug",서울,중구,1037,47440,3800,52277,"2016-08-01",2016
"16-Aug",서울,중랑구,190,101854,9663,111707,"2016-08-01",2016
"16-Aug",부산,계,4315,1202539,80537,1287391,"2016-08-01",2016
"16-Aug",부산,강서구,301,57528,4014,61843,"2016-08-01",2016
"16-Aug",부산,금정구,271,78713,7363,86347,"2016-08-01",2016
"16-Aug",부산,기장군,219,64532,2131,66882,"2016-08-01",2016
"16-Aug",부산,남구,209,86808,8908,95925,"2016-08-01",2016
"16-Aug",부산,동구,221,38873,5969,45063,"2016-08-01",2016
"16-Aug",부산,동래구,164,85598,4480,90242,"2016-08-01",2016
"16-Aug",부산,부산진구,365,122608,6245,129218,"2016-08-01",2016
"16-Aug",부산,북구,215,100323,3414,103952,"2016-08-01",2016
"16-Aug",부산,사상구,259,84681,6317,91257,"2016-08-01",2016
"16-Aug",부산,사하구,239,105907,7183,113329,"2016-08-01",2016
"16-Aug",부산,서구,127,27595,1357,29079,"2016-08-01",2016
"16-Aug",부산,수영구,152,64804,3024,67980,"2016-08-01",2016
"16-Aug",부산,연제구,795,82491,5906,89192,"2016-08-01",2016
"16-Aug",부산,영도구,219,31682,2552,34453,"2016-08-01",2016
"16-Aug",부산,중구,302,15610,6274,22186,"2016-08-01",2016
"16-Aug",부산,해운대구,257,154786,5400,160443,"2016-08-01",2016
"16-Aug",대구,계,2812,1071027,48457,1122296,"2016-08-01",2016
"16-Aug",대구,남구,298,56574,2147,59019,"2016-08-01",2016
"16-Aug",대구,달서구,419,252396,11793,264608,"2016-08-01",2016
"16-Aug",대구,달성군,401,98123,3525,102049,"2016-08-01",2016
"16-Aug",대구,동구,320,143163,10863,154346,"2016-08-01",2016
"16-Aug",대구,북구,411,184187,8378,192976,"2016-08-01",2016
"16-Aug",대구,서구,202,76121,4527,80850,"2016-08-01",2016
"16-Aug",대구,수성구,495,203192,5366,209053,"2016-08-01",2016
"16-Aug",대구,중구,266,57271,1858,59395,"2016-08-01",2016
"16-Aug",인천,계,3455,1149944,255775,1409174,"2016-08-01",2016
"16-Aug",인천,강화군,287,29735,2814,32836,"2016-08-01",2016
"16-Aug",인천,계양구,249,119793,126405,246447,"2016-08-01",2016
"16-Aug",인천,남구,365,137481,51529,189375,"2016-08-01",2016
"16-Aug",인천,남동구,783,228903,30560,260246,"2016-08-01",2016
"16-Aug",인천,동구,84,25614,2604,28302,"2016-08-01",2016
"16-Aug",인천,부평구,314,203571,7390,211275,"2016-08-01",2016
"16-Aug",인천,서구,352,201787,10712,212851,"2016-08-01",2016
"16-Aug",인천,연수구,277,141924,7248,149449,"2016-08-01",2016
"16-Aug",인천,옹진군,164,10730,155,11049,"2016-08-01",2016
"16-Aug",인천,중구,580,50406,16358,67344,"2016-08-01",2016
"16-Aug",광주,계,1943,593479,33436,628858,"2016-08-01",2016
"16-Aug",광주,광산구,471,168609,9830,178910,"2016-08-01",2016
"16-Aug",광주,남구,170,81691,3278,85139,"2016-08-01",2016
"16-Aug",광주,동구,222,34885,1196,36303,"2016-08-01",2016
"16-Aug",광주,북구,446,172338,9571,182355,"2016-08-01",2016
"16-Aug",광주,서구,634,135956,9561,146151,"2016-08-01",2016
"16-Aug",대전,계,1756,613818,28001,643575,"2016-08-01",2016
"16-Aug",대전,대덕구,268,84993,6500,91761,"2016-08-01",2016
"16-Aug",대전,동구,161,86100,4280,90541,"2016-08-01",2016
"16-Aug",대전,서구,751,194212,6941,201904,"2016-08-01",2016
"16-Aug",대전,유성구,362,153551,4629,158542,"2016-08-01",2016
"16-Aug",대전,중구,214,94962,5651,100827,"2016-08-01",2016
"16-Aug",울산,계,1537,513048,21422,536007,"2016-08-01",2016
"16-Aug",울산,남구,617,149846,7446,157909,"2016-08-01",2016
"16-Aug",울산,동구,186,62645,924,63755,"2016-08-01",2016
"16-Aug",울산,북구,111,90390,4471,94972,"2016-08-01",2016
"16-Aug",울산,울주군,309,108275,5831,114415,"2016-08-01",2016
"16-Aug",울산,중구,314,101892,2750,104956,"2016-08-01",2016
"16-Aug",세종,계,600,102774,2314,105688,"2016-08-01",2016
"16-Aug",세종,세종특별자치시,600,102774,2314,105688,"2016-08-01",2016
"16-Aug",경기,계,14765,4844562,218201,5077528,"2016-08-01",2016
"16-Aug",경기,가평군,338,27111,743,28192,"2016-08-01",2016
"16-Aug",경기,고양시 덕양구,590,149709,3734,154033,"2016-08-01",2016
"16-Aug",경기,고양시 일산동구,276,110087,6685,117048,"2016-08-01",2016
"16-Aug",경기,고양시 일산서구,73,104489,3277,107839,"2016-08-01",2016
"16-Aug",경기,과천시,687,21593,559,22839,"2016-08-01",2016
"16-Aug",경기,광명시,274,101959,4342,106575,"2016-08-01",2016
"16-Aug",경기,광주시,351,149730,7848,157929,"2016-08-01",2016
"16-Aug",경기,구리시,207,61545,2401,64153,"2016-08-01",2016
"16-Aug",경기,군포시,237,93091,4821,98149,"2016-08-01",2016
"16-Aug",경기,김포시,378,152936,6112,159426,"2016-08-01",2016
"16-Aug",경기,남양주시,541,246035,6944,253520,"2016-08-01",2016
"16-Aug",경기,동두천시,195,35209,1255,36659,"2016-08-01",2016
"16-Aug",경기,부천시,642,277162,11389,289193,"2016-08-01",2016
"16-Aug",경기,부천시 소사구,,,,,"2016-08-01",2016
"16-Aug",경기,부천시 오정구,,,,,"2016-08-01",2016
"16-Aug",경기,부천시 원미구,,,,,"2016-08-01",2016
"16-Aug",경기,성남시 분당구,324,180578,5949,186851,"2016-08-01",2016
"16-Aug",경기,성남시 수정구,298,65020,2355,67673,"2016-08-01",2016
"16-Aug",경기,성남시 중원구,254,73349,3928,77531,"2016-08-01",2016
"16-Aug",경기,수원시 권선구,309,151604,7154,159067,"2016-08-01",2016
"16-Aug",경기,수원시 영통구,203,123993,2677,126873,"2016-08-01",2016
"16-Aug",경기,수원시 장안구,552,102973,3865,107390,"2016-08-01",2016
"16-Aug",경기,수원시 팔달구,451,70514,3624,74589,"2016-08-01",2016
"16-Aug",경기,시흥시,413,177201,7298,184912,"2016-08-01",2016
"16-Aug",경기,안산시 단원구,487,140921,8412,149820,"2016-08-01",2016
"16-Aug",경기,안산시 상록구,161,134904,4510,139575,"2016-08-01",2016
"16-Aug",경기,안성시,322,87742,4991,93055,"2016-08-01",2016
"16-Aug",경기,안양시 동안구,367,118100,6466,124933,"2016-08-01",2016
"16-Aug",경기,안양시 만안구,143,77717,3777,81637,"2016-08-01",2016
"16-Aug",경기,양주시,306,84333,2885,87524,"2016-08-01",2016
"16-Aug",경기,양평군,439,50283,1574,52296,"2016-08-01",2016
"16-Aug",경기,여주시,351,55848,7177,63376,"2016-08-01",2016
"16-Aug",경기,연천군,256,21239,5694,27189,"2016-08-01",2016
"16-Aug",경기,오산시,208,83444,3065,86717,"2016-08-01",2016
"16-Aug",경기,용인시 기흥구,92,160468,8297,168857,"2016-08-01",2016
"16-Aug",경기,용인시 수지구,39,124971,1836,126846,"2016-08-01",2016
"16-Aug",경기,용인시 처인구,574,101658,6510,108742,"2016-08-01",2016
"16-Aug",경기,의왕시,256,55945,2834,59035,"2016-08-01",2016
"16-Aug",경기,의정부시,513,136790,4855,142158,"2016-08-01",2016
"16-Aug",경기,이천시,351,95935,5716,102002,"2016-08-01",2016
"16-Aug",경기,파주시,373,175451,9963,185787,"2016-08-01",2016
"16-Aug",경기,평택시,591,213520,10336,224447,"2016-08-01",2016
"16-Aug",경기,포천시,334,77420,9489,87243,"2016-08-01",2016
"16-Aug",경기,하남시,310,74510,2099,76919,"2016-08-01",2016
"16-Aug",경기,화성시,699,297475,10755,308929,"2016-08-01",2016
"16-Aug",강원,계,5090,685489,24595,715174,"2016-08-01",2016
"16-Aug",강원,강릉시,476,96349,4223,101048,"2016-08-01",2016
"16-Aug",강원,고성군,145,12584,243,12972,"2016-08-01",2016
"16-Aug",강원,동해시,276,40466,1367,42109,"2016-08-01",2016
"16-Aug",강원,삼척시,327,29029,712,30068,"2016-08-01",2016
"16-Aug",강원,속초시,273,33415,1265,34953,"2016-08-01",2016
"16-Aug",강원,양구군,128,10771,123,11022,"2016-08-01",2016
"16-Aug",강원,양양군,151,13176,247,13574,"2016-08-01",2016
"16-Aug",강원,영월군,297,18917,400,19614,"2016-08-01",2016
"16-Aug",강원,원주시,503,146212,5864,152579,"2016-08-01",2016
"16-Aug",강원,인제군,180,16098,208,16486,"2016-08-01",2016
"16-Aug",강원,정선군,282,18863,476,19621,"2016-08-01",2016
"16-Aug",강원,철원군,180,21883,314,22377,"2016-08-01",2016
"16-Aug",강원,춘천시,693,116068,5863,122624,"2016-08-01",2016
"16-Aug",강원,태백시,196,19966,836,20998,"2016-08-01",2016
"16-Aug",강원,평창군,267,23587,424,24278,"2016-08-01",2016
"16-Aug",강원,홍천군,333,34113,1117,35563,"2016-08-01",2016
"16-Aug",강원,화천군,169,11445,130,11744,"2016-08-01",2016
"16-Aug",강원,횡성군,214,22547,783,23544,"2016-08-01",2016
"16-Aug",충북,계,3420,716433,32442,752295,"2016-08-01",2016
"16-Aug",충북,괴산군,166,19810,353,20329,"2016-08-01",2016
"16-Aug",충북,단양군,155,14387,836,15378,"2016-08-01",2016
"16-Aug",충북,보은군,188,16174,931,17293,"2016-08-01",2016
"16-Aug",충북,영동군,206,23077,381,23664,"2016-08-01",2016
"16-Aug",충북,옥천군,185,23892,1012,25089,"2016-08-01",2016
"16-Aug",충북,음성군,193,52531,1677,54401,"2016-08-01",2016
"16-Aug",충북,제천시,307,60439,3295,64041,"2016-08-01",2016
"16-Aug",충북,증평군,75,16780,738,17593,"2016-08-01",2016
"16-Aug",충북,진천군,179,36273,1078,37530,"2016-08-01",2016
"16-Aug",충북,청원군,1,37,1,39,"2016-08-01",2016
"16-Aug",충북,청주시 상당구,392,72658,2673,75723,"2016-08-01",2016
"16-Aug",충북,청주시 서원구,217,89691,6110,96018,"2016-08-01",2016
"16-Aug",충북,청주시 청원구,306,87981,3708,91995,"2016-08-01",2016
"16-Aug",충북,청주시 흥덕구,343,107807,5987,114137,"2016-08-01",2016
"16-Aug",충북,충주시,507,94896,3662,99065,"2016-08-01",2016
"16-Aug",충남,계,4759,958475,39141,1002375,"2016-08-01",2016
"16-Aug",충남,계룡시,131,19053,488,19672,"2016-08-01",2016
"16-Aug",충남,공주시,492,49681,2128,52301,"2016-08-01",2016
"16-Aug",충남,금산군,165,26241,2400,28806,"2016-08-01",2016
"16-Aug",충남,논산시,318,56043,2123,58484,"2016-08-01",2016
"16-Aug",충남,당진시,343,82616,3640,86599,"2016-08-01",2016
"16-Aug",충남,보령시,324,47504,1302,49130,"2016-08-01",2016
"16-Aug",충남,부여군,231,31735,1403,33369,"2016-08-01",2016
"16-Aug",충남,서산시,367,79896,3515,83778,"2016-08-01",2016
"16-Aug",충남,서천군,200,25564,966,26730,"2016-08-01",2016
"16-Aug",충남,아산시,371,139701,6199,146271,"2016-08-01",2016
"16-Aug",충남,예산군,311,39219,1395,40925,"2016-08-01",2016
"16-Aug",충남,천안시 동남구,234,115923,5023,121180,"2016-08-01",2016
"16-Aug",충남,천안시 서북구,486,154013,5850,160349,"2016-08-01",2016
"16-Aug",충남,청양군,213,15076,919,16208,"2016-08-01",2016
"16-Aug",충남,태안군,215,30431,493,31139,"2016-08-01",2016
"16-Aug",충남,홍성군,358,45720,1296,47374,"2016-08-01",2016
"16-Aug",전북,계,4349,819139,37701,861189,"2016-08-01",2016
"16-Aug",전북,고창군,222,27850,544,28616,"2016-08-01",2016
"16-Aug",전북,군산시,432,120269,6899,127600,"2016-08-01",2016
"16-Aug",전북,김제시,252,41508,1782,43542,"2016-08-01",2016
"16-Aug",전북,남원시,372,36873,3140,40385,"2016-08-01",2016
"16-Aug",전북,무주군,157,11487,364,12008,"2016-08-01",2016
"16-Aug",전북,부안군,236,25724,598,26558,"2016-08-01",2016
"16-Aug",전북,순창군,179,13101,232,13512,"2016-08-01",2016
"16-Aug",전북,완주군,290,47012,3483,50785,"2016-08-01",2016
"16-Aug",전북,익산시,436,128849,6147,135432,"2016-08-01",2016
"16-Aug",전북,임실군,173,12911,398,13482,"2016-08-01",2016
"16-Aug",전북,장수군,184,10857,163,11204,"2016-08-01",2016
"16-Aug",전북,전주시 덕진구,358,136380,7603,144341,"2016-08-01",2016
"16-Aug",전북,전주시 완산구,570,144457,3954,148981,"2016-08-01",2016
"16-Aug",전북,정읍시,283,49295,2207,51785,"2016-08-01",2016
"16-Aug",전북,진안군,205,12566,187,12958,"2016-08-01",2016
"16-Aug",전남,계,5308,833087,96557,934952,"2016-08-01",2016
"16-Aug",전남,강진군,187,16946,970,18103,"2016-08-01",2016
"16-Aug",전남,고흥군,228,28044,676,28948,"2016-08-01",2016
"16-Aug",전남,곡성군,140,13502,872,14514,"2016-08-01",2016
"16-Aug",전남,광양시,232,71940,5881,78053,"2016-08-01",2016
"16-Aug",전남,구례군,105,11903,662,12670,"2016-08-01",2016
"16-Aug",전남,나주시,367,49480,3158,53005,"2016-08-01",2016
"16-Aug",전남,담양군,168,23749,1568,25485,"2016-08-01",2016
"16-Aug",전남,목포시,428,89656,6057,96141,"2016-08-01",2016
"16-Aug",전남,무안군,446,37825,1185,39456,"2016-08-01",2016
"16-Aug",전남,보성군,206,19793,37695,57694,"2016-08-01",2016
"16-Aug",전남,순천시,451,120108,4807,125366,"2016-08-01",2016
"16-Aug",전남,신안군,190,18584,631,19405,"2016-08-01",2016
"16-Aug",전남,여수시,473,117158,6526,124157,"2016-08-01",2016
"16-Aug",전남,영광군,200,24904,698,25802,"2016-08-01",2016
"16-Aug",전남,영암군,213,30497,19636,50346,"2016-08-01",2016
"16-Aug",전남,완도군,199,22238,476,22913,"2016-08-01",2016
"16-Aug",전남,장성군,131,22966,1219,24316,"2016-08-01",2016
"16-Aug",전남,장흥군,173,18185,448,18806,"2016-08-01",2016
"16-Aug",전남,진도군,132,14847,291,15270,"2016-08-01",2016
"16-Aug",전남,함평군,145,16081,391,16617,"2016-08-01",2016
"16-Aug",전남,해남군,295,35492,563,36350,"2016-08-01",2016
"16-Aug",전남,화순군,199,29189,2147,31535,"2016-08-01",2016
"16-Aug",경북,계,6424,1288191,49208,1343823,"2016-08-01",2016
"16-Aug",경북,경산시,392,123138,4163,127693,"2016-08-01",2016
"16-Aug",경북,경주시,505,128202,5142,133849,"2016-08-01",2016
"16-Aug",경북,고령군,140,19787,418,20345,"2016-08-01",2016
"16-Aug",경북,구미시,444,191056,7661,199161,"2016-08-01",2016
"16-Aug",경북,군위군,110,13173,255,13538,"2016-08-01",2016
"16-Aug",경북,김천시,325,65770,1747,67842,"2016-08-01",2016
"16-Aug",경북,문경시,254,33110,916,34280,"2016-08-01",2016
"16-Aug",경북,봉화군,180,16020,206,16406,"2016-08-01",2016
"16-Aug",경북,상주시,336,48286,1816,50438,"2016-08-01",2016
"16-Aug",경북,성주군,170,27697,1505,29372,"2016-08-01",2016
"16-Aug",경북,안동시,531,76455,2585,79571,"2016-08-01",2016
"16-Aug",경북,영덕군,212,17484,305,18001,"2016-08-01",2016
"16-Aug",경북,영양군,121,8563,96,8780,"2016-08-01",2016
"16-Aug",경북,영주시,315,52020,1646,53981,"2016-08-01",2016
"16-Aug",경북,영천시,236,52518,2671,55425,"2016-08-01",2016
"16-Aug",경북,예천군,176,21568,427,22171,"2016-08-01",2016
"16-Aug",경북,울릉군,131,4680,410,5221,"2016-08-01",2016
"16-Aug",경북,울진군,244,23819,392,24455,"2016-08-01",2016
"16-Aug",경북,의성군,284,27291,988,28563,"2016-08-01",2016
"16-Aug",경북,청도군,146,22490,635,23271,"2016-08-01",2016
"16-Aug",경북,청송군,183,13776,198,14157,"2016-08-01",2016
"16-Aug",경북,칠곡군,310,64402,2064,66776,"2016-08-01",2016
"16-Aug",경북,포항시 남구,357,114330,9024,123711,"2016-08-01",2016
"16-Aug",경북,포항시 북구,322,122556,3938,126816,"2016-08-01",2016
"16-Aug",경남,계,6306,1523139,81486,1610931,"2016-08-01",2016
"16-Aug",경남,거제시,322,102136,2689,105147,"2016-08-01",2016
"16-Aug",경남,거창군,228,28646,789,29663,"2016-08-01",2016
"16-Aug",경남,고성군,206,24785,711,25702,"2016-08-01",2016
"16-Aug",경남,김해시,588,240608,6617,247813,"2016-08-01",2016
"16-Aug",경남,남해군,210,17615,516,18341,"2016-08-01",2016
"16-Aug",경남,밀양시,289,50965,4297,55551,"2016-08-01",2016
"16-Aug",경남,사천시,287,50715,1560,52562,"2016-08-01",2016
"16-Aug",경남,산청군,179,17674,770,18623,"2016-08-01",2016
"16-Aug",경남,양산시,342,131199,8851,140392,"2016-08-01",2016
"16-Aug",경남,의령군,163,12701,776,13640,"2016-08-01",2016
"16-Aug",경남,진주시,550,147335,6817,154702,"2016-08-01",2016
"16-Aug",경남,창녕군,208,32196,757,33161,"2016-08-01",2016
"16-Aug",경남,창원시 마산합포구,312,94153,3119,97584,"2016-08-01",2016
"16-Aug",경남,창원시 마산회원구,161,97808,5437,103406,"2016-08-01",2016
"16-Aug",경남,창원시 성산구,139,121432,17134,138705,"2016-08-01",2016
"16-Aug",경남,창원시 의창구,833,121730,5701,128264,"2016-08-01",2016
"16-Aug",경남,창원시 진해구,192,78211,1553,79956,"2016-08-01",2016
"16-Aug",경남,통영시,296,50677,1516,52489,"2016-08-01",2016
"16-Aug",경남,하동군,202,22722,447,23371,"2016-08-01",2016
"16-Aug",경남,함안군,169,40688,9974,50831,"2016-08-01",2016
"16-Aug",경남,함양군,195,18058,456,18709,"2016-08-01",2016
"16-Aug",경남,합천군,235,21085,999,22319,"2016-08-01",2016
"16-Aug",제주,계,1943,349595,107259,458797,"2016-08-01",2016
"16-Aug",제주,서귀포시,643,88522,2378,91543,"2016-08-01",2016
"16-Aug",제주,제주시,1300,261073,104881,367254,"2016-08-01",2016
"16-Sep",서울,계,11331,2871907,197389,3080627,"2016-09-01",2016
"16-Sep",서울,강남구,347,222369,19954,242670,"2016-09-01",2016
"16-Sep",서울,강동구,225,128149,8507,136881,"2016-09-01",2016
"16-Sep",서울,강북구,280,71646,4915,76841,"2016-09-01",2016
"16-Sep",서울,강서구,285,178387,14885,193557,"2016-09-01",2016
"16-Sep",서울,관악구,275,116016,5810,122101,"2016-09-01",2016
"16-Sep",서울,광진구,274,91342,5756,97372,"2016-09-01",2016
"16-Sep",서울,구로구,225,129060,11203,140488,"2016-09-01",2016
"16-Sep",서울,금천구,124,76468,7350,83942,"2016-09-01",2016
"16-Sep",서울,노원구,255,146342,9697,156294,"2016-09-01",2016
"16-Sep",서울,도봉구,231,88975,7720,96926,"2016-09-01",2016
"16-Sep",서울,동대문구,271,91331,5785,97387,"2016-09-01",2016
"16-Sep",서울,동작구,274,100946,2796,104016,"2016-09-01",2016
"16-Sep",서울,마포구,290,109474,7522,117286,"2016-09-01",2016
"16-Sep",서울,서대문구,424,78743,5238,84405,"2016-09-01",2016
"16-Sep",서울,서초구,608,168210,10422,179240,"2016-09-01",2016
"16-Sep",서울,성동구,273,88846,9386,98505,"2016-09-01",2016
"16-Sep",서울,성북구,228,111020,5512,116760,"2016-09-01",2016
"16-Sep",서울,송파구,330,208969,11630,220929,"2016-09-01",2016
"16-Sep",서울,양천구,300,141450,9011,150761,"2016-09-01",2016
"16-Sep",서울,영등포구,306,136604,10199,147109,"2016-09-01",2016
"16-Sep",서울,용산구,359,73367,2055,75781,"2016-09-01",2016
"16-Sep",서울,은평구,228,120599,6908,127735,"2016-09-01",2016
"16-Sep",서울,종로구,3702,44257,1649,49608,"2016-09-01",2016
"16-Sep",서울,중구,1029,47292,3801,52122,"2016-09-01",2016
"16-Sep",서울,중랑구,188,102045,9678,111911,"2016-09-01",2016
"16-Sep",부산,계,4307,1204725,80564,1289596,"2016-09-01",2016
"16-Sep",부산,강서구,302,57812,3983,62097,"2016-09-01",2016
"16-Sep",부산,금정구,271,78889,7383,86543,"2016-09-01",2016
"16-Sep",부산,기장군,220,64809,2134,67163,"2016-09-01",2016
"16-Sep",부산,남구,205,86803,8949,95957,"2016-09-01",2016
"16-Sep",부산,동구,224,39289,5808,45321,"2016-09-01",2016
"16-Sep",부산,동래구,165,85715,4509,90389,"2016-09-01",2016
"16-Sep",부산,부산진구,360,122487,6226,129073,"2016-09-01",2016
"16-Sep",부산,북구,215,100519,3412,104146,"2016-09-01",2016
"16-Sep",부산,사상구,259,84732,6401,91392,"2016-09-01",2016
"16-Sep",부산,사하구,238,106073,7122,113433,"2016-09-01",2016
"16-Sep",부산,서구,127,27610,1352,29089,"2016-09-01",2016
"16-Sep",부산,수영구,154,64828,3041,68023,"2016-09-01",2016
"16-Sep",부산,연제구,793,82646,5994,89433,"2016-09-01",2016
"16-Sep",부산,영도구,216,31660,2557,34433,"2016-09-01",2016
"16-Sep",부산,중구,301,15910,6292,22503,"2016-09-01",2016
"16-Sep",부산,해운대구,257,154943,5401,160601,"2016-09-01",2016
"16-Sep",대구,계,2831,1072357,48483,1123671,"2016-09-01",2016
"16-Sep",대구,남구,316,56536,2142,58994,"2016-09-01",2016
"16-Sep",대구,달서구,415,252620,11782,264817,"2016-09-01",2016
"16-Sep",대구,달성군,404,98940,3563,102907,"2016-09-01",2016
"16-Sep",대구,동구,317,143183,10784,154284,"2016-09-01",2016
"16-Sep",대구,북구,411,184667,8375,193453,"2016-09-01",2016
"16-Sep",대구,서구,206,75845,4568,80619,"2016-09-01",2016
"16-Sep",대구,수성구,494,203526,5412,209432,"2016-09-01",2016
"16-Sep",대구,중구,268,57040,1857,59165,"2016-09-01",2016
"16-Sep",인천,계,3441,1153977,258122,1415540,"2016-09-01",2016
"16-Sep",인천,강화군,291,29885,2758,32934,"2016-09-01",2016
"16-Sep",인천,계양구,249,120041,127399,247689,"2016-09-01",2016
"16-Sep",인천,남구,364,138335,52458,191157,"2016-09-01",2016
"16-Sep",인천,남동구,780,229024,31228,261032,"2016-09-01",2016
"16-Sep",인천,동구,84,25616,2595,28295,"2016-09-01",2016
"16-Sep",인천,부평구,318,204641,7154,212113,"2016-09-01",2016
"16-Sep",인천,서구,355,202204,10704,213263,"2016-09-01",2016
"16-Sep",인천,연수구,294,142880,7236,150410,"2016-09-01",2016
"16-Sep",인천,옹진군,164,10783,158,11105,"2016-09-01",2016
"16-Sep",인천,중구,542,50568,16432,67542,"2016-09-01",2016
"16-Sep",광주,계,1927,594584,33458,629969,"2016-09-01",2016
"16-Sep",광주,광산구,468,168982,9814,179264,"2016-09-01",2016
"16-Sep",광주,남구,170,81858,3274,85302,"2016-09-01",2016
"16-Sep",광주,동구,214,34885,1195,36294,"2016-09-01",2016
"16-Sep",광주,북구,436,172751,9557,182744,"2016-09-01",2016
"16-Sep",광주,서구,639,136108,9618,146365,"2016-09-01",2016
"16-Sep",대전,계,1762,614506,27972,644240,"2016-09-01",2016
"16-Sep",대전,대덕구,270,84955,6520,91745,"2016-09-01",2016
"16-Sep",대전,동구,162,86162,4283,90607,"2016-09-01",2016
"16-Sep",대전,서구,751,194534,7044,202329,"2016-09-01",2016
"16-Sep",대전,유성구,363,153868,4484,158715,"2016-09-01",2016
"16-Sep",대전,중구,216,94987,5641,100844,"2016-09-01",2016
"16-Sep",울산,계,1546,513680,21463,536689,"2016-09-01",2016
"16-Sep",울산,남구,629,149953,7482,158064,"2016-09-01",2016
"16-Sep",울산,동구,183,62722,925,63830,"2016-09-01",2016
"16-Sep",울산,북구,111,90573,4479,95163,"2016-09-01",2016
"16-Sep",울산,울주군,311,108504,5832,114647,"2016-09-01",2016
"16-Sep",울산,중구,312,101928,2745,104985,"2016-09-01",2016
"16-Sep",세종,계,639,103804,2314,106757,"2016-09-01",2016
"16-Sep",세종,세종특별자치시,639,103804,2314,106757,"2016-09-01",2016
"16-Sep",경기,계,14767,4861785,218133,5094685,"2016-09-01",2016
"16-Sep",경기,가평군,333,27209,756,28298,"2016-09-01",2016
"16-Sep",경기,고양시 덕양구,579,150108,3739,154426,"2016-09-01",2016
"16-Sep",경기,고양시 일산동구,275,110702,6665,117642,"2016-09-01",2016
"16-Sep",경기,고양시 일산서구,73,104720,3325,108118,"2016-09-01",2016
"16-Sep",경기,과천시,685,21573,561,22819,"2016-09-01",2016
"16-Sep",경기,광명시,276,101998,4269,106543,"2016-09-01",2016
"16-Sep",경기,광주시,345,150436,7853,158634,"2016-09-01",2016
"16-Sep",경기,구리시,206,61866,2400,64472,"2016-09-01",2016
"16-Sep",경기,군포시,235,93132,4840,98207,"2016-09-01",2016
"16-Sep",경기,김포시,378,153784,6150,160312,"2016-09-01",2016
"16-Sep",경기,남양주시,543,246824,6916,254283,"2016-09-01",2016
"16-Sep",경기,동두천시,193,35357,1267,36817,"2016-09-01",2016
"16-Sep",경기,부천시,640,278687,11352,290679,"2016-09-01",2016
"16-Sep",경기,부천시 소사구,,,,,"2016-09-01",2016
"16-Sep",경기,부천시 오정구,,,,,"2016-09-01",2016
"16-Sep",경기,부천시 원미구,,,,,"2016-09-01",2016
"16-Sep",경기,성남시 분당구,322,180817,6029,187168,"2016-09-01",2016
"16-Sep",경기,성남시 수정구,296,65256,2344,67896,"2016-09-01",2016
"16-Sep",경기,성남시 중원구,254,73121,3911,77286,"2016-09-01",2016
"16-Sep",경기,수원시 권선구,307,151660,7162,159129,"2016-09-01",2016
"16-Sep",경기,수원시 영통구,201,124155,2664,127020,"2016-09-01",2016
"16-Sep",경기,수원시 장안구,549,102905,3862,107316,"2016-09-01",2016
"16-Sep",경기,수원시 팔달구,456,70742,3651,74849,"2016-09-01",2016
"16-Sep",경기,시흥시,412,178039,7288,185739,"2016-09-01",2016
"16-Sep",경기,안산시 단원구,491,141060,8369,149920,"2016-09-01",2016
"16-Sep",경기,안산시 상록구,161,135184,4586,139931,"2016-09-01",2016
"16-Sep",경기,안성시,323,88416,4985,93724,"2016-09-01",2016
"16-Sep",경기,안양시 동안구,367,118391,6529,125287,"2016-09-01",2016
"16-Sep",경기,안양시 만안구,144,77794,3749,81687,"2016-09-01",2016
"16-Sep",경기,양주시,308,84679,2885,87872,"2016-09-01",2016
"16-Sep",경기,양평군,435,50526,1609,52570,"2016-09-01",2016
"16-Sep",경기,여주시,359,56006,7106,63471,"2016-09-01",2016
"16-Sep",경기,연천군,253,21395,5670,27318,"2016-09-01",2016
"16-Sep",경기,오산시,208,83655,3095,86958,"2016-09-01",2016
"16-Sep",경기,용인시 기흥구,92,160739,8205,169036,"2016-09-01",2016
"16-Sep",경기,용인시 수지구,46,125273,1887,127206,"2016-09-01",2016
"16-Sep",경기,용인시 처인구,576,102216,6469,109261,"2016-09-01",2016
"16-Sep",경기,의왕시,260,56069,2829,59158,"2016-09-01",2016
"16-Sep",경기,의정부시,518,137347,4863,142728,"2016-09-01",2016
"16-Sep",경기,이천시,351,96284,5778,102413,"2016-09-01",2016
"16-Sep",경기,파주시,372,176104,10007,186483,"2016-09-01",2016
"16-Sep",경기,평택시,590,214368,10392,225350,"2016-09-01",2016
"16-Sep",경기,포천시,335,77600,9364,87299,"2016-09-01",2016
"16-Sep",경기,하남시,311,75945,2110,78366,"2016-09-01",2016
"16-Sep",경기,화성시,709,299643,10642,310994,"2016-09-01",2016
"16-Sep",강원,계,5097,687244,24565,716906,"2016-09-01",2016
"16-Sep",강원,강릉시,474,96463,4206,101143,"2016-09-01",2016
"16-Sep",강원,고성군,145,12585,243,12973,"2016-09-01",2016
"16-Sep",강원,동해시,278,40588,1377,42243,"2016-09-01",2016
"16-Sep",강원,삼척시,326,29051,706,30083,"2016-09-01",2016
"16-Sep",강원,속초시,273,33758,1259,35290,"2016-09-01",2016
"16-Sep",강원,양구군,128,10827,129,11084,"2016-09-01",2016
"16-Sep",강원,양양군,153,13121,247,13521,"2016-09-01",2016
"16-Sep",강원,영월군,299,18954,399,19652,"2016-09-01",2016
"16-Sep",강원,원주시,508,146692,5856,153056,"2016-09-01",2016
"16-Sep",강원,인제군,182,16194,208,16584,"2016-09-01",2016
"16-Sep",강원,정선군,286,18867,471,19624,"2016-09-01",2016
"16-Sep",강원,철원군,181,22010,312,22503,"2016-09-01",2016
"16-Sep",강원,춘천시,685,116292,5857,122834,"2016-09-01",2016
"16-Sep",강원,태백시,202,19938,836,20976,"2016-09-01",2016
"16-Sep",강원,평창군,264,23615,425,24304,"2016-09-01",2016
"16-Sep",강원,홍천군,329,34234,1114,35677,"2016-09-01",2016
"16-Sep",강원,화천군,170,11445,130,11745,"2016-09-01",2016
"16-Sep",강원,횡성군,214,22610,790,23614,"2016-09-01",2016
"16-Sep",충북,계,3437,718368,32542,754347,"2016-09-01",2016
"16-Sep",충북,괴산군,169,19907,362,20438,"2016-09-01",2016
"16-Sep",충북,단양군,157,14427,832,15416,"2016-09-01",2016
"16-Sep",충북,보은군,187,16219,929,17335,"2016-09-01",2016
"16-Sep",충북,영동군,209,23156,384,23749,"2016-09-01",2016
"16-Sep",충북,옥천군,184,23988,1019,25191,"2016-09-01",2016
"16-Sep",충북,음성군,194,52668,1679,54541,"2016-09-01",2016
"16-Sep",충북,제천시,307,60682,3291,64280,"2016-09-01",2016
"16-Sep",충북,증평군,75,16870,741,17686,"2016-09-01",2016
"16-Sep",충북,진천군,178,36390,1080,37648,"2016-09-01",2016
"16-Sep",충북,청원군,1,35,1,37,"2016-09-01",2016
"16-Sep",충북,청주시 상당구,394,72667,2662,75723,"2016-09-01",2016
"16-Sep",충북,청주시 서원구,216,89548,6175,95939,"2016-09-01",2016
"16-Sep",충북,청주시 청원구,309,88604,3694,92607,"2016-09-01",2016
"16-Sep",충북,청주시 흥덕구,344,108106,6033,114483,"2016-09-01",2016
"16-Sep",충북,충주시,513,95101,3660,99274,"2016-09-01",2016
"16-Sep",충남,계,4784,961322,39116,1005222,"2016-09-01",2016
"16-Sep",충남,계룡시,131,19074,488,19693,"2016-09-01",2016
"16-Sep",충남,공주시,488,49748,2139,52375,"2016-09-01",2016
"16-Sep",충남,금산군,167,26287,2394,28848,"2016-09-01",2016
"16-Sep",충남,논산시,322,56185,2142,58649,"2016-09-01",2016
"16-Sep",충남,당진시,345,82928,3633,86906,"2016-09-01",2016
"16-Sep",충남,보령시,325,47601,1309,49235,"2016-09-01",2016
"16-Sep",충남,부여군,231,31785,1407,33423,"2016-09-01",2016
"16-Sep",충남,서산시,369,80107,3485,83961,"2016-09-01",2016
"16-Sep",충남,서천군,200,25533,964,26697,"2016-09-01",2016
"16-Sep",충남,아산시,374,140033,6162,146569,"2016-09-01",2016
"16-Sep",충남,예산군,314,39294,1405,41013,"2016-09-01",2016
"16-Sep",충남,천안시 동남구,234,116066,5014,121314,"2016-09-01",2016
"16-Sep",충남,천안시 서북구,489,154983,5846,161318,"2016-09-01",2016
"16-Sep",충남,청양군,215,15144,925,16284,"2016-09-01",2016
"16-Sep",충남,태안군,215,30483,497,31195,"2016-09-01",2016
"16-Sep",충남,홍성군,365,46012,1305,47682,"2016-09-01",2016
"16-Sep",전북,계,4353,820788,37606,862747,"2016-09-01",2016
"16-Sep",전북,고창군,222,27922,544,28688,"2016-09-01",2016
"16-Sep",전북,군산시,430,120532,6899,127861,"2016-09-01",2016
"16-Sep",전북,김제시,251,41562,1780,43593,"2016-09-01",2016
"16-Sep",전북,남원시,370,36967,3076,40413,"2016-09-01",2016
"16-Sep",전북,무주군,160,11526,366,12052,"2016-09-01",2016
"16-Sep",전북,부안군,234,25787,598,26619,"2016-09-01",2016
"16-Sep",전북,순창군,178,13137,227,13542,"2016-09-01",2016
"16-Sep",전북,완주군,289,47082,3500,50871,"2016-09-01",2016
"16-Sep",전북,익산시,436,128983,6139,135558,"2016-09-01",2016
"16-Sep",전북,임실군,172,12924,401,13497,"2016-09-01",2016
"16-Sep",전북,장수군,184,10898,162,11244,"2016-09-01",2016
"16-Sep",전북,전주시 덕진구,355,136776,7508,144639,"2016-09-01",2016
"16-Sep",전북,전주시 완산구,584,144694,4020,149298,"2016-09-01",2016
"16-Sep",전북,정읍시,286,49448,2205,51939,"2016-09-01",2016
"16-Sep",전북,진안군,202,12550,181,12933,"2016-09-01",2016
"16-Sep",전남,계,5312,834853,97216,937381,"2016-09-01",2016
"16-Sep",전남,강진군,188,16969,977,18134,"2016-09-01",2016
"16-Sep",전남,고흥군,228,28065,674,28967,"2016-09-01",2016
"16-Sep",전남,곡성군,140,13532,990,14662,"2016-09-01",2016
"16-Sep",전남,광양시,233,72130,5872,78235,"2016-09-01",2016
"16-Sep",전남,구례군,105,11961,657,12723,"2016-09-01",2016
"16-Sep",전남,나주시,366,49790,3153,53309,"2016-09-01",2016
"16-Sep",전남,담양군,167,23777,1557,25501,"2016-09-01",2016
"16-Sep",전남,목포시,431,89769,6033,96233,"2016-09-01",2016
"16-Sep",전남,무안군,448,37912,1063,39423,"2016-09-01",2016
"16-Sep",전남,보성군,207,19804,38975,58986,"2016-09-01",2016
"16-Sep",전남,순천시,451,120405,4809,125665,"2016-09-01",2016
"16-Sep",전남,신안군,189,18619,634,19442,"2016-09-01",2016
"16-Sep",전남,여수시,479,117306,6513,124298,"2016-09-01",2016
"16-Sep",전남,영광군,202,24968,704,25874,"2016-09-01",2016
"16-Sep",전남,영암군,212,30515,19044,49771,"2016-09-01",2016
"16-Sep",전남,완도군,200,22370,485,23055,"2016-09-01",2016
"16-Sep",전남,장성군,131,23015,1247,24393,"2016-09-01",2016
"16-Sep",전남,장흥군,173,18215,447,18835,"2016-09-01",2016
"16-Sep",전남,진도군,132,14888,291,15311,"2016-09-01",2016
"16-Sep",전남,함평군,144,16057,385,16586,"2016-09-01",2016
"16-Sep",전남,해남군,288,35524,564,36376,"2016-09-01",2016
"16-Sep",전남,화순군,198,29262,2142,31602,"2016-09-01",2016
"16-Sep",경북,계,6351,1290503,49160,1346014,"2016-09-01",2016
"16-Sep",경북,경산시,392,123348,4167,127907,"2016-09-01",2016
"16-Sep",경북,경주시,504,128523,5137,134164,"2016-09-01",2016
"16-Sep",경북,고령군,138,19807,418,20363,"2016-09-01",2016
"16-Sep",경북,구미시,433,191311,7641,199385,"2016-09-01",2016
"16-Sep",경북,군위군,109,13199,255,13563,"2016-09-01",2016
"16-Sep",경북,김천시,322,66019,1753,68094,"2016-09-01",2016
"16-Sep",경북,문경시,248,33181,784,34213,"2016-09-01",2016
"16-Sep",경북,봉화군,182,16092,205,16479,"2016-09-01",2016
"16-Sep",경북,상주시,333,48406,1823,50562,"2016-09-01",2016
"16-Sep",경북,성주군,168,27720,1500,29388,"2016-09-01",2016
"16-Sep",경북,안동시,526,76485,2583,79594,"2016-09-01",2016
"16-Sep",경북,영덕군,211,17492,311,18014,"2016-09-01",2016
"16-Sep",경북,영양군,121,8580,97,8798,"2016-09-01",2016
"16-Sep",경북,영주시,312,52096,1643,54051,"2016-09-01",2016
"16-Sep",경북,영천시,232,52576,2670,55478,"2016-09-01",2016
"16-Sep",경북,예천군,173,21717,428,22318,"2016-09-01",2016
"16-Sep",경북,울릉군,129,4673,411,5213,"2016-09-01",2016
"16-Sep",경북,울진군,244,23913,391,24548,"2016-09-01",2016
"16-Sep",경북,의성군,276,27344,985,28605,"2016-09-01",2016
"16-Sep",경북,청도군,143,22526,638,23307,"2016-09-01",2016
"16-Sep",경북,청송군,182,13777,197,14156,"2016-09-01",2016
"16-Sep",경북,칠곡군,302,64587,2189,67078,"2016-09-01",2016
"16-Sep",경북,포항시 남구,351,114538,9004,123893,"2016-09-01",2016
"16-Sep",경북,포항시 북구,320,122593,3930,126843,"2016-09-01",2016
"16-Sep",경남,계,6234,1525790,81984,1614008,"2016-09-01",2016
"16-Sep",경남,거제시,312,102215,2673,105200,"2016-09-01",2016
"16-Sep",경남,거창군,224,28688,790,29702,"2016-09-01",2016
"16-Sep",경남,고성군,204,24833,708,25745,"2016-09-01",2016
"16-Sep",경남,김해시,570,240936,6618,248124,"2016-09-01",2016
"16-Sep",경남,남해군,210,17644,517,18371,"2016-09-01",2016
"16-Sep",경남,밀양시,283,51148,4315,55746,"2016-09-01",2016
"16-Sep",경남,사천시,280,50783,1555,52618,"2016-09-01",2016
"16-Sep",경남,산청군,177,17722,769,18668,"2016-09-01",2016
"16-Sep",경남,양산시,343,132091,8839,141273,"2016-09-01",2016
"16-Sep",경남,의령군,164,12729,782,13675,"2016-09-01",2016
"16-Sep",경남,진주시,544,147706,6838,155088,"2016-09-01",2016
"16-Sep",경남,창녕군,205,32279,761,33245,"2016-09-01",2016
"16-Sep",경남,창원시 마산합포구,311,94390,3125,97826,"2016-09-01",2016
"16-Sep",경남,창원시 마산회원구,163,97919,5448,103530,"2016-09-01",2016
"16-Sep",경남,창원시 성산구,139,121697,17509,139345,"2016-09-01",2016
"16-Sep",경남,창원시 의창구,829,121341,5855,128025,"2016-09-01",2016
"16-Sep",경남,창원시 진해구,187,78465,1559,80211,"2016-09-01",2016
"16-Sep",경남,통영시,293,50647,1515,52455,"2016-09-01",2016
"16-Sep",경남,하동군,197,22776,447,23420,"2016-09-01",2016
"16-Sep",경남,함안군,172,40626,9915,50713,"2016-09-01",2016
"16-Sep",경남,함양군,195,17997,445,18637,"2016-09-01",2016
"16-Sep",경남,합천군,232,21158,1001,22391,"2016-09-01",2016
"16-Sep",제주,계,1947,350600,107761,460308,"2016-09-01",2016
"16-Sep",제주,서귀포시,642,88993,2416,92051,"2016-09-01",2016
"16-Sep",제주,제주시,1305,261607,105345,368257,"2016-09-01",2016
"16-Oct",서울,계,11292,2874714,197263,3083269,"2016-10-01",2016
"16-Oct",서울,강남구,349,222796,19681,242826,"2016-10-01",2016
"16-Oct",서울,강동구,223,128115,8504,136842,"2016-10-01",2016
"16-Oct",서울,강북구,279,71666,4876,76821,"2016-10-01",2016
"16-Oct",서울,강서구,286,178550,14909,193745,"2016-10-01",2016
"16-Oct",서울,관악구,276,116027,5802,122105,"2016-10-01",2016
"16-Oct",서울,광진구,271,91430,5750,97451,"2016-10-01",2016
"16-Oct",서울,구로구,223,129220,11561,141004,"2016-10-01",2016
"16-Oct",서울,금천구,125,76546,7256,83927,"2016-10-01",2016
"16-Oct",서울,노원구,255,146235,9690,156180,"2016-10-01",2016
"16-Oct",서울,도봉구,232,89111,7716,97059,"2016-10-01",2016
"16-Oct",서울,동대문구,274,91343,5776,97393,"2016-10-01",2016
"16-Oct",서울,동작구,270,101081,2800,104151,"2016-10-01",2016
"16-Oct",서울,마포구,289,109495,7523,117307,"2016-10-01",2016
"16-Oct",서울,서대문구,424,78803,5245,84472,"2016-10-01",2016
"16-Oct",서울,서초구,589,168787,10453,179829,"2016-10-01",2016
"16-Oct",서울,성동구,269,89049,9166,98484,"2016-10-01",2016
"16-Oct",서울,성북구,224,111118,5515,116857,"2016-10-01",2016
"16-Oct",서울,송파구,331,209626,11803,221760,"2016-10-01",2016
"16-Oct",서울,양천구,300,141476,8993,150769,"2016-10-01",2016
"16-Oct",서울,영등포구,307,136313,10173,146793,"2016-10-01",2016
"16-Oct",서울,용산구,354,73410,2053,75817,"2016-10-01",2016
"16-Oct",서울,은평구,227,120755,6903,127885,"2016-10-01",2016
"16-Oct",서울,종로구,3697,44269,1649,49615,"2016-10-01",2016
"16-Oct",서울,중구,1030,47348,3787,52165,"2016-10-01",2016
"16-Oct",서울,중랑구,188,102145,9679,112012,"2016-10-01",2016
"16-Oct",부산,계,4306,1206439,80339,1291084,"2016-10-01",2016
"16-Oct",부산,강서구,302,58189,3945,62436,"2016-10-01",2016
"16-Oct",부산,금정구,270,78971,7404,86645,"2016-10-01",2016
"16-Oct",부산,기장군,221,65032,2131,67384,"2016-10-01",2016
"16-Oct",부산,남구,204,86726,8995,95925,"2016-10-01",2016
"16-Oct",부산,동구,223,39406,5628,45257,"2016-10-01",2016
"16-Oct",부산,동래구,164,86017,4411,90592,"2016-10-01",2016
"16-Oct",부산,부산진구,361,122336,6178,128875,"2016-10-01",2016
"16-Oct",부산,북구,215,100487,3404,104106,"2016-10-01",2016
"16-Oct",부산,사상구,259,84568,6406,91233,"2016-10-01",2016
"16-Oct",부산,사하구,239,106440,7105,113784,"2016-10-01",2016
"16-Oct",부산,서구,127,27556,1345,29028,"2016-10-01",2016
"16-Oct",부산,수영구,152,64867,3072,68091,"2016-10-01",2016
"16-Oct",부산,연제구,795,82898,5983,89676,"2016-10-01",2016
"16-Oct",부산,영도구,218,31665,2612,34495,"2016-10-01",2016
"16-Oct",부산,중구,300,16123,6297,22720,"2016-10-01",2016
"16-Oct",부산,해운대구,256,155158,5423,160837,"2016-10-01",2016
"16-Oct",대구,계,2807,1073843,48442,1125092,"2016-10-01",2016
"16-Oct",대구,남구,303,56498,2135,58936,"2016-10-01",2016
"16-Oct",대구,달서구,408,252700,11761,264869,"2016-10-01",2016
"16-Oct",대구,달성군,406,99888,3584,103878,"2016-10-01",2016
"16-Oct",대구,동구,313,143391,10739,154443,"2016-10-01",2016
"16-Oct",대구,북구,410,184889,8406,193705,"2016-10-01",2016
"16-Oct",대구,서구,203,75758,4581,80542,"2016-10-01",2016
"16-Oct",대구,수성구,496,203578,5352,209426,"2016-10-01",2016
"16-Oct",대구,중구,268,57141,1884,59293,"2016-10-01",2016
"16-Oct",인천,계,3409,1158232,259999,1421640,"2016-10-01",2016
"16-Oct",인천,강화군,287,30041,2747,33075,"2016-10-01",2016
"16-Oct",인천,계양구,245,120081,129206,249532,"2016-10-01",2016
"16-Oct",인천,남구,366,138915,51953,191234,"2016-10-01",2016
"16-Oct",인천,남동구,768,229394,31728,261890,"2016-10-01",2016
"16-Oct",인천,동구,83,25690,2592,28365,"2016-10-01",2016
"16-Oct",인천,부평구,315,205427,7191,212933,"2016-10-01",2016
"16-Oct",인천,서구,346,202494,10680,213520,"2016-10-01",2016
"16-Oct",인천,연수구,294,144615,7250,152159,"2016-10-01",2016
"16-Oct",인천,옹진군,164,10832,157,11153,"2016-10-01",2016
"16-Oct",인천,중구,541,50743,16495,67779,"2016-10-01",2016
"16-Oct",광주,계,1942,595697,33460,631099,"2016-10-01",2016
"16-Oct",광주,광산구,470,169548,9810,179828,"2016-10-01",2016
"16-Oct",광주,남구,169,81937,3278,85384,"2016-10-01",2016
"16-Oct",광주,동구,214,34859,1190,36263,"2016-10-01",2016
"16-Oct",광주,북구,438,173021,9546,183005,"2016-10-01",2016
"16-Oct",광주,서구,651,136332,9636,146619,"2016-10-01",2016
"16-Oct",대전,계,1759,615413,27940,645112,"2016-10-01",2016
"16-Oct",대전,대덕구,271,84955,6560,91786,"2016-10-01",2016
"16-Oct",대전,동구,161,86229,4221,90611,"2016-10-01",2016
"16-Oct",대전,서구,750,194882,7019,202651,"2016-10-01",2016
"16-Oct",대전,유성구,364,154209,4479,159052,"2016-10-01",2016
"16-Oct",대전,중구,213,95138,5661,101012,"2016-10-01",2016
"16-Oct",울산,계,1541,513042,21548,536131,"2016-10-01",2016
"16-Oct",울산,남구,624,149771,7448,157843,"2016-10-01",2016
"16-Oct",울산,동구,182,62692,930,63804,"2016-10-01",2016
"16-Oct",울산,북구,113,90578,4580,95271,"2016-10-01",2016
"16-Oct",울산,울주군,311,108517,5862,114690,"2016-10-01",2016
"16-Oct",울산,중구,311,101484,2728,104523,"2016-10-01",2016
"16-Oct",세종,계,647,105201,2317,108165,"2016-10-01",2016
"16-Oct",세종,세종특별자치시,647,105201,2317,108165,"2016-10-01",2016
"16-Oct",경기,계,14721,4880693,218115,5113529,"2016-10-01",2016
"16-Oct",경기,가평군,330,27252,731,28313,"2016-10-01",2016
"16-Oct",경기,고양시 덕양구,581,150676,3764,155021,"2016-10-01",2016
"16-Oct",경기,고양시 일산동구,275,111365,6593,118233,"2016-10-01",2016
"16-Oct",경기,고양시 일산서구,73,104918,3258,108249,"2016-10-01",2016
"16-Oct",경기,과천시,683,21555,560,22798,"2016-10-01",2016
"16-Oct",경기,광명시,276,102069,4265,106610,"2016-10-01",2016
"16-Oct",경기,광주시,339,151163,7917,159419,"2016-10-01",2016
"16-Oct",경기,구리시,207,62015,2402,64624,"2016-10-01",2016
"16-Oct",경기,군포시,236,93275,4824,98335,"2016-10-01",2016
"16-Oct",경기,김포시,380,154763,6164,161307,"2016-10-01",2016
"16-Oct",경기,남양주시,559,247532,6925,255016,"2016-10-01",2016
"16-Oct",경기,동두천시,192,35432,1262,36886,"2016-10-01",2016
"16-Oct",경기,부천시,636,280048,11357,292041,"2016-10-01",2016
"16-Oct",경기,성남시 분당구,318,181140,6066,187524,"2016-10-01",2016
"16-Oct",경기,성남시 수정구,292,65132,2343,67767,"2016-10-01",2016
"16-Oct",경기,성남시 중원구,253,72890,3883,77026,"2016-10-01",2016
"16-Oct",경기,수원시 권선구,304,152390,7163,159857,"2016-10-01",2016
"16-Oct",경기,수원시 영통구,199,124409,2657,127265,"2016-10-01",2016
"16-Oct",경기,수원시 장안구,551,102974,3955,107480,"2016-10-01",2016
"16-Oct",경기,수원시 팔달구,455,70910,3626,74991,"2016-10-01",2016
"16-Oct",경기,시흥시,407,178561,7343,186311,"2016-10-01",2016
"16-Oct",경기,안산시 단원구,494,141281,8419,150194,"2016-10-01",2016
"16-Oct",경기,안산시 상록구,160,135537,4597,140294,"2016-10-01",2016
"16-Oct",경기,안성시,321,88674,4989,93984,"2016-10-01",2016
"16-Oct",경기,안양시 동안구,368,118575,6559,125502,"2016-10-01",2016
"16-Oct",경기,안양시 만안구,146,77870,3749,81765,"2016-10-01",2016
"16-Oct",경기,양주시,310,84951,2875,88136,"2016-10-01",2016
"16-Oct",경기,양평군,440,50736,1613,52789,"2016-10-01",2016
"16-Oct",경기,여주시,358,56201,7041,63600,"2016-10-01",2016
"16-Oct",경기,연천군,252,21525,5666,27443,"2016-10-01",2016
"16-Oct",경기,오산시,207,84092,3110,87409,"2016-10-01",2016
"16-Oct",경기,용인시 기흥구,92,161310,8355,169757,"2016-10-01",2016
"16-Oct",경기,용인시 수지구,49,125518,2002,127569,"2016-10-01",2016
"16-Oct",경기,용인시 처인구,570,102648,6465,109683,"2016-10-01",2016
"16-Oct",경기,의왕시,258,56132,2827,59217,"2016-10-01",2016
"16-Oct",경기,의정부시,522,137786,4863,143171,"2016-10-01",2016
"16-Oct",경기,이천시,348,96711,5796,102855,"2016-10-01",2016
"16-Oct",경기,파주시,376,176804,10070,187250,"2016-10-01",2016
"16-Oct",경기,평택시,583,215455,10310,226348,"2016-10-01",2016
"16-Oct",경기,포천시,338,77848,9238,87424,"2016-10-01",2016
"16-Oct",경기,하남시,300,78643,2025,80968,"2016-10-01",2016
"16-Oct",경기,화성시,683,301927,10488,313098,"2016-10-01",2016
"16-Oct",강원,계,5065,689102,24520,718687,"2016-10-01",2016
"16-Oct",강원,강릉시,473,96639,4199,101311,"2016-10-01",2016
"16-Oct",강원,고성군,141,12650,244,13035,"2016-10-01",2016
"16-Oct",강원,동해시,278,40746,1373,42397,"2016-10-01",2016
"16-Oct",강원,삼척시,323,29093,721,30137,"2016-10-01",2016
"16-Oct",강원,속초시,273,33663,1248,35184,"2016-10-01",2016
"16-Oct",강원,양구군,129,10850,127,11106,"2016-10-01",2016
"16-Oct",강원,양양군,152,13229,243,13624,"2016-10-01",2016
"16-Oct",강원,영월군,295,18995,397,19687,"2016-10-01",2016
"16-Oct",강원,원주시,501,147294,5886,153681,"2016-10-01",2016
"16-Oct",강원,인제군,183,16265,208,16656,"2016-10-01",2016
"16-Oct",강원,정선군,283,18867,473,19623,"2016-10-01",2016
"16-Oct",강원,철원군,180,22077,311,22568,"2016-10-01",2016
"16-Oct",강원,춘천시,678,116622,5825,123125,"2016-10-01",2016
"16-Oct",강원,태백시,200,19933,818,20951,"2016-10-01",2016
"16-Oct",강원,평창군,263,23677,422,24362,"2016-10-01",2016
"16-Oct",강원,홍천군,328,34345,1114,35787,"2016-10-01",2016
"16-Oct",강원,화천군,170,11492,129,11791,"2016-10-01",2016
"16-Oct",강원,횡성군,215,22665,782,23662,"2016-10-01",2016
"16-Oct",충북,계,3392,720511,32577,756480,"2016-10-01",2016
"16-Oct",충북,괴산군,164,19929,371,20464,"2016-10-01",2016
"16-Oct",충북,단양군,151,14453,839,15443,"2016-10-01",2016
"16-Oct",충북,보은군,186,16251,925,17362,"2016-10-01",2016
"16-Oct",충북,영동군,204,23227,383,23814,"2016-10-01",2016
"16-Oct",충북,옥천군,180,24102,1026,25308,"2016-10-01",2016
"16-Oct",충북,음성군,194,52890,1682,54766,"2016-10-01",2016
"16-Oct",충북,제천시,297,60904,3303,64504,"2016-10-01",2016
"16-Oct",충북,증평군,75,16933,747,17755,"2016-10-01",2016
"16-Oct",충북,진천군,175,36582,1106,37863,"2016-10-01",2016
"16-Oct",충북,청원군,1,35,1,37,"2016-10-01",2016
"16-Oct",충북,청주시 상당구,393,72905,2587,75885,"2016-10-01",2016
"16-Oct",충북,청주시 서원구,216,89289,6181,95686,"2016-10-01",2016
"16-Oct",충북,청주시 청원구,307,89372,3694,93373,"2016-10-01",2016
"16-Oct",충북,청주시 흥덕구,342,108354,6060,114756,"2016-10-01",2016
"16-Oct",충북,충주시,507,95285,3672,99464,"2016-10-01",2016
"16-Oct",충남,계,4804,964423,39120,1008347,"2016-10-01",2016
"16-Oct",충남,계룡시,131,19174,498,19803,"2016-10-01",2016
"16-Oct",충남,공주시,491,49849,2126,52466,"2016-10-01",2016
"16-Oct",충남,금산군,163,26341,2406,28910,"2016-10-01",2016
"16-Oct",충남,논산시,326,56296,2150,58772,"2016-10-01",2016
"16-Oct",충남,당진시,345,83275,3614,87234,"2016-10-01",2016
"16-Oct",충남,보령시,326,47696,1310,49332,"2016-10-01",2016
"16-Oct",충남,부여군,236,31826,1443,33505,"2016-10-01",2016
"16-Oct",충남,서산시,370,80420,3464,84254,"2016-10-01",2016
"16-Oct",충남,서천군,201,25577,964,26742,"2016-10-01",2016
"16-Oct",충남,아산시,381,140390,6134,146905,"2016-10-01",2016
"16-Oct",충남,예산군,314,39320,1413,41047,"2016-10-01",2016
"16-Oct",충남,천안시 동남구,235,116240,4995,121470,"2016-10-01",2016
"16-Oct",충남,천안시 서북구,489,155973,5863,162325,"2016-10-01",2016
"16-Oct",충남,청양군,212,15188,925,16325,"2016-10-01",2016
"16-Oct",충남,태안군,217,30534,502,31253,"2016-10-01",2016
"16-Oct",충남,홍성군,367,46324,1313,48004,"2016-10-01",2016
"16-Oct",전북,계,4330,822584,37921,864835,"2016-10-01",2016
"16-Oct",전북,고창군,220,27955,541,28716,"2016-10-01",2016
"16-Oct",전북,군산시,430,120696,6934,128060,"2016-10-01",2016
"16-Oct",전북,김제시,249,41631,1795,43675,"2016-10-01",2016
"16-Oct",전북,남원시,368,37036,3398,40802,"2016-10-01",2016
"16-Oct",전북,무주군,160,11595,366,12121,"2016-10-01",2016
"16-Oct",전북,부안군,237,25823,600,26660,"2016-10-01",2016
"16-Oct",전북,순창군,180,13130,225,13535,"2016-10-01",2016
"16-Oct",전북,완주군,285,47216,3487,50988,"2016-10-01",2016
"16-Oct",전북,익산시,432,129240,6127,135799,"2016-10-01",2016
"16-Oct",전북,임실군,169,12963,399,13531,"2016-10-01",2016
"16-Oct",전북,장수군,181,10924,167,11272,"2016-10-01",2016
"16-Oct",전북,전주시 덕진구,353,137208,7495,145056,"2016-10-01",2016
"16-Oct",전북,전주시 완산구,579,144994,4023,149596,"2016-10-01",2016
"16-Oct",전북,정읍시,284,49609,2183,52076,"2016-10-01",2016
"16-Oct",전북,진안군,203,12564,181,12948,"2016-10-01",2016
"16-Oct",전남,계,5276,836968,100344,942588,"2016-10-01",2016
"16-Oct",전남,강진군,187,17017,973,18177,"2016-10-01",2016
"16-Oct",전남,고흥군,227,28134,670,29031,"2016-10-01",2016
"16-Oct",전남,곡성군,140,13564,982,14686,"2016-10-01",2016
"16-Oct",전남,광양시,221,72426,5863,78510,"2016-10-01",2016
"16-Oct",전남,구례군,104,11983,653,12740,"2016-10-01",2016
"16-Oct",전남,나주시,367,50230,3150,53747,"2016-10-01",2016
"16-Oct",전남,담양군,166,23821,1557,25544,"2016-10-01",2016
"16-Oct",전남,목포시,430,89898,6049,96377,"2016-10-01",2016
"16-Oct",전남,무안군,447,37985,1062,39494,"2016-10-01",2016
"16-Oct",전남,보성군,208,19800,42404,62412,"2016-10-01",2016
"16-Oct",전남,순천시,453,120800,4826,126079,"2016-10-01",2016
"16-Oct",전남,신안군,186,18647,640,19473,"2016-10-01",2016
"16-Oct",전남,여수시,482,117399,6520,124401,"2016-10-01",2016
"16-Oct",전남,영광군,201,25028,707,25936,"2016-10-01",2016
"16-Oct",전남,영암군,213,30499,18756,49468,"2016-10-01",2016
"16-Oct",전남,완도군,197,22450,480,23127,"2016-10-01",2016
"16-Oct",전남,장성군,131,23044,1238,24413,"2016-10-01",2016
"16-Oct",전남,장흥군,170,18282,447,18899,"2016-10-01",2016
"16-Oct",전남,진도군,129,14931,293,15353,"2016-10-01",2016
"16-Oct",전남,함평군,144,16120,375,16639,"2016-10-01",2016
"16-Oct",전남,해남군,279,35607,564,36450,"2016-10-01",2016
"16-Oct",전남,화순군,194,29303,2135,31632,"2016-10-01",2016
"16-Oct",경북,계,6329,1293054,49174,1348557,"2016-10-01",2016
"16-Oct",경북,경산시,389,123626,4180,128195,"2016-10-01",2016
"16-Oct",경북,경주시,501,128627,5119,134247,"2016-10-01",2016
"16-Oct",경북,고령군,139,19819,423,20381,"2016-10-01",2016
"16-Oct",경북,구미시,433,191631,7634,199698,"2016-10-01",2016
"16-Oct",경북,군위군,109,13257,255,13621,"2016-10-01",2016
"16-Oct",경북,김천시,323,66232,1747,68302,"2016-10-01",2016
"16-Oct",경북,문경시,250,33273,782,34305,"2016-10-01",2016
"16-Oct",경북,봉화군,182,16110,208,16500,"2016-10-01",2016
"16-Oct",경북,상주시,336,48407,1826,50569,"2016-10-01",2016
"16-Oct",경북,성주군,168,27764,1507,29439,"2016-10-01",2016
"16-Oct",경북,안동시,515,76615,2586,79716,"2016-10-01",2016
"16-Oct",경북,영덕군,211,17546,311,18068,"2016-10-01",2016
"16-Oct",경북,영양군,123,8618,98,8839,"2016-10-01",2016
"16-Oct",경북,영주시,310,52210,1641,54161,"2016-10-01",2016
"16-Oct",경북,영천시,232,52748,2679,55659,"2016-10-01",2016
"16-Oct",경북,예천군,172,21802,428,22402,"2016-10-01",2016
"16-Oct",경북,울릉군,128,4660,412,5200,"2016-10-01",2016
"16-Oct",경북,울진군,243,23945,373,24561,"2016-10-01",2016
"16-Oct",경북,의성군,274,27445,989,28708,"2016-10-01",2016
"16-Oct",경북,청도군,141,22597,634,23372,"2016-10-01",2016
"16-Oct",경북,청송군,185,13830,208,14223,"2016-10-01",2016
"16-Oct",경북,칠곡군,297,64853,2204,67354,"2016-10-01",2016
"16-Oct",경북,포항시 남구,347,114664,9020,124031,"2016-10-01",2016
"16-Oct",경북,포항시 북구,321,122775,3910,127006,"2016-10-01",2016
"16-Oct",경남,계,6263,1528079,82162,1616504,"2016-10-01",2016
"16-Oct",경남,거제시,308,102235,2649,105192,"2016-10-01",2016
"16-Oct",경남,거창군,225,28769,788,29782,"2016-10-01",2016
"16-Oct",경남,고성군,202,24892,710,25804,"2016-10-01",2016
"16-Oct",경남,김해시,579,241215,6594,248388,"2016-10-01",2016
"16-Oct",경남,남해군,212,17693,518,18423,"2016-10-01",2016
"16-Oct",경남,밀양시,284,51274,4296,55854,"2016-10-01",2016
"16-Oct",경남,사천시,281,50949,1558,52788,"2016-10-01",2016
"16-Oct",경남,산청군,179,17772,766,18717,"2016-10-01",2016
"16-Oct",경남,양산시,344,133005,8834,142183,"2016-10-01",2016
"16-Oct",경남,의령군,165,12754,778,13697,"2016-10-01",2016
"16-Oct",경남,진주시,544,148059,6825,155428,"2016-10-01",2016
"16-Oct",경남,창녕군,202,32381,772,33355,"2016-10-01",2016
"16-Oct",경남,창원시 마산합포구,312,94754,3103,98169,"2016-10-01",2016
"16-Oct",경남,창원시 마산회원구,165,97935,5462,103562,"2016-10-01",2016
"16-Oct",경남,창원시 성산구,139,121413,17979,139531,"2016-10-01",2016
"16-Oct",경남,창원시 의창구,834,121103,5713,127650,"2016-10-01",2016
"16-Oct",경남,창원시 진해구,189,78594,1551,80334,"2016-10-01",2016
"16-Oct",경남,통영시,299,50686,1503,52488,"2016-10-01",2016
"16-Oct",경남,하동군,196,22819,446,23461,"2016-10-01",2016
"16-Oct",경남,함안군,175,40618,9877,50670,"2016-10-01",2016
"16-Oct",경남,함양군,196,18010,438,18644,"2016-10-01",2016
"16-Oct",경남,합천군,233,21149,1002,22384,"2016-10-01",2016
"16-Oct",제주,계,1949,351651,108276,461876,"2016-10-01",2016
"16-Oct",제주,서귀포시,642,89461,2408,92511,"2016-10-01",2016
"16-Oct",제주,제주시,1307,262190,105868,369365,"2016-10-01",2016
"16-Nov",서울,계,11300,2876250,196695,3084245,"2016-11-01",2016
"16-Nov",서울,강남구,353,222809,19701,242863,"2016-11-01",2016
"16-Nov",서울,강동구,224,127911,8470,136605,"2016-11-01",2016
"16-Nov",서울,강북구,277,71724,4893,76894,"2016-11-01",2016
"16-Nov",서울,강서구,289,179570,15005,194864,"2016-11-01",2016
"16-Nov",서울,관악구,264,116143,5817,122224,"2016-11-01",2016
"16-Nov",서울,광진구,274,91289,5707,97270,"2016-11-01",2016
"16-Nov",서울,구로구,223,129352,11530,141105,"2016-11-01",2016
"16-Nov",서울,금천구,124,76663,7209,83996,"2016-11-01",2016
"16-Nov",서울,노원구,257,146233,9614,156104,"2016-11-01",2016
"16-Nov",서울,도봉구,230,89155,7697,97082,"2016-11-01",2016
"16-Nov",서울,동대문구,275,91368,5793,97436,"2016-11-01",2016
"16-Nov",서울,동작구,268,101202,2787,104257,"2016-11-01",2016
"16-Nov",서울,마포구,288,109465,7511,117264,"2016-11-01",2016
"16-Nov",서울,서대문구,424,78797,5239,84460,"2016-11-01",2016
"16-Nov",서울,서초구,583,169250,10257,180090,"2016-11-01",2016
"16-Nov",서울,성동구,269,89120,9301,98690,"2016-11-01",2016
"16-Nov",서울,성북구,224,111050,5521,116795,"2016-11-01",2016
"16-Nov",서울,송파구,331,210118,11859,222308,"2016-11-01",2016
"16-Nov",서울,양천구,299,141248,9067,150614,"2016-11-01",2016
"16-Nov",서울,영등포구,309,135924,9739,145972,"2016-11-01",2016
"16-Nov",서울,용산구,353,73260,2032,75645,"2016-11-01",2016
"16-Nov",서울,은평구,228,120840,6854,127922,"2016-11-01",2016
"16-Nov",서울,종로구,3740,44251,1662,49653,"2016-11-01",2016
"16-Nov",서울,중구,1004,47241,3764,52009,"2016-11-01",2016
"16-Nov",서울,중랑구,190,102267,9666,112123,"2016-11-01",2016
"16-Nov",부산,계,4343,1209345,79419,1293107,"2016-11-01",2016
"16-Nov",부산,강서구,299,58544,3908,62751,"2016-11-01",2016
"16-Nov",부산,금정구,270,79099,7381,86750,"2016-11-01",2016
"16-Nov",부산,기장군,223,65314,2132,67669,"2016-11-01",2016
"16-Nov",부산,남구,207,86780,9019,96006,"2016-11-01",2016
"16-Nov",부산,동구,223,39581,5449,45253,"2016-11-01",2016
"16-Nov",부산,동래구,167,86163,4415,90745,"2016-11-01",2016
"16-Nov",부산,부산진구,366,122428,5625,128419,"2016-11-01",2016
"16-Nov",부산,북구,223,100668,3383,104274,"2016-11-01",2016
"16-Nov",부산,사상구,259,84572,6373,91204,"2016-11-01",2016
"16-Nov",부산,사하구,238,106697,7098,114033,"2016-11-01",2016
"16-Nov",부산,서구,128,27562,1345,29035,"2016-11-01",2016
"16-Nov",부산,수영구,150,64981,3091,68222,"2016-11-01",2016
"16-Nov",부산,연제구,810,83258,5867,89935,"2016-11-01",2016
"16-Nov",부산,영도구,216,31608,2608,34432,"2016-11-01",2016
"16-Nov",부산,중구,303,16407,6307,23017,"2016-11-01",2016
"16-Nov",부산,해운대구,261,155683,5418,161362,"2016-11-01",2016
"16-Nov",대구,계,2853,1076553,48433,1127839,"2016-11-01",2016
"16-Nov",대구,남구,305,56484,2106,58895,"2016-11-01",2016
"16-Nov",대구,달서구,437,252734,11876,265047,"2016-11-01",2016
"16-Nov",대구,달성군,415,101468,3609,105492,"2016-11-01",2016
"16-Nov",대구,동구,299,143964,10704,154967,"2016-11-01",2016
"16-Nov",대구,북구,417,185037,8385,193839,"2016-11-01",2016
"16-Nov",대구,서구,206,75782,4577,80565,"2016-11-01",2016
"16-Nov",대구,수성구,504,203983,5392,209879,"2016-11-01",2016
"16-Nov",대구,중구,270,57101,1784,59155,"2016-11-01",2016
"16-Nov",인천,계,3430,1164055,264205,1431690,"2016-11-01",2016
"16-Nov",인천,강화군,287,30207,2750,33244,"2016-11-01",2016
"16-Nov",인천,계양구,248,120333,131207,251788,"2016-11-01",2016
"16-Nov",인천,남구,370,139692,52684,192746,"2016-11-01",2016
"16-Nov",인천,남동구,770,229917,33099,263786,"2016-11-01",2016
"16-Nov",인천,동구,85,25751,2606,28442,"2016-11-01",2016
"16-Nov",인천,부평구,318,206182,7173,213673,"2016-11-01",2016
"16-Nov",인천,서구,347,204262,10727,215336,"2016-11-01",2016
"16-Nov",인천,연수구,295,145905,7268,153468,"2016-11-01",2016
"16-Nov",인천,옹진군,163,10832,155,11150,"2016-11-01",2016
"16-Nov",인천,중구,547,50974,16536,68057,"2016-11-01",2016
"16-Nov",광주,계,1986,597051,33546,632583,"2016-11-01",2016
"16-Nov",광주,광산구,481,169926,9872,180279,"2016-11-01",2016
"16-Nov",광주,남구,176,82132,3252,85560,"2016-11-01",2016
"16-Nov",광주,동구,218,34789,1195,36202,"2016-11-01",2016
"16-Nov",광주,북구,446,173247,9499,183192,"2016-11-01",2016
"16-Nov",광주,서구,665,136957,9728,147350,"2016-11-01",2016
"16-Nov",대전,계,1769,616866,28053,646688,"2016-11-01",2016
"16-Nov",대전,대덕구,265,85154,6633,92052,"2016-11-01",2016
"16-Nov",대전,동구,166,86226,4214,90606,"2016-11-01",2016
"16-Nov",대전,서구,752,195213,7078,203043,"2016-11-01",2016
"16-Nov",대전,유성구,369,155050,4366,159785,"2016-11-01",2016
"16-Nov",대전,중구,217,95223,5762,101202,"2016-11-01",2016
"16-Nov",울산,계,1545,514562,21565,537672,"2016-11-01",2016
"16-Nov",울산,남구,626,150078,7432,158136,"2016-11-01",2016
"16-Nov",울산,동구,187,62794,937,63918,"2016-11-01",2016
"16-Nov",울산,북구,113,91111,4566,95790,"2016-11-01",2016
"16-Nov",울산,울주군,307,108887,5901,115095,"2016-11-01",2016
"16-Nov",울산,중구,312,101692,2729,104733,"2016-11-01",2016
"16-Nov",세종,계,649,106293,2332,109274,"2016-11-01",2016
"16-Nov",세종,세종특별자치시,649,106293,2332,109274,"2016-11-01",2016
"16-Nov",경기,계,14858,4903002,218376,5136236,"2016-11-01",2016
"16-Nov",경기,가평군,334,27374,718,28426,"2016-11-01",2016
"16-Nov",경기,고양시 덕양구,584,151133,3710,155427,"2016-11-01",2016
"16-Nov",경기,고양시 일산동구,278,111832,6566,118676,"2016-11-01",2016
"16-Nov",경기,고양시 일산서구,74,105155,3256,108485,"2016-11-01",2016
"16-Nov",경기,과천시,685,21404,563,22652,"2016-11-01",2016
"16-Nov",경기,광명시,277,102159,4269,106705,"2016-11-01",2016
"16-Nov",경기,광주시,341,152944,7987,161272,"2016-11-01",2016
"16-Nov",경기,구리시,206,62409,2397,65012,"2016-11-01",2016
"16-Nov",경기,군포시,245,93354,4849,98448,"2016-11-01",2016
"16-Nov",경기,김포시,403,155645,6164,162212,"2016-11-01",2016
"16-Nov",경기,남양주시,564,248360,6912,255836,"2016-11-01",2016
"16-Nov",경기,동두천시,194,35580,1269,37043,"2016-11-01",2016
"16-Nov",경기,부천시,649,281310,11431,293390,"2016-11-01",2016
"16-Nov",경기,성남시 분당구,319,181282,6183,187784,"2016-11-01",2016
"16-Nov",경기,성남시 수정구,295,65151,2350,67796,"2016-11-01",2016
"16-Nov",경기,성남시 중원구,254,72612,3876,76742,"2016-11-01",2016
"16-Nov",경기,수원시 권선구,304,153826,7156,161286,"2016-11-01",2016
"16-Nov",경기,수원시 영통구,202,124760,2666,127628,"2016-11-01",2016
"16-Nov",경기,수원시 장안구,556,103361,3959,107876,"2016-11-01",2016
"16-Nov",경기,수원시 팔달구,450,71114,3609,75173,"2016-11-01",2016
"16-Nov",경기,시흥시,412,179965,7383,187760,"2016-11-01",2016
"16-Nov",경기,안산시 단원구,497,141561,8395,150453,"2016-11-01",2016
"16-Nov",경기,안산시 상록구,164,135727,4615,140506,"2016-11-01",2016
"16-Nov",경기,안성시,319,88859,5010,94188,"2016-11-01",2016
"16-Nov",경기,안양시 동안구,367,118161,6583,125111,"2016-11-01",2016
"16-Nov",경기,안양시 만안구,150,79288,3772,83210,"2016-11-01",2016
"16-Nov",경기,양주시,313,85283,2866,88462,"2016-11-01",2016
"16-Nov",경기,양평군,433,51076,1648,53157,"2016-11-01",2016
"16-Nov",경기,여주시,364,56393,7050,63807,"2016-11-01",2016
"16-Nov",경기,연천군,255,21602,5651,27508,"2016-11-01",2016
"16-Nov",경기,오산시,209,84605,3111,87925,"2016-11-01",2016
"16-Nov",경기,용인시 기흥구,94,162085,8331,170510,"2016-11-01",2016
"16-Nov",경기,용인시 수지구,50,125658,2030,127738,"2016-11-01",2016
"16-Nov",경기,용인시 처인구,579,103313,6473,110365,"2016-11-01",2016
"16-Nov",경기,의왕시,264,56178,2801,59243,"2016-11-01",2016
"16-Nov",경기,의정부시,522,138321,4863,143706,"2016-11-01",2016
"16-Nov",경기,이천시,351,96972,5752,103075,"2016-11-01",2016
"16-Nov",경기,파주시,377,177663,10125,188165,"2016-11-01",2016
"16-Nov",경기,평택시,595,216762,10356,227713,"2016-11-01",2016
"16-Nov",경기,포천시,336,78129,9057,87522,"2016-11-01",2016
"16-Nov",경기,하남시,308,80405,2031,82744,"2016-11-01",2016
"16-Nov",경기,화성시,685,304231,10583,315499,"2016-11-01",2016
"16-Nov",강원,계,5078,691373,24510,720961,"2016-11-01",2016
"16-Nov",강원,강릉시,473,96959,4205,101637,"2016-11-01",2016
"16-Nov",강원,고성군,142,12723,245,13110,"2016-11-01",2016
"16-Nov",강원,동해시,281,40831,1370,42482,"2016-11-01",2016
"16-Nov",강원,삼척시,322,29180,713,30215,"2016-11-01",2016
"16-Nov",강원,속초시,275,33641,1238,35154,"2016-11-01",2016
"16-Nov",강원,양구군,126,10861,127,11114,"2016-11-01",2016
"16-Nov",강원,양양군,152,13281,240,13673,"2016-11-01",2016
"16-Nov",강원,영월군,300,19020,402,19722,"2016-11-01",2016
"16-Nov",강원,원주시,501,147802,5878,154181,"2016-11-01",2016
"16-Nov",강원,인제군,183,16291,208,16682,"2016-11-01",2016
"16-Nov",강원,정선군,286,18934,477,19697,"2016-11-01",2016
"16-Nov",강원,철원군,179,22143,309,22631,"2016-11-01",2016
"16-Nov",강원,춘천시,680,117247,5815,123742,"2016-11-01",2016
"16-Nov",강원,태백시,201,19933,834,20968,"2016-11-01",2016
"16-Nov",강원,평창군,258,23765,421,24444,"2016-11-01",2016
"16-Nov",강원,홍천군,333,34447,1112,35892,"2016-11-01",2016
"16-Nov",강원,화천군,172,11532,129,11833,"2016-11-01",2016
"16-Nov",강원,횡성군,214,22783,787,23784,"2016-11-01",2016
"16-Nov",충북,계,3416,723045,32595,759056,"2016-11-01",2016
"16-Nov",충북,괴산군,164,20021,376,20561,"2016-11-01",2016
"16-Nov",충북,단양군,151,14515,843,15509,"2016-11-01",2016
"16-Nov",충북,보은군,189,16294,935,17418,"2016-11-01",2016
"16-Nov",충북,영동군,203,23419,386,24008,"2016-11-01",2016
"16-Nov",충북,옥천군,183,24204,1024,25411,"2016-11-01",2016
"16-Nov",충북,음성군,191,53038,1685,54914,"2016-11-01",2016
"16-Nov",충북,제천시,300,61153,3319,64772,"2016-11-01",2016
"16-Nov",충북,증평군,76,17004,743,17823,"2016-11-01",2016
"16-Nov",충북,진천군,179,36837,1114,38130,"2016-11-01",2016
"16-Nov",충북,청원군,1,35,1,37,"2016-11-01",2016
"16-Nov",충북,청주시 상당구,397,72962,2577,75936,"2016-11-01",2016
"16-Nov",충북,청주시 서원구,216,89321,6126,95663,"2016-11-01",2016
"16-Nov",충북,청주시 청원구,312,89914,3732,93958,"2016-11-01",2016
"16-Nov",충북,청주시 흥덕구,344,108680,6035,115059,"2016-11-01",2016
"16-Nov",충북,충주시,510,95648,3699,99857,"2016-11-01",2016
"16-Nov",충남,계,4798,968326,39159,1012283,"2016-11-01",2016
"16-Nov",충남,계룡시,135,19261,503,19899,"2016-11-01",2016
"16-Nov",충남,공주시,493,49859,2131,52483,"2016-11-01",2016
"16-Nov",충남,금산군,160,26388,2411,28959,"2016-11-01",2016
"16-Nov",충남,논산시,321,56391,2159,58871,"2016-11-01",2016
"16-Nov",충남,당진시,340,83596,3618,87554,"2016-11-01",2016
"16-Nov",충남,보령시,329,47772,1303,49404,"2016-11-01",2016
"16-Nov",충남,부여군,236,31884,1451,33571,"2016-11-01",2016
"16-Nov",충남,서산시,366,80846,3458,84670,"2016-11-01",2016
"16-Nov",충남,서천군,200,25653,965,26818,"2016-11-01",2016
"16-Nov",충남,아산시,379,140873,6168,147420,"2016-11-01",2016
"16-Nov",충남,예산군,318,39419,1380,41117,"2016-11-01",2016
"16-Nov",충남,천안시 동남구,238,116483,4994,121715,"2016-11-01",2016
"16-Nov",충남,천안시 서북구,491,157454,5849,163794,"2016-11-01",2016
"16-Nov",충남,청양군,208,15239,942,16389,"2016-11-01",2016
"16-Nov",충남,태안군,217,30606,504,31327,"2016-11-01",2016
"16-Nov",충남,홍성군,367,46602,1323,48292,"2016-11-01",2016
"16-Nov",전북,계,4361,825156,37892,867409,"2016-11-01",2016
"16-Nov",전북,고창군,222,28257,545,29024,"2016-11-01",2016
"16-Nov",전북,군산시,435,120886,6940,128261,"2016-11-01",2016
"16-Nov",전북,김제시,255,41720,1802,43777,"2016-11-01",2016
"16-Nov",전북,남원시,371,37086,3345,40802,"2016-11-01",2016
"16-Nov",전북,무주군,161,11623,367,12151,"2016-11-01",2016
"16-Nov",전북,부안군,237,25859,601,26697,"2016-11-01",2016
"16-Nov",전북,순창군,178,13194,228,13600,"2016-11-01",2016
"16-Nov",전북,완주군,284,47372,3487,51143,"2016-11-01",2016
"16-Nov",전북,익산시,430,129529,6118,136077,"2016-11-01",2016
"16-Nov",전북,임실군,170,13061,401,13632,"2016-11-01",2016
"16-Nov",전북,장수군,186,11043,171,11400,"2016-11-01",2016
"16-Nov",전북,전주시 덕진구,365,138409,7504,146278,"2016-11-01",2016
"16-Nov",전북,전주시 완산구,576,144905,3993,149474,"2016-11-01",2016
"16-Nov",전북,정읍시,287,49645,2208,52140,"2016-11-01",2016
"16-Nov",전북,진안군,204,12567,182,12953,"2016-11-01",2016
"16-Nov",전남,계,5312,839553,102887,947752,"2016-11-01",2016
"16-Nov",전남,강진군,187,17055,970,18212,"2016-11-01",2016
"16-Nov",전남,고흥군,229,28211,678,29118,"2016-11-01",2016
"16-Nov",전남,곡성군,138,13599,976,14713,"2016-11-01",2016
"16-Nov",전남,광양시,220,72689,5853,78762,"2016-11-01",2016
"16-Nov",전남,구례군,102,12073,652,12827,"2016-11-01",2016
"16-Nov",전남,나주시,369,50731,3157,54257,"2016-11-01",2016
"16-Nov",전남,담양군,182,23862,1546,25590,"2016-11-01",2016
"16-Nov",전남,목포시,431,90083,6070,96584,"2016-11-01",2016
"16-Nov",전남,무안군,452,38040,1064,39556,"2016-11-01",2016
"16-Nov",전남,보성군,214,19879,45256,65349,"2016-11-01",2016
"16-Nov",전남,순천시,453,121120,4824,126397,"2016-11-01",2016
"16-Nov",전남,신안군,186,18680,643,19509,"2016-11-01",2016
"16-Nov",전남,여수시,478,117779,6563,124820,"2016-11-01",2016
"16-Nov",전남,영광군,202,25060,705,25967,"2016-11-01",2016
"16-Nov",전남,영암군,216,30549,18379,49144,"2016-11-01",2016
"16-Nov",전남,완도군,199,22524,485,23208,"2016-11-01",2016
"16-Nov",전남,장성군,131,23128,1253,24512,"2016-11-01",2016
"16-Nov",전남,장흥군,170,18287,445,18902,"2016-11-01",2016
"16-Nov",전남,진도군,130,14969,292,15391,"2016-11-01",2016
"16-Nov",전남,함평군,146,16162,339,16647,"2016-11-01",2016
"16-Nov",전남,해남군,282,35702,585,36569,"2016-11-01",2016
"16-Nov",전남,화순군,195,29371,2152,31718,"2016-11-01",2016
"16-Nov",경북,계,6361,1296076,49119,1351556,"2016-11-01",2016
"16-Nov",경북,경산시,390,123739,4237,128366,"2016-11-01",2016
"16-Nov",경북,경주시,497,128962,5156,134615,"2016-11-01",2016
"16-Nov",경북,고령군,138,19821,423,20382,"2016-11-01",2016
"16-Nov",경북,구미시,439,191892,7580,199911,"2016-11-01",2016
"16-Nov",경북,군위군,107,13315,249,13671,"2016-11-01",2016
"16-Nov",경북,김천시,325,66404,1746,68475,"2016-11-01",2016
"16-Nov",경북,문경시,255,33293,781,34329,"2016-11-01",2016
"16-Nov",경북,봉화군,182,16184,207,16573,"2016-11-01",2016
"16-Nov",경북,상주시,338,48571,1826,50735,"2016-11-01",2016
"16-Nov",경북,성주군,168,27778,1505,29451,"2016-11-01",2016
"16-Nov",경북,안동시,522,76918,2554,79994,"2016-11-01",2016
"16-Nov",경북,영덕군,214,17606,311,18131,"2016-11-01",2016
"16-Nov",경북,영양군,125,8610,97,8832,"2016-11-01",2016
"16-Nov",경북,영주시,311,52341,1637,54289,"2016-11-01",2016
"16-Nov",경북,영천시,236,52992,2682,55910,"2016-11-01",2016
"16-Nov",경북,예천군,172,21873,429,22474,"2016-11-01",2016
"16-Nov",경북,울릉군,128,4640,400,5168,"2016-11-01",2016
"16-Nov",경북,울진군,244,24012,372,24628,"2016-11-01",2016
"16-Nov",경북,의성군,271,27503,986,28760,"2016-11-01",2016
"16-Nov",경북,청도군,138,22672,631,23441,"2016-11-01",2016
"16-Nov",경북,청송군,187,13856,208,14251,"2016-11-01",2016
"16-Nov",경북,칠곡군,303,65062,2189,67554,"2016-11-01",2016
"16-Nov",경북,포항시 남구,349,114924,8998,124271,"2016-11-01",2016
"16-Nov",경북,포항시 북구,322,123108,3915,127345,"2016-11-01",2016
"16-Nov",경남,계,6300,1532169,83043,1621512,"2016-11-01",2016
"16-Nov",경남,거제시,309,102300,2714,105323,"2016-11-01",2016
"16-Nov",경남,거창군,226,28878,785,29889,"2016-11-01",2016
"16-Nov",경남,고성군,201,24998,709,25908,"2016-11-01",2016
"16-Nov",경남,김해시,585,241991,6576,249152,"2016-11-01",2016
"16-Nov",경남,남해군,210,17739,516,18465,"2016-11-01",2016
"16-Nov",경남,밀양시,287,51526,4311,56124,"2016-11-01",2016
"16-Nov",경남,사천시,280,51073,1554,52907,"2016-11-01",2016
"16-Nov",경남,산청군,181,17840,777,18798,"2016-11-01",2016
"16-Nov",경남,양산시,348,134094,8903,143345,"2016-11-01",2016
"16-Nov",경남,의령군,168,12791,787,13746,"2016-11-01",2016
"16-Nov",경남,진주시,543,148370,6844,155757,"2016-11-01",2016
"16-Nov",경남,창녕군,204,32485,779,33468,"2016-11-01",2016
"16-Nov",경남,창원시 마산합포구,313,95019,3103,98435,"2016-11-01",2016
"16-Nov",경남,창원시 마산회원구,169,97848,5464,103481,"2016-11-01",2016
"16-Nov",경남,창원시 성산구,138,121427,18550,140115,"2016-11-01",2016
"16-Nov",경남,창원시 의창구,843,121468,5772,128083,"2016-11-01",2016
"16-Nov",경남,창원시 진해구,191,78824,1556,80571,"2016-11-01",2016
"16-Nov",경남,통영시,299,50785,1501,52585,"2016-11-01",2016
"16-Nov",경남,하동군,200,22851,443,23494,"2016-11-01",2016
"16-Nov",경남,함안군,177,40638,9956,50771,"2016-11-01",2016
"16-Nov",경남,함양군,195,18002,436,18633,"2016-11-01",2016
"16-Nov",경남,합천군,233,21222,1007,22462,"2016-11-01",2016
"16-Nov",제주,계,1943,353167,109497,464607,"2016-11-01",2016
"16-Nov",제주,서귀포시,636,90034,2397,93067,"2016-11-01",2016
"16-Nov",제주,제주시,1307,263133,107100,371540,"2016-11-01",2016
"16-Dec",서울,계,11276,2875305,196426,3083007,"2016-12-01",2016
"16-Dec",서울,강남구,351,222368,19629,242348,"2016-12-01",2016
"16-Dec",서울,강동구,222,127621,8367,136210,"2016-12-01",2016
"16-Dec",서울,강북구,271,71707,4866,76844,"2016-12-01",2016
"16-Dec",서울,강서구,286,180689,15189,196164,"2016-12-01",2016
"16-Dec",서울,관악구,265,116013,5761,122039,"2016-12-01",2016
"16-Dec",서울,광진구,275,91068,5702,97045,"2016-12-01",2016
"16-Dec",서울,구로구,225,129033,11435,140693,"2016-12-01",2016
"16-Dec",서울,금천구,120,77340,7224,84684,"2016-12-01",2016
"16-Dec",서울,노원구,252,145897,9548,155697,"2016-12-01",2016
"16-Dec",서울,도봉구,229,89131,7699,97059,"2016-12-01",2016
"16-Dec",서울,동대문구,275,91319,5739,97333,"2016-12-01",2016
"16-Dec",서울,동작구,269,101123,2784,104176,"2016-12-01",2016
"16-Dec",서울,마포구,290,109220,7561,117071,"2016-12-01",2016
"16-Dec",서울,서대문구,424,78683,5251,84358,"2016-12-01",2016
"16-Dec",서울,서초구,588,169108,10253,179949,"2016-12-01",2016
"16-Dec",서울,성동구,266,90126,9137,99529,"2016-12-01",2016
"16-Dec",서울,성북구,224,110714,5508,116446,"2016-12-01",2016
"16-Dec",서울,송파구,330,210294,11890,222514,"2016-12-01",2016
"16-Dec",서울,양천구,300,140871,9037,150208,"2016-12-01",2016
"16-Dec",서울,영등포구,306,136124,9750,146180,"2016-12-01",2016
"16-Dec",서울,용산구,352,73248,2040,75640,"2016-12-01",2016
"16-Dec",서울,은평구,225,120562,6860,127647,"2016-12-01",2016
"16-Dec",서울,종로구,3754,44062,1655,49471,"2016-12-01",2016
"16-Dec",서울,중구,988,46806,3810,51604,"2016-12-01",2016
"16-Dec",서울,중랑구,189,102178,9731,112098,"2016-12-01",2016
"16-Dec",부산,계,4313,1211619,79384,1295316,"2016-12-01",2016
"16-Dec",부산,강서구,296,59415,4026,63737,"2016-12-01",2016
"16-Dec",부산,금정구,271,79173,7437,86881,"2016-12-01",2016
"16-Dec",부산,기장군,224,65583,2120,67927,"2016-12-01",2016
"16-Dec",부산,남구,204,86897,9000,96101,"2016-12-01",2016
"16-Dec",부산,동구,220,39774,5382,45376,"2016-12-01",2016
"16-Dec",부산,동래구,164,86311,4405,90880,"2016-12-01",2016
"16-Dec",부산,부산진구,368,122227,5688,128283,"2016-12-01",2016
"16-Dec",부산,북구,212,100521,3299,104032,"2016-12-01",2016
"16-Dec",부산,사상구,257,84871,6342,91470,"2016-12-01",2016
"16-Dec",부산,사하구,235,106829,7102,114166,"2016-12-01",2016
"16-Dec",부산,서구,128,27414,1333,28875,"2016-12-01",2016
"16-Dec",부산,수영구,149,64805,3098,68052,"2016-12-01",2016
"16-Dec",부산,연제구,802,83739,5813,90354,"2016-12-01",2016
"16-Dec",부산,영도구,214,31539,2612,34365,"2016-12-01",2016
"16-Dec",부산,중구,306,16637,6307,23250,"2016-12-01",2016
"16-Dec",부산,해운대구,263,155884,5420,161567,"2016-12-01",2016
"16-Dec",대구,계,2885,1078747,49179,1130811,"2016-12-01",2016
"16-Dec",대구,남구,311,56309,2087,58707,"2016-12-01",2016
"16-Dec",대구,달서구,437,252876,12605,265918,"2016-12-01",2016
"16-Dec",대구,달성군,429,102733,3623,106785,"2016-12-01",2016
"16-Dec",대구,동구,300,144864,10686,155850,"2016-12-01",2016
"16-Dec",대구,북구,420,185094,8388,193902,"2016-12-01",2016
"16-Dec",대구,서구,211,76141,4582,80934,"2016-12-01",2016
"16-Dec",대구,수성구,507,204038,5406,209951,"2016-12-01",2016
"16-Dec",대구,중구,270,56692,1802,58764,"2016-12-01",2016
"16-Dec",인천,계,3426,1169329,264618,1437373,"2016-12-01",2016
"16-Dec",인천,강화군,287,30306,2744,33337,"2016-12-01",2016
"16-Dec",인천,계양구,245,120440,131436,252121,"2016-12-01",2016
"16-Dec",인천,남구,366,140515,52010,192891,"2016-12-01",2016
"16-Dec",인천,남동구,774,230586,33963,265323,"2016-12-01",2016
"16-Dec",인천,동구,84,25878,2599,28561,"2016-12-01",2016
"16-Dec",인천,부평구,314,206725,7195,214234,"2016-12-01",2016
"16-Dec",인천,서구,345,205931,10528,216804,"2016-12-01",2016
"16-Dec",인천,연수구,293,146991,7334,154618,"2016-12-01",2016
"16-Dec",인천,옹진군,165,10872,152,11189,"2016-12-01",2016
"16-Dec",인천,중구,553,51085,16657,68295,"2016-12-01",2016
"16-Dec",광주,계,1991,597843,33541,633375,"2016-12-01",2016
"16-Dec",광주,광산구,475,170391,9932,180798,"2016-12-01",2016
"16-Dec",광주,남구,173,82249,3227,85649,"2016-12-01",2016
"16-Dec",광주,동구,220,34657,1188,36065,"2016-12-01",2016
"16-Dec",광주,북구,458,173148,9435,183041,"2016-12-01",2016
"16-Dec",광주,서구,665,137398,9759,147822,"2016-12-01",2016
"16-Dec",대전,계,1765,618263,28056,648084,"2016-12-01",2016
"16-Dec",대전,대덕구,208,85262,6647,92117,"2016-12-01",2016
"16-Dec",대전,동구,221,86367,4157,90745,"2016-12-01",2016
"16-Dec",대전,서구,753,195620,7142,203515,"2016-12-01",2016
"16-Dec",대전,유성구,363,155925,4379,160667,"2016-12-01",2016
"16-Dec",대전,중구,220,95089,5731,101040,"2016-12-01",2016
"16-Dec",울산,계,1542,515680,21498,538720,"2016-12-01",2016
"16-Dec",울산,남구,624,150234,7412,158270,"2016-12-01",2016
"16-Dec",울산,동구,189,62895,943,64027,"2016-12-01",2016
"16-Dec",울산,북구,113,91643,4529,96285,"2016-12-01",2016
"16-Dec",울산,울주군,305,109232,5890,115427,"2016-12-01",2016
"16-Dec",울산,중구,311,101676,2724,104711,"2016-12-01",2016
"16-Dec",세종,계,654,107462,2303,110419,"2016-12-01",2016
"16-Dec",세종,세종특별자치시,654,107462,2303,110419,"2016-12-01",2016
"16-Dec",경기,계,14911,4924496,221514,5160921,"2016-12-01",2016
"16-Dec",경기,가평군,326,27404,718,28448,"2016-12-01",2016
"16-Dec",경기,고양시 덕양구,595,151611,3703,155909,"2016-12-01",2016
"16-Dec",경기,고양시 일산동구,252,112365,7103,119720,"2016-12-01",2016
"16-Dec",경기,고양시 일산서구,108,105546,3243,108897,"2016-12-01",2016
"16-Dec",경기,과천시,677,21116,558,22351,"2016-12-01",2016
"16-Dec",경기,광명시,277,102179,4280,106736,"2016-12-01",2016
"16-Dec",경기,광주시,343,154063,7962,162368,"2016-12-01",2016
"16-Dec",경기,구리시,204,63079,2404,65687,"2016-12-01",2016
"16-Dec",경기,군포시,244,93478,4854,98576,"2016-12-01",2016
"16-Dec",경기,김포시,400,156501,6188,163089,"2016-12-01",2016
"16-Dec",경기,남양주시,566,248826,6894,256286,"2016-12-01",2016
"16-Dec",경기,동두천시,194,35535,1273,37002,"2016-12-01",2016
"16-Dec",경기,부천시,659,282497,11810,294966,"2016-12-01",2016
"16-Dec",경기,성남시 분당구,318,181670,6353,188341,"2016-12-01",2016
"16-Dec",경기,성남시 수정구,300,65513,2359,68172,"2016-12-01",2016
"16-Dec",경기,성남시 중원구,253,72166,3866,76285,"2016-12-01",2016
"16-Dec",경기,수원시 권선구,305,156914,7134,164353,"2016-12-01",2016
"16-Dec",경기,수원시 영통구,202,125117,2668,127987,"2016-12-01",2016
"16-Dec",경기,수원시 장안구,565,103752,4019,108336,"2016-12-01",2016
"16-Dec",경기,수원시 팔달구,450,71136,3585,75171,"2016-12-01",2016
"16-Dec",경기,시흥시,414,180993,7381,188788,"2016-12-01",2016
"16-Dec",경기,안산시 단원구,509,142140,8334,150983,"2016-12-01",2016
"16-Dec",경기,안산시 상록구,163,135759,4619,140541,"2016-12-01",2016
"16-Dec",경기,안성시,324,89335,5007,94666,"2016-12-01",2016
"16-Dec",경기,안양시 동안구,367,117690,6602,124659,"2016-12-01",2016
"16-Dec",경기,안양시 만안구,150,80532,3810,84492,"2016-12-01",2016
"16-Dec",경기,양주시,313,85566,2884,88763,"2016-12-01",2016
"16-Dec",경기,양평군,440,51305,1648,53393,"2016-12-01",2016
"16-Dec",경기,여주시,354,56496,7038,63888,"2016-12-01",2016
"16-Dec",경기,연천군,256,21665,5667,27588,"2016-12-01",2016
"16-Dec",경기,오산시,210,84915,3107,88232,"2016-12-01",2016
"16-Dec",경기,용인시 기흥구,95,162789,8238,171122,"2016-12-01",2016
"16-Dec",경기,용인시 수지구,49,125864,2012,127925,"2016-12-01",2016
"16-Dec",경기,용인시 처인구,585,104019,6651,111255,"2016-12-01",2016
"16-Dec",경기,의왕시,266,56000,2817,59083,"2016-12-01",2016
"16-Dec",경기,의정부시,519,138740,4859,144118,"2016-12-01",2016
"16-Dec",경기,이천시,350,97272,5799,103421,"2016-12-01",2016
"16-Dec",경기,파주시,381,178274,10343,188998,"2016-12-01",2016
"16-Dec",경기,평택시,600,217792,10370,228762,"2016-12-01",2016
"16-Dec",경기,포천시,335,78205,10637,89177,"2016-12-01",2016
"16-Dec",경기,하남시,305,81619,2033,83957,"2016-12-01",2016
"16-Dec",경기,화성시,688,307058,10684,318430,"2016-12-01",2016
"16-Dec",강원,계,5099,692757,24477,722333,"2016-12-01",2016
"16-Dec",강원,강릉시,471,97030,4197,101698,"2016-12-01",2016
"16-Dec",강원,고성군,168,13164,243,13575,"2016-12-01",2016
"16-Dec",강원,동해시,282,40892,1366,42540,"2016-12-01",2016
"16-Dec",강원,삼척시,326,29134,710,30170,"2016-12-01",2016
"16-Dec",강원,속초시,273,33399,1245,34917,"2016-12-01",2016
"16-Dec",강원,양구군,126,10911,130,11167,"2016-12-01",2016
"16-Dec",강원,양양군,153,13313,228,13694,"2016-12-01",2016
"16-Dec",강원,영월군,301,19071,402,19774,"2016-12-01",2016
"16-Dec",강원,원주시,501,148216,5888,154605,"2016-12-01",2016
"16-Dec",강원,인제군,180,16289,208,16677,"2016-12-01",2016
"16-Dec",강원,정선군,281,18960,477,19718,"2016-12-01",2016
"16-Dec",강원,철원군,179,22133,308,22620,"2016-12-01",2016
"16-Dec",강원,춘천시,685,117609,5794,124088,"2016-12-01",2016
"16-Dec",강원,태백시,196,19953,832,20981,"2016-12-01",2016
"16-Dec",강원,평창군,258,23774,418,24450,"2016-12-01",2016
"16-Dec",강원,홍천군,334,34568,1114,36016,"2016-12-01",2016
"16-Dec",강원,화천군,174,11520,129,11823,"2016-12-01",2016
"16-Dec",강원,횡성군,211,22821,788,23820,"2016-12-01",2016
"16-Dec",충북,계,3426,724677,32598,760701,"2016-12-01",2016
"16-Dec",충북,괴산군,168,20286,369,20823,"2016-12-01",2016
"16-Dec",충북,단양군,151,14534,844,15529,"2016-12-01",2016
"16-Dec",충북,보은군,186,16324,946,17456,"2016-12-01",2016
"16-Dec",충북,영동군,204,23485,387,24076,"2016-12-01",2016
"16-Dec",충북,옥천군,183,24217,1024,25424,"2016-12-01",2016
"16-Dec",충북,음성군,199,53131,1686,55016,"2016-12-01",2016
"16-Dec",충북,제천시,302,61216,3316,64834,"2016-12-01",2016
"16-Dec",충북,증평군,76,17018,744,17838,"2016-12-01",2016
"16-Dec",충북,진천군,180,36941,1109,38230,"2016-12-01",2016
"16-Dec",충북,청원군,1,35,1,37,"2016-12-01",2016
"16-Dec",충북,청주시 상당구,400,72965,2585,75950,"2016-12-01",2016
"16-Dec",충북,청주시 서원구,218,89247,6129,95594,"2016-12-01",2016
"16-Dec",충북,청주시 청원구,314,90586,3737,94637,"2016-12-01",2016
"16-Dec",충북,청주시 흥덕구,346,108854,6009,115209,"2016-12-01",2016
"16-Dec",충북,충주시,498,95838,3712,100048,"2016-12-01",2016
"16-Dec",충남,계,4825,971200,39119,1015144,"2016-12-01",2016
"16-Dec",충남,계룡시,134,19269,495,19898,"2016-12-01",2016
"16-Dec",충남,공주시,492,49886,2126,52504,"2016-12-01",2016
"16-Dec",충남,금산군,164,26452,2367,28983,"2016-12-01",2016
"16-Dec",충남,논산시,323,56408,2161,58892,"2016-12-01",2016
"16-Dec",충남,당진시,343,83816,3669,87828,"2016-12-01",2016
"16-Dec",충남,보령시,332,47838,1295,49465,"2016-12-01",2016
"16-Dec",충남,부여군,244,31886,1447,33577,"2016-12-01",2016
"16-Dec",충남,서산시,371,81063,3452,84886,"2016-12-01",2016
"16-Dec",충남,서천군,200,25658,962,26820,"2016-12-01",2016
"16-Dec",충남,아산시,376,141247,6175,147798,"2016-12-01",2016
"16-Dec",충남,예산군,317,39423,1383,41123,"2016-12-01",2016
"16-Dec",충남,천안시 동남구,246,116653,4837,121736,"2016-12-01",2016
"16-Dec",충남,천안시 서북구,493,158581,5976,165050,"2016-12-01",2016
"16-Dec",충남,청양군,208,15458,937,16603,"2016-12-01",2016
"16-Dec",충남,태안군,216,30733,502,31451,"2016-12-01",2016
"16-Dec",충남,홍성군,366,46829,1335,48530,"2016-12-01",2016
"16-Dec",전북,계,4302,826821,37879,869002,"2016-12-01",2016
"16-Dec",전북,고창군,221,28538,550,29309,"2016-12-01",2016
"16-Dec",전북,군산시,432,120855,6963,128250,"2016-12-01",2016
"16-Dec",전북,김제시,255,41824,1788,43867,"2016-12-01",2016
"16-Dec",전북,남원시,368,37060,3302,40730,"2016-12-01",2016
"16-Dec",전북,무주군,156,11606,369,12131,"2016-12-01",2016
"16-Dec",전북,부안군,234,25906,601,26741,"2016-12-01",2016
"16-Dec",전북,순창군,178,13450,226,13854,"2016-12-01",2016
"16-Dec",전북,완주군,284,47311,3477,51072,"2016-12-01",2016
"16-Dec",전북,익산시,429,129773,6102,136304,"2016-12-01",2016
"16-Dec",전북,임실군,169,13345,408,13922,"2016-12-01",2016
"16-Dec",전북,장수군,182,11101,171,11454,"2016-12-01",2016
"16-Dec",전북,전주시 덕진구,357,139467,7477,147301,"2016-12-01",2016
"16-Dec",전북,전주시 완산구,559,144426,4010,148995,"2016-12-01",2016
"16-Dec",전북,정읍시,280,49614,2253,52147,"2016-12-01",2016
"16-Dec",전북,진안군,198,12545,182,12925,"2016-12-01",2016
"16-Dec",전남,계,5323,841916,104765,952004,"2016-12-01",2016
"16-Dec",전남,강진군,190,17061,972,18223,"2016-12-01",2016
"16-Dec",전남,고흥군,229,28223,678,29130,"2016-12-01",2016
"16-Dec",전남,곡성군,137,13583,982,14702,"2016-12-01",2016
"16-Dec",전남,광양시,222,73743,5866,79831,"2016-12-01",2016
"16-Dec",전남,구례군,102,12153,653,12908,"2016-12-01",2016
"16-Dec",전남,나주시,365,51166,3167,54698,"2016-12-01",2016
"16-Dec",전남,담양군,183,23904,1549,25636,"2016-12-01",2016
"16-Dec",전남,목포시,429,90284,6084,96797,"2016-12-01",2016
"16-Dec",전남,무안군,456,38152,1058,39666,"2016-12-01",2016
"16-Dec",전남,보성군,214,19880,47543,67637,"2016-12-01",2016
"16-Dec",전남,순천시,451,121064,4856,126371,"2016-12-01",2016
"16-Dec",전남,신안군,185,18709,644,19538,"2016-12-01",2016
"16-Dec",전남,여수시,486,117835,6527,124848,"2016-12-01",2016
"16-Dec",전남,영광군,204,25098,702,26004,"2016-12-01",2016
"16-Dec",전남,영암군,216,30489,17971,48676,"2016-12-01",2016
"16-Dec",전남,완도군,196,22594,479,23269,"2016-12-01",2016
"16-Dec",전남,장성군,133,23211,1253,24597,"2016-12-01",2016
"16-Dec",전남,장흥군,169,18420,443,19032,"2016-12-01",2016
"16-Dec",전남,진도군,130,15006,296,15432,"2016-12-01",2016
"16-Dec",전남,함평군,146,16183,331,16660,"2016-12-01",2016
"16-Dec",전남,해남군,284,35730,584,36598,"2016-12-01",2016
"16-Dec",전남,화순군,196,29428,2127,31751,"2016-12-01",2016
"16-Dec",경북,계,6374,1298395,48885,1353654,"2016-12-01",2016
"16-Dec",경북,경산시,388,123734,4211,128333,"2016-12-01",2016
"16-Dec",경북,경주시,497,129200,5155,134852,"2016-12-01",2016
"16-Dec",경북,고령군,140,19828,436,20404,"2016-12-01",2016
"16-Dec",경북,구미시,439,192380,7524,200343,"2016-12-01",2016
"16-Dec",경북,군위군,106,13354,249,13709,"2016-12-01",2016
"16-Dec",경북,김천시,321,66487,1754,68562,"2016-12-01",2016
"16-Dec",경북,문경시,253,33387,779,34419,"2016-12-01",2016
"16-Dec",경북,봉화군,181,16199,207,16587,"2016-12-01",2016
"16-Dec",경북,상주시,342,48664,1819,50825,"2016-12-01",2016
"16-Dec",경북,성주군,168,27760,1465,29393,"2016-12-01",2016
"16-Dec",경북,안동시,526,77276,2546,80348,"2016-12-01",2016
"16-Dec",경북,영덕군,219,17618,313,18150,"2016-12-01",2016
"16-Dec",경북,영양군,125,8625,98,8848,"2016-12-01",2016
"16-Dec",경북,영주시,310,52413,1552,54275,"2016-12-01",2016
"16-Dec",경북,영천시,238,53126,2674,56038,"2016-12-01",2016
"16-Dec",경북,예천군,172,21891,433,22496,"2016-12-01",2016
"16-Dec",경북,울릉군,130,4625,397,5152,"2016-12-01",2016
"16-Dec",경북,울진군,244,24079,375,24698,"2016-12-01",2016
"16-Dec",경북,의성군,275,27549,988,28812,"2016-12-01",2016
"16-Dec",경북,청도군,138,22719,630,23487,"2016-12-01",2016
"16-Dec",경북,청송군,186,13957,205,14348,"2016-12-01",2016
"16-Dec",경북,칠곡군,303,65176,2161,67640,"2016-12-01",2016
"16-Dec",경북,포항시 남구,354,115033,9009,124396,"2016-12-01",2016
"16-Dec",경북,포항시 북구,319,123315,3905,127539,"2016-12-01",2016
"16-Dec",경남,계,6291,1536157,82796,1625244,"2016-12-01",2016
"16-Dec",경남,거제시,304,102277,2706,105287,"2016-12-01",2016
"16-Dec",경남,거창군,230,28895,783,29908,"2016-12-01",2016
"16-Dec",경남,고성군,200,24992,709,25901,"2016-12-01",2016
"16-Dec",경남,김해시,583,242669,6566,249818,"2016-12-01",2016
"16-Dec",경남,남해군,207,17772,514,18493,"2016-12-01",2016
"16-Dec",경남,밀양시,287,51617,4318,56222,"2016-12-01",2016
"16-Dec",경남,사천시,280,51201,1562,53043,"2016-12-01",2016
"16-Dec",경남,산청군,194,17888,774,18856,"2016-12-01",2016
"16-Dec",경남,양산시,345,135508,8821,144674,"2016-12-01",2016
"16-Dec",경남,의령군,168,12828,788,13784,"2016-12-01",2016
"16-Dec",경남,진주시,546,148599,6885,156030,"2016-12-01",2016
"16-Dec",경남,창녕군,202,32503,786,33491,"2016-12-01",2016
"16-Dec",경남,창원시 마산합포구,313,95321,3092,98726,"2016-12-01",2016
"16-Dec",경남,창원시 마산회원구,165,97816,5482,103463,"2016-12-01",2016
"16-Dec",경남,창원시 성산구,139,121743,18387,140269,"2016-12-01",2016
"16-Dec",경남,창원시 의창구,839,121672,5791,128302,"2016-12-01",2016
"16-Dec",경남,창원시 진해구,187,78943,1558,80688,"2016-12-01",2016
"16-Dec",경남,통영시,294,50765,1492,52551,"2016-12-01",2016
"16-Dec",경남,하동군,198,23057,444,23699,"2016-12-01",2016
"16-Dec",경남,함안군,178,40630,9862,50670,"2016-12-01",2016
"16-Dec",경남,함양군,194,18005,408,18607,"2016-12-01",2016
"16-Dec",경남,합천군,238,21456,1068,22762,"2016-12-01",2016
"16-Dec",제주,계,1973,354642,110628,467243,"2016-12-01",2016
"16-Dec",제주,서귀포시,639,90510,2388,93537,"2016-12-01",2016
"16-Dec",제주,제주시,1334,264132,108240,373706,"2016-12-01",2016
"17-Jan",서울,계,11255,2883800,196848,3091903,"2017-01-01",2017
"17-Jan",서울,강남구,350,222719,20125,243194,"2017-01-01",2017
"17-Jan",서울,강동구,222,128288,8405,136915,"2017-01-01",2017
"17-Jan",서울,강북구,270,71871,4842,76983,"2017-01-01",2017
"17-Jan",서울,강서구,287,181128,15193,196608,"2017-01-01",2017
"17-Jan",서울,관악구,266,116390,5769,122425,"2017-01-01",2017
"17-Jan",서울,광진구,275,91374,5641,97290,"2017-01-01",2017
"17-Jan",서울,구로구,247,129530,11330,141107,"2017-01-01",2017
"17-Jan",서울,금천구,93,77868,7143,85104,"2017-01-01",2017
"17-Jan",서울,노원구,252,146315,9567,156134,"2017-01-01",2017
"17-Jan",서울,도봉구,229,89283,7696,97208,"2017-01-01",2017
"17-Jan",서울,동대문구,273,91532,5740,97545,"2017-01-01",2017
"17-Jan",서울,동작구,271,101364,2781,104416,"2017-01-01",2017
"17-Jan",서울,마포구,291,109417,7583,117291,"2017-01-01",2017
"17-Jan",서울,서대문구,419,79032,5217,84668,"2017-01-01",2017
"17-Jan",서울,서초구,587,169501,10222,180310,"2017-01-01",2017
"17-Jan",서울,성동구,269,90624,9261,100154,"2017-01-01",2017
"17-Jan",서울,성북구,224,111104,5514,116842,"2017-01-01",2017
"17-Jan",서울,송파구,330,211448,11839,223617,"2017-01-01",2017
"17-Jan",서울,양천구,297,141373,8950,150620,"2017-01-01",2017
"17-Jan",서울,영등포구,307,136056,9830,146193,"2017-01-01",2017
"17-Jan",서울,용산구,345,73211,2153,75709,"2017-01-01",2017
"17-Jan",서울,은평구,225,120920,6855,128000,"2017-01-01",2017
"17-Jan",서울,종로구,3749,44127,1662,49538,"2017-01-01",2017
"17-Jan",서울,중구,989,46805,3796,51590,"2017-01-01",2017
"17-Jan",서울,중랑구,188,102520,9734,112442,"2017-01-01",2017
"17-Jan",부산,계,4304,1216302,79578,1300184,"2017-01-01",2017
"17-Jan",부산,강서구,296,60035,3980,64311,"2017-01-01",2017
"17-Jan",부산,금정구,271,79370,7433,87074,"2017-01-01",2017
"17-Jan",부산,기장군,225,65909,2110,68244,"2017-01-01",2017
"17-Jan",부산,남구,203,87033,9025,96261,"2017-01-01",2017
"17-Jan",부산,동구,220,40017,5400,45637,"2017-01-01",2017
"17-Jan",부산,동래구,165,86829,4402,91396,"2017-01-01",2017
"17-Jan",부산,부산진구,365,122589,6152,129106,"2017-01-01",2017
"17-Jan",부산,북구,210,100865,3274,104349,"2017-01-01",2017
"17-Jan",부산,사상구,256,84999,6319,91574,"2017-01-01",2017
"17-Jan",부산,사하구,233,107157,7090,114480,"2017-01-01",2017
"17-Jan",부산,서구,130,27462,1335,28927,"2017-01-01",2017
"17-Jan",부산,수영구,147,64831,3092,68070,"2017-01-01",2017
"17-Jan",부산,연제구,801,84188,5625,90614,"2017-01-01",2017
"17-Jan",부산,영도구,214,31575,2616,34405,"2017-01-01",2017
"17-Jan",부산,중구,308,16832,6315,23455,"2017-01-01",2017
"17-Jan",부산,해운대구,260,156611,5410,162281,"2017-01-01",2017
"17-Jan",대구,계,2836,1083195,48975,1135006,"2017-01-01",2017
"17-Jan",대구,남구,310,56313,2075,58698,"2017-01-01",2017
"17-Jan",대구,달서구,422,253592,12520,266534,"2017-01-01",2017
"17-Jan",대구,달성군,420,104033,3621,108074,"2017-01-01",2017
"17-Jan",대구,동구,295,145176,10654,156125,"2017-01-01",2017
"17-Jan",대구,북구,415,185906,8392,194713,"2017-01-01",2017
"17-Jan",대구,서구,208,75977,4570,80755,"2017-01-01",2017
"17-Jan",대구,수성구,498,205529,5363,211390,"2017-01-01",2017
"17-Jan",대구,중구,268,56669,1780,58717,"2017-01-01",2017
"17-Jan",인천,계,3400,1174584,267843,1445827,"2017-01-01",2017
"17-Jan",인천,강화군,285,30427,2748,33460,"2017-01-01",2017
"17-Jan",인천,계양구,243,121051,132859,254153,"2017-01-01",2017
"17-Jan",인천,남구,363,141188,53025,194576,"2017-01-01",2017
"17-Jan",인천,남동구,773,231261,34691,266725,"2017-01-01",2017
"17-Jan",인천,동구,83,25733,2588,28404,"2017-01-01",2017
"17-Jan",인천,부평구,318,207940,7175,215433,"2017-01-01",2017
"17-Jan",인천,서구,334,206635,10560,217529,"2017-01-01",2017
"17-Jan",인천,연수구,288,148103,7376,155767,"2017-01-01",2017
"17-Jan",인천,옹진군,165,10965,149,11279,"2017-01-01",2017
"17-Jan",인천,중구,548,51281,16672,68501,"2017-01-01",2017
"17-Jan",광주,계,1965,600617,33433,636015,"2017-01-01",2017
"17-Jan",광주,광산구,458,171505,10009,181972,"2017-01-01",2017
"17-Jan",광주,남구,183,82777,3193,86153,"2017-01-01",2017
"17-Jan",광주,동구,218,34756,1182,36156,"2017-01-01",2017
"17-Jan",광주,북구,451,173897,9372,183720,"2017-01-01",2017
"17-Jan",광주,서구,655,137682,9677,148014,"2017-01-01",2017
"17-Jan",대전,계,1760,620967,27868,650595,"2017-01-01",2017
"17-Jan",대전,대덕구,207,85413,6613,92233,"2017-01-01",2017
"17-Jan",대전,동구,223,86638,4179,91040,"2017-01-01",2017
"17-Jan",대전,서구,747,196390,7100,204237,"2017-01-01",2017
"17-Jan",대전,유성구,361,157065,4162,161588,"2017-01-01",2017
"17-Jan",대전,중구,222,95461,5814,101497,"2017-01-01",2017
"17-Jan",울산,계,1547,517991,21426,540964,"2017-01-01",2017
"17-Jan",울산,남구,627,150692,7356,158675,"2017-01-01",2017
"17-Jan",울산,동구,191,63067,933,64191,"2017-01-01",2017
"17-Jan",울산,북구,111,92324,4454,96889,"2017-01-01",2017
"17-Jan",울산,울주군,306,109744,5869,115919,"2017-01-01",2017
"17-Jan",울산,중구,312,102164,2814,105290,"2017-01-01",2017
"17-Jan",세종,계,655,108644,2276,111575,"2017-01-01",2017
"17-Jan",세종,세종특별자치시,655,108644,2276,111575,"2017-01-01",2017
"17-Jan",경기,계,14846,4951051,221314,5187211,"2017-01-01",2017
"17-Jan",경기,가평군,329,27481,707,28517,"2017-01-01",2017
"17-Jan",경기,고양시 덕양구,593,152545,3742,156880,"2017-01-01",2017
"17-Jan",경기,고양시 일산동구,248,112867,6957,120072,"2017-01-01",2017
"17-Jan",경기,고양시 일산서구,110,105897,3174,109181,"2017-01-01",2017
"17-Jan",경기,과천시,681,21005,548,22234,"2017-01-01",2017
"17-Jan",경기,광명시,275,102464,4298,107037,"2017-01-01",2017
"17-Jan",경기,광주시,343,155385,7953,163681,"2017-01-01",2017
"17-Jan",경기,구리시,204,63550,2407,66161,"2017-01-01",2017
"17-Jan",경기,군포시,242,93922,4853,99017,"2017-01-01",2017
"17-Jan",경기,김포시,393,157704,6225,164322,"2017-01-01",2017
"17-Jan",경기,남양주시,564,250063,6891,257518,"2017-01-01",2017
"17-Jan",경기,동두천시,193,35614,1279,37086,"2017-01-01",2017
"17-Jan",경기,부천시,653,283437,11870,295960,"2017-01-01",2017
"17-Jan",경기,성남시 분당구,317,182259,6351,188927,"2017-01-01",2017
"17-Jan",경기,성남시 수정구,297,66069,2371,68737,"2017-01-01",2017
"17-Jan",경기,성남시 중원구,250,72317,3782,76349,"2017-01-01",2017
"17-Jan",경기,수원시 권선구,307,156830,7165,164302,"2017-01-01",2017
"17-Jan",경기,수원시 영통구,200,125736,2716,128652,"2017-01-01",2017
"17-Jan",경기,수원시 장안구,558,104017,4033,108608,"2017-01-01",2017
"17-Jan",경기,수원시 팔달구,446,71317,3451,75214,"2017-01-01",2017
"17-Jan",경기,시흥시,416,182041,7385,189842,"2017-01-01",2017
"17-Jan",경기,안산시 단원구,505,142589,8271,151365,"2017-01-01",2017
"17-Jan",경기,안산시 상록구,160,136399,4659,141218,"2017-01-01",2017
"17-Jan",경기,안성시,322,89815,5119,95256,"2017-01-01",2017
"17-Jan",경기,안양시 동안구,367,118151,6595,125113,"2017-01-01",2017
"17-Jan",경기,안양시 만안구,145,81302,3822,85269,"2017-01-01",2017
"17-Jan",경기,양주시,312,86357,2902,89571,"2017-01-01",2017
"17-Jan",경기,양평군,440,51569,1667,53676,"2017-01-01",2017
"17-Jan",경기,여주시,353,56703,7246,64302,"2017-01-01",2017
"17-Jan",경기,연천군,255,21852,5662,27769,"2017-01-01",2017
"17-Jan",경기,오산시,211,85433,3094,88738,"2017-01-01",2017
"17-Jan",경기,용인시 기흥구,93,163504,8034,171631,"2017-01-01",2017
"17-Jan",경기,용인시 수지구,49,126304,2005,128358,"2017-01-01",2017
"17-Jan",경기,용인시 처인구,580,104703,6756,112039,"2017-01-01",2017
"17-Jan",경기,의왕시,264,56218,2829,59311,"2017-01-01",2017
"17-Jan",경기,의정부시,528,139583,4848,144959,"2017-01-01",2017
"17-Jan",경기,이천시,351,97815,5818,103984,"2017-01-01",2017
"17-Jan",경기,파주시,383,179426,10223,190032,"2017-01-01",2017
"17-Jan",경기,평택시,597,219511,10551,230659,"2017-01-01",2017
"17-Jan",경기,포천시,334,78378,10492,89204,"2017-01-01",2017
"17-Jan",경기,하남시,300,82669,2080,85049,"2017-01-01",2017
"17-Jan",경기,화성시,678,310250,10483,321411,"2017-01-01",2017
"17-Jan",강원,계,5097,695443,24432,724972,"2017-01-01",2017
"17-Jan",강원,강릉시,473,97351,4186,102010,"2017-01-01",2017
"17-Jan",강원,고성군,168,13052,243,13463,"2017-01-01",2017
"17-Jan",강원,동해시,282,41082,1365,42729,"2017-01-01",2017
"17-Jan",강원,삼척시,326,29204,710,30240,"2017-01-01",2017
"17-Jan",강원,속초시,273,33506,1244,35023,"2017-01-01",2017
"17-Jan",강원,양구군,125,10927,127,11179,"2017-01-01",2017
"17-Jan",강원,양양군,153,13381,228,13762,"2017-01-01",2017
"17-Jan",강원,영월군,298,19141,396,19835,"2017-01-01",2017
"17-Jan",강원,원주시,502,149117,5845,155464,"2017-01-01",2017
"17-Jan",강원,인제군,181,16367,206,16754,"2017-01-01",2017
"17-Jan",강원,정선군,280,19026,478,19784,"2017-01-01",2017
"17-Jan",강원,철원군,180,22232,305,22717,"2017-01-01",2017
"17-Jan",강원,춘천시,680,117960,5804,124444,"2017-01-01",2017
"17-Jan",강원,태백시,200,19977,837,21014,"2017-01-01",2017
"17-Jan",강원,평창군,259,23880,417,24556,"2017-01-01",2017
"17-Jan",강원,홍천군,333,34749,1112,36194,"2017-01-01",2017
"17-Jan",강원,화천군,173,11562,131,11866,"2017-01-01",2017
"17-Jan",강원,횡성군,211,22929,798,23938,"2017-01-01",2017
"17-Jan",충북,계,3407,728247,32552,764206,"2017-01-01",2017
"17-Jan",충북,괴산군,168,20271,360,20799,"2017-01-01",2017
"17-Jan",충북,단양군,150,14543,852,15545,"2017-01-01",2017
"17-Jan",충북,보은군,185,16430,946,17561,"2017-01-01",2017
"17-Jan",충북,영동군,202,23462,383,24047,"2017-01-01",2017
"17-Jan",충북,옥천군,181,24341,1021,25543,"2017-01-01",2017
"17-Jan",충북,음성군,198,53390,1702,55290,"2017-01-01",2017
"17-Jan",충북,제천시,303,61478,3322,65103,"2017-01-01",2017
"17-Jan",충북,증평군,76,17138,739,17953,"2017-01-01",2017
"17-Jan",충북,진천군,177,37223,1122,38522,"2017-01-01",2017
"17-Jan",충북,청원군,1,35,1,37,"2017-01-01",2017
"17-Jan",충북,청주시 상당구,399,73295,2603,76297,"2017-01-01",2017
"17-Jan",충북,청주시 서원구,218,89648,6108,95974,"2017-01-01",2017
"17-Jan",충북,청주시 청원구,306,91112,3706,95124,"2017-01-01",2017
"17-Jan",충북,청주시 흥덕구,345,109493,5950,115788,"2017-01-01",2017
"17-Jan",충북,충주시,498,96388,3737,100623,"2017-01-01",2017
"17-Jan",충남,계,4820,976205,39057,1020082,"2017-01-01",2017
"17-Jan",충남,계룡시,134,19359,510,20003,"2017-01-01",2017
"17-Jan",충남,공주시,491,50047,2097,52635,"2017-01-01",2017
"17-Jan",충남,금산군,163,26602,2320,29085,"2017-01-01",2017
"17-Jan",충남,논산시,325,56619,2143,59087,"2017-01-01",2017
"17-Jan",충남,당진시,343,84397,3702,88442,"2017-01-01",2017
"17-Jan",충남,보령시,334,47962,1296,49592,"2017-01-01",2017
"17-Jan",충남,부여군,244,32046,1447,33737,"2017-01-01",2017
"17-Jan",충남,서산시,368,81576,3458,85402,"2017-01-01",2017
"17-Jan",충남,서천군,200,25762,967,26929,"2017-01-01",2017
"17-Jan",충남,아산시,375,141991,6162,148528,"2017-01-01",2017
"17-Jan",충남,예산군,316,39498,1377,41191,"2017-01-01",2017
"17-Jan",충남,천안시 동남구,244,117004,4861,122109,"2017-01-01",2017
"17-Jan",충남,천안시 서북구,493,159972,5928,166393,"2017-01-01",2017
"17-Jan",충남,청양군,207,15448,952,16607,"2017-01-01",2017
"17-Jan",충남,태안군,216,30812,498,31526,"2017-01-01",2017
"17-Jan",충남,홍성군,367,47110,1339,48816,"2017-01-01",2017
"17-Jan",전북,계,4290,830081,37790,872161,"2017-01-01",2017
"17-Jan",전북,고창군,222,28424,549,29195,"2017-01-01",2017
"17-Jan",전북,군산시,433,121357,6918,128708,"2017-01-01",2017
"17-Jan",전북,김제시,249,41951,1777,43977,"2017-01-01",2017
"17-Jan",전북,남원시,368,37213,3259,40840,"2017-01-01",2017
"17-Jan",전북,무주군,152,11672,367,12191,"2017-01-01",2017
"17-Jan",전북,부안군,235,25924,597,26756,"2017-01-01",2017
"17-Jan",전북,순창군,177,13413,227,13817,"2017-01-01",2017
"17-Jan",전북,완주군,284,47575,3477,51336,"2017-01-01",2017
"17-Jan",전북,익산시,428,130540,6111,137079,"2017-01-01",2017
"17-Jan",전북,임실군,169,13296,406,13871,"2017-01-01",2017
"17-Jan",전북,장수군,183,11123,173,11479,"2017-01-01",2017
"17-Jan",전북,전주시 덕진구,356,140125,7459,147940,"2017-01-01",2017
"17-Jan",전북,전주시 완산구,559,145126,4000,149685,"2017-01-01",2017
"17-Jan",전북,정읍시,279,49748,2284,52311,"2017-01-01",2017
"17-Jan",전북,진안군,196,12594,186,12976,"2017-01-01",2017
"17-Jan",전남,계,5319,845549,105545,956413,"2017-01-01",2017
"17-Jan",전남,강진군,190,17130,1092,18412,"2017-01-01",2017
"17-Jan",전남,고흥군,228,28380,678,29286,"2017-01-01",2017
"17-Jan",전남,곡성군,137,13629,960,14726,"2017-01-01",2017
"17-Jan",전남,광양시,224,73622,5869,79715,"2017-01-01",2017
"17-Jan",전남,구례군,102,12147,645,12894,"2017-01-01",2017
"17-Jan",전남,나주시,365,51676,3151,55192,"2017-01-01",2017
"17-Jan",전남,담양군,182,23960,1545,25687,"2017-01-01",2017
"17-Jan",전남,목포시,427,90553,6130,97110,"2017-01-01",2017
"17-Jan",전남,무안군,459,38418,1046,39923,"2017-01-01",2017
"17-Jan",전남,보성군,213,19938,48659,68810,"2017-01-01",2017
"17-Jan",전남,순천시,448,121912,4854,127214,"2017-01-01",2017
"17-Jan",전남,신안군,184,18780,646,19610,"2017-01-01",2017
"17-Jan",전남,여수시,488,118448,6561,125497,"2017-01-01",2017
"17-Jan",전남,영광군,204,25196,703,26103,"2017-01-01",2017
"17-Jan",전남,영암군,216,30539,17522,48277,"2017-01-01",2017
"17-Jan",전남,완도군,196,22730,480,23406,"2017-01-01",2017
"17-Jan",전남,장성군,133,23249,1237,24619,"2017-01-01",2017
"17-Jan",전남,장흥군,168,18426,441,19035,"2017-01-01",2017
"17-Jan",전남,진도군,130,15097,297,15524,"2017-01-01",2017
"17-Jan",전남,함평군,146,16258,334,16738,"2017-01-01",2017
"17-Jan",전남,해남군,284,35900,574,36758,"2017-01-01",2017
"17-Jan",전남,화순군,195,29561,2121,31877,"2017-01-01",2017
"17-Jan",경북,경산시,382,124298,4248,128928,"2017-01-01",2017
"17-Jan",경북,경주시,498,129700,5162,135360,"2017-01-01",2017
"17-Jan",경북,고령군,139,19803,459,20401,"2017-01-01",2017
"17-Jan",경북,구미시,444,193444,7510,201398,"2017-01-01",2017
"17-Jan",경북,군위군,106,13448,253,13807,"2017-01-01",2017
"17-Jan",경북,김천시,318,66826,1750,68894,"2017-01-01",2017
"17-Jan",경북,문경시,251,33494,783,34528,"2017-01-01",2017
"17-Jan",경북,봉화군,182,16249,205,16636,"2017-01-01",2017
"17-Jan",경북,상주시,341,48836,1809,50986,"2017-01-01",2017
"17-Jan",경북,성주군,168,27835,1444,29447,"2017-01-01",2017
"17-Jan",경북,안동시,525,77478,2551,80554,"2017-01-01",2017
"17-Jan",경북,영덕군,217,17706,309,18232,"2017-01-01",2017
"17-Jan",경북,영양군,125,8699,97,8921,"2017-01-01",2017
"17-Jan",경북,영주시,309,52586,1550,54445,"2017-01-01",2017
"17-Jan",경북,영천시,239,53246,2686,56171,"2017-01-01",2017
"17-Jan",경북,예천군,172,22027,426,22625,"2017-01-01",2017
"17-Jan",경북,울릉군,130,4663,397,5190,"2017-01-01",2017
"17-Jan",경북,울진군,244,24202,373,24819,"2017-01-01",2017
"17-Jan",경북,의성군,275,27662,985,28922,"2017-01-01",2017
"17-Jan",경북,청도군,137,22818,632,23587,"2017-01-01",2017
"17-Jan",경북,청송군,186,14005,204,14395,"2017-01-01",2017
"17-Jan",경북,칠곡군,304,65442,2166,67912,"2017-01-01",2017
"17-Jan",경북,포항시 남구,354,115601,9034,124989,"2017-01-01",2017
"17-Jan",경북,포항시 북구,312,123774,3880,127966,"2017-01-01",2017
"17-Jan",경북,계,6358,1303842,48913,1359113,"2017-01-01",2017
"17-Jan",경남,계,6271,1542202,83135,1631608,"2017-01-01",2017
"17-Jan",경남,거제시,304,102610,2693,105607,"2017-01-01",2017
"17-Jan",경남,거창군,229,29040,787,30056,"2017-01-01",2017
"17-Jan",경남,고성군,199,25113,707,26019,"2017-01-01",2017
"17-Jan",경남,김해시,582,243951,6576,251109,"2017-01-01",2017
"17-Jan",경남,남해군,206,17838,514,18558,"2017-01-01",2017
"17-Jan",경남,밀양시,285,51791,4304,56380,"2017-01-01",2017
"17-Jan",경남,사천시,280,51432,1554,53266,"2017-01-01",2017
"17-Jan",경남,산청군,194,17934,769,18897,"2017-01-01",2017
"17-Jan",경남,양산시,344,136921,8837,146102,"2017-01-01",2017
"17-Jan",경남,의령군,167,12873,786,13826,"2017-01-01",2017
"17-Jan",경남,진주시,546,149425,6854,156825,"2017-01-01",2017
"17-Jan",경남,창녕군,201,32634,772,33607,"2017-01-01",2017
"17-Jan",경남,창원시 마산합포구,314,95780,3075,99169,"2017-01-01",2017
"17-Jan",경남,창원시 마산회원구,165,97822,5459,103446,"2017-01-01",2017
"17-Jan",경남,창원시 성산구,142,122092,18803,141037,"2017-01-01",2017
"17-Jan",경남,창원시 의창구,830,121720,5766,128316,"2017-01-01",2017
"17-Jan",경남,창원시 진해구,185,79232,1586,81003,"2017-01-01",2017
"17-Jan",경남,통영시,294,50904,1487,52685,"2017-01-01",2017
"17-Jan",경남,하동군,197,23077,468,23742,"2017-01-01",2017
"17-Jan",경남,함안군,176,40574,9860,50610,"2017-01-01",2017
"17-Jan",경남,함양군,194,17998,407,18599,"2017-01-01",2017
"17-Jan",경남,합천군,237,21441,1071,22749,"2017-01-01",2017
"17-Jan",제주,계,1969,355700,111723,469392,"2017-01-01",2017
"17-Jan",제주,서귀포시,636,91180,2351,94167,"2017-01-01",2017
"17-Jan",제주,제주시,1333,264520,109372,375225,"2017-01-01",2017
"17-Feb",서울,계,11095,2886488,196347,3093930,"2017-02-01",2017
"17-Feb",서울,강남구,350,224078,19933,244361,"2017-02-01",2017
"17-Feb",서울,강동구,222,129446,8416,138084,"2017-02-01",2017
"17-Feb",서울,강북구,271,71846,4814,76931,"2017-02-01",2017
"17-Feb",서울,강서구,288,181444,15196,196928,"2017-02-01",2017
"17-Feb",서울,관악구,264,116161,5722,122147,"2017-02-01",2017
"17-Feb",서울,광진구,275,91330,5657,97262,"2017-02-01",2017
"17-Feb",서울,구로구,253,129540,11351,141144,"2017-02-01",2017
"17-Feb",서울,금천구,93,78223,7070,85386,"2017-02-01",2017
"17-Feb",서울,노원구,252,146186,9588,156026,"2017-02-01",2017
"17-Feb",서울,도봉구,229,89292,7666,97187,"2017-02-01",2017
"17-Feb",서울,동대문구,275,91451,5789,97515,"2017-02-01",2017
"17-Feb",서울,동작구,271,101307,2759,104337,"2017-02-01",2017
"17-Feb",서울,마포구,291,109281,7411,116983,"2017-02-01",2017
"17-Feb",서울,서대문구,420,79173,5343,84936,"2017-02-01",2017
"17-Feb",서울,서초구,590,169363,10161,180114,"2017-02-01",2017
"17-Feb",서울,성동구,268,91043,9276,100587,"2017-02-01",2017
"17-Feb",서울,성북구,223,111151,5487,116861,"2017-02-01",2017
"17-Feb",서울,송파구,332,212377,11788,224497,"2017-02-01",2017
"17-Feb",서울,양천구,295,141235,8940,150470,"2017-02-01",2017
"17-Feb",서울,영등포구,319,135558,9742,145619,"2017-02-01",2017
"17-Feb",서울,용산구,345,73038,2235,75618,"2017-02-01",2017
"17-Feb",서울,은평구,225,120862,6878,127965,"2017-02-01",2017
"17-Feb",서울,종로구,3569,43969,1601,49139,"2017-02-01",2017
"17-Feb",서울,중구,987,46618,3903,51508,"2017-02-01",2017
"17-Feb",서울,중랑구,188,102516,9621,112325,"2017-02-01",2017
"17-Feb",부산,계,4272,1216603,79441,1300316,"2017-02-01",2017
"17-Feb",부산,강서구,296,60805,3947,65048,"2017-02-01",2017
"17-Feb",부산,금정구,271,79383,7419,87073,"2017-02-01",2017
"17-Feb",부산,기장군,224,66071,2113,68408,"2017-02-01",2017
"17-Feb",부산,남구,200,86841,9008,96049,"2017-02-01",2017
"17-Feb",부산,동구,218,40153,5328,45699,"2017-02-01",2017
"17-Feb",부산,동래구,161,87388,4381,91930,"2017-02-01",2017
"17-Feb",부산,부산진구,365,121227,6263,127855,"2017-02-01",2017
"17-Feb",부산,북구,211,100839,3262,104312,"2017-02-01",2017
"17-Feb",부산,사상구,256,84700,6311,91267,"2017-02-01",2017
"17-Feb",부산,사하구,232,107110,7095,114437,"2017-02-01",2017
"17-Feb",부산,서구,127,27406,1334,28867,"2017-02-01",2017
"17-Feb",부산,수영구,147,64670,3096,67913,"2017-02-01",2017
"17-Feb",부산,연제구,791,84477,5567,90835,"2017-02-01",2017
"17-Feb",부산,영도구,215,31634,2607,34456,"2017-02-01",2017
"17-Feb",부산,중구,303,17119,6322,23744,"2017-02-01",2017
"17-Feb",부산,해운대구,255,156780,5388,162423,"2017-02-01",2017
"17-Feb",대구,계,2831,1084008,48807,1135646,"2017-02-01",2017
"17-Feb",대구,남구,308,56267,2056,58631,"2017-02-01",2017
"17-Feb",대구,달서구,422,253512,12427,266361,"2017-02-01",2017
"17-Feb",대구,달성군,421,105318,3719,109458,"2017-02-01",2017
"17-Feb",대구,동구,294,145120,10614,156028,"2017-02-01",2017
"17-Feb",대구,북구,421,185715,8409,194545,"2017-02-01",2017
"17-Feb",대구,서구,205,75642,4514,80361,"2017-02-01",2017
"17-Feb",대구,수성구,496,205777,5321,211594,"2017-02-01",2017
"17-Feb",대구,중구,264,56657,1747,58668,"2017-02-01",2017
"17-Feb",인천,계,3402,1176519,269848,1449769,"2017-02-01",2017
"17-Feb",인천,강화군,285,30527,2692,33504,"2017-02-01",2017
"17-Feb",인천,계양구,243,121016,133984,255243,"2017-02-01",2017
"17-Feb",인천,남구,359,141196,53385,194940,"2017-02-01",2017
"17-Feb",인천,남동구,776,231409,35493,267678,"2017-02-01",2017
"17-Feb",인천,동구,85,25839,2592,28516,"2017-02-01",2017
"17-Feb",인천,부평구,316,208142,7172,215630,"2017-02-01",2017
"17-Feb",인천,서구,334,206740,10521,217595,"2017-02-01",2017
"17-Feb",인천,연수구,289,149177,7319,156785,"2017-02-01",2017
"17-Feb",인천,옹진군,164,10970,158,11292,"2017-02-01",2017
"17-Feb",인천,중구,551,51503,16532,68586,"2017-02-01",2017
"17-Feb",광주,계,1964,601418,33361,636743,"2017-02-01",2017
"17-Feb",광주,광산구,458,171924,10090,182472,"2017-02-01",2017
"17-Feb",광주,남구,184,82791,3206,86181,"2017-02-01",2017
"17-Feb",광주,동구,218,35098,1163,36479,"2017-02-01",2017
"17-Feb",광주,북구,453,174020,9353,183826,"2017-02-01",2017
"17-Feb",광주,서구,651,137585,9549,147785,"2017-02-01",2017
"17-Feb",대전,계,1762,621238,27908,650908,"2017-02-01",2017
"17-Feb",대전,대덕구,208,85268,6622,92098,"2017-02-01",2017
"17-Feb",대전,동구,221,86759,4165,91145,"2017-02-01",2017
"17-Feb",대전,서구,745,196516,7132,204393,"2017-02-01",2017
"17-Feb",대전,유성구,366,157036,4171,161573,"2017-02-01",2017
"17-Feb",대전,중구,222,95659,5818,101699,"2017-02-01",2017
"17-Feb",울산,계,1565,518444,21378,541387,"2017-02-01",2017
"17-Feb",울산,남구,624,150785,7326,158735,"2017-02-01",2017
"17-Feb",울산,동구,192,62977,931,64100,"2017-02-01",2017
"17-Feb",울산,북구,113,92428,4420,96961,"2017-02-01",2017
"17-Feb",울산,울주군,324,109883,5904,116111,"2017-02-01",2017
"17-Feb",울산,중구,312,102371,2797,105480,"2017-02-01",2017
"17-Feb",세종,계,633,109822,2296,112751,"2017-02-01",2017
"17-Feb",세종,세종특별자치시,633,109822,2296,112751,"2017-02-01",2017
"17-Feb",경기,계,14819,4960309,221234,5196362,"2017-02-01",2017
"17-Feb",경기,가평군,324,27482,705,28511,"2017-02-01",2017
"17-Feb",경기,고양시 덕양구,586,152644,3730,156960,"2017-02-01",2017
"17-Feb",경기,고양시 일산동구,244,113039,6932,120215,"2017-02-01",2017
"17-Feb",경기,고양시 일산서구,110,105918,3148,109176,"2017-02-01",2017
"17-Feb",경기,과천시,680,20682,545,21907,"2017-02-01",2017
"17-Feb",경기,광명시,281,102125,4301,106707,"2017-02-01",2017
"17-Feb",경기,광주시,346,155875,7797,164018,"2017-02-01",2017
"17-Feb",경기,구리시,202,63791,2412,66405,"2017-02-01",2017
"17-Feb",경기,군포시,241,93790,4852,98883,"2017-02-01",2017
"17-Feb",경기,김포시,393,159457,6230,166080,"2017-02-01",2017
"17-Feb",경기,남양주시,548,250373,6885,257806,"2017-02-01",2017
"17-Feb",경기,동두천시,192,35664,1275,37131,"2017-02-01",2017
"17-Feb",경기,부천시,650,283185,11952,295787,"2017-02-01",2017
"17-Feb",경기,성남시 분당구,315,182478,6507,189300,"2017-02-01",2017
"17-Feb",경기,성남시 수정구,295,66554,2372,69221,"2017-02-01",2017
"17-Feb",경기,성남시 중원구,250,72018,3827,76095,"2017-02-01",2017
"17-Feb",경기,수원시 권선구,311,156112,7261,163684,"2017-02-01",2017
"17-Feb",경기,수원시 영통구,196,126070,2732,128998,"2017-02-01",2017
"17-Feb",경기,수원시 장안구,551,103760,4056,108367,"2017-02-01",2017
"17-Feb",경기,수원시 팔달구,450,71317,3395,75162,"2017-02-01",2017
"17-Feb",경기,시흥시,413,182672,7393,190478,"2017-02-01",2017
"17-Feb",경기,안산시 단원구,507,142419,8251,151177,"2017-02-01",2017
"17-Feb",경기,안산시 상록구,162,136398,4665,141225,"2017-02-01",2017
"17-Feb",경기,안성시,324,89958,5112,95394,"2017-02-01",2017
"17-Feb",경기,안양시 동안구,369,118133,6592,125094,"2017-02-01",2017
"17-Feb",경기,안양시 만안구,145,81674,3832,85651,"2017-02-01",2017
"17-Feb",경기,양주시,315,86724,2919,89958,"2017-02-01",2017
"17-Feb",경기,양평군,439,51796,1676,53911,"2017-02-01",2017
"17-Feb",경기,여주시,354,56681,7299,64334,"2017-02-01",2017
"17-Feb",경기,연천군,254,21954,5662,27870,"2017-02-01",2017
"17-Feb",경기,오산시,212,85835,3103,89150,"2017-02-01",2017
"17-Feb",경기,용인시 기흥구,93,163503,7943,171539,"2017-02-01",2017
"17-Feb",경기,용인시 수지구,48,126392,2036,128476,"2017-02-01",2017
"17-Feb",경기,용인시 처인구,594,104991,6723,112308,"2017-02-01",2017
"17-Feb",경기,의왕시,267,56154,2817,59238,"2017-02-01",2017
"17-Feb",경기,의정부시,517,139648,4848,145013,"2017-02-01",2017
"17-Feb",경기,이천시,350,98057,5815,104222,"2017-02-01",2017
"17-Feb",경기,파주시,381,179771,10140,190292,"2017-02-01",2017
"17-Feb",경기,평택시,593,220547,10567,231707,"2017-02-01",2017
"17-Feb",경기,포천시,331,78335,10322,88988,"2017-02-01",2017
"17-Feb",경기,하남시,301,83452,2081,85834,"2017-02-01",2017
"17-Feb",경기,화성시,685,312881,10524,324090,"2017-02-01",2017
"17-Feb",강원,계,5092,696776,24409,726277,"2017-02-01",2017
"17-Feb",강원,강릉시,477,97458,4186,102121,"2017-02-01",2017
"17-Feb",강원,고성군,169,12992,244,13405,"2017-02-01",2017
"17-Feb",강원,동해시,280,41137,1370,42787,"2017-02-01",2017
"17-Feb",강원,삼척시,328,29203,760,30291,"2017-02-01",2017
"17-Feb",강원,속초시,271,33876,1226,35373,"2017-02-01",2017
"17-Feb",강원,양구군,124,10914,126,11164,"2017-02-01",2017
"17-Feb",강원,양양군,153,13424,227,13804,"2017-02-01",2017
"17-Feb",강원,영월군,296,19180,391,19867,"2017-02-01",2017
"17-Feb",강원,원주시,499,149571,5823,155893,"2017-02-01",2017
"17-Feb",강원,인제군,180,16380,205,16765,"2017-02-01",2017
"17-Feb",강원,정선군,282,19022,477,19781,"2017-02-01",2017
"17-Feb",강원,철원군,186,22202,305,22693,"2017-02-01",2017
"17-Feb",강원,춘천시,675,118266,5765,124706,"2017-02-01",2017
"17-Feb",강원,태백시,197,19921,851,20969,"2017-02-01",2017
"17-Feb",강원,평창군,262,23837,414,24513,"2017-02-01",2017
"17-Feb",강원,홍천군,328,34817,1109,36254,"2017-02-01",2017
"17-Feb",강원,화천군,173,11560,130,11863,"2017-02-01",2017
"17-Feb",강원,횡성군,212,23016,800,24028,"2017-02-01",2017
"17-Feb",충북,계,3417,730531,32595,766543,"2017-02-01",2017
"17-Feb",충북,괴산군,169,20339,368,20876,"2017-02-01",2017
"17-Feb",충북,단양군,150,14561,857,15568,"2017-02-01",2017
"17-Feb",충북,보은군,186,16454,949,17589,"2017-02-01",2017
"17-Feb",충북,영동군,202,23467,383,24052,"2017-02-01",2017
"17-Feb",충북,옥천군,182,24400,1023,25605,"2017-02-01",2017
"17-Feb",충북,음성군,198,53651,1703,55552,"2017-02-01",2017
"17-Feb",충북,제천시,304,61597,3318,65219,"2017-02-01",2017
"17-Feb",충북,증평군,77,17218,738,18033,"2017-02-01",2017
"17-Feb",충북,진천군,177,37426,1121,38724,"2017-02-01",2017
"17-Feb",충북,청원군,1,35,1,37,"2017-02-01",2017
"17-Feb",충북,청주시 상당구,401,73363,2605,76369,"2017-02-01",2017
"17-Feb",충북,청주시 서원구,219,89872,6086,96177,"2017-02-01",2017
"17-Feb",충북,청주시 청원구,308,91487,3740,95535,"2017-02-01",2017
"17-Feb",충북,청주시 흥덕구,345,110102,5972,116419,"2017-02-01",2017
"17-Feb",충북,충주시,498,96559,3731,100788,"2017-02-01",2017
"17-Feb",충남,계,4812,980014,39074,1023900,"2017-02-01",2017
"17-Feb",충남,계룡시,134,19629,518,20281,"2017-02-01",2017
"17-Feb",충남,공주시,490,50172,2087,52749,"2017-02-01",2017
"17-Feb",충남,금산군,160,26668,2322,29150,"2017-02-01",2017
"17-Feb",충남,논산시,324,56717,2139,59180,"2017-02-01",2017
"17-Feb",충남,당진시,336,84727,3687,88750,"2017-02-01",2017
"17-Feb",충남,보령시,337,47989,1271,49597,"2017-02-01",2017
"17-Feb",충남,부여군,235,32115,1402,33752,"2017-02-01",2017
"17-Feb",충남,서산시,369,81937,3445,85751,"2017-02-01",2017
"17-Feb",충남,서천군,203,25807,976,26986,"2017-02-01",2017
"17-Feb",충남,아산시,377,142656,6289,149322,"2017-02-01",2017
"17-Feb",충남,예산군,321,39508,1370,41199,"2017-02-01",2017
"17-Feb",충남,천안시 동남구,242,117007,4847,122096,"2017-02-01",2017
"17-Feb",충남,천안시 서북구,494,161336,5903,167733,"2017-02-01",2017
"17-Feb",충남,청양군,207,15463,969,16639,"2017-02-01",2017
"17-Feb",충남,태안군,214,30885,498,31597,"2017-02-01",2017
"17-Feb",충남,홍성군,369,47398,1351,49118,"2017-02-01",2017
"17-Feb",전북,계,4314,831357,37724,873395,"2017-02-01",2017
"17-Feb",전북,고창군,223,28335,554,29112,"2017-02-01",2017
"17-Feb",전북,군산시,432,121503,6900,128835,"2017-02-01",2017
"17-Feb",전북,김제시,248,42038,1781,44067,"2017-02-01",2017
"17-Feb",전북,남원시,369,37335,3224,40928,"2017-02-01",2017
"17-Feb",전북,무주군,152,11699,364,12215,"2017-02-01",2017
"17-Feb",전북,부안군,238,25913,594,26745,"2017-02-01",2017
"17-Feb",전북,순창군,177,13403,229,13809,"2017-02-01",2017
"17-Feb",전북,완주군,288,47776,3475,51539,"2017-02-01",2017
"17-Feb",전북,익산시,434,130689,6113,137236,"2017-02-01",2017
"17-Feb",전북,임실군,173,13295,407,13875,"2017-02-01",2017
"17-Feb",전북,장수군,185,11129,176,11490,"2017-02-01",2017
"17-Feb",전북,전주시 덕진구,359,140328,7455,148142,"2017-02-01",2017
"17-Feb",전북,전주시 완산구,562,145381,4017,149960,"2017-02-01",2017
"17-Feb",전북,정읍시,278,49880,2251,52409,"2017-02-01",2017
"17-Feb",전북,진안군,196,12653,184,13033,"2017-02-01",2017
"17-Feb",전남,계,5305,847460,105927,958692,"2017-02-01",2017
"17-Feb",전남,강진군,187,17141,1084,18412,"2017-02-01",2017
"17-Feb",전남,고흥군,228,28463,677,29368,"2017-02-01",2017
"17-Feb",전남,곡성군,137,13617,942,14696,"2017-02-01",2017
"17-Feb",전남,광양시,224,73499,5844,79567,"2017-02-01",2017
"17-Feb",전남,구례군,104,12129,647,12880,"2017-02-01",2017
"17-Feb",전남,나주시,367,52183,3112,55662,"2017-02-01",2017
"17-Feb",전남,담양군,182,24105,1538,25825,"2017-02-01",2017
"17-Feb",전남,목포시,427,90571,6113,97111,"2017-02-01",2017
"17-Feb",전남,무안군,459,38627,1046,40132,"2017-02-01",2017
"17-Feb",전남,보성군,211,20002,49702,69915,"2017-02-01",2017
"17-Feb",전남,순천시,440,122382,4853,127675,"2017-02-01",2017
"17-Feb",전남,신안군,184,18864,646,19694,"2017-02-01",2017
"17-Feb",전남,여수시,481,118628,6607,125716,"2017-02-01",2017
"17-Feb",전남,영광군,202,25234,701,26137,"2017-02-01",2017
"17-Feb",전남,영암군,217,30484,16950,47651,"2017-02-01",2017
"17-Feb",전남,완도군,194,22783,475,23452,"2017-02-01",2017
"17-Feb",전남,장성군,135,23374,1221,24730,"2017-02-01",2017
"17-Feb",전남,장흥군,169,18426,437,19032,"2017-02-01",2017
"17-Feb",전남,진도군,130,15120,296,15546,"2017-02-01",2017
"17-Feb",전남,함평군,147,16262,336,16745,"2017-02-01",2017
"17-Feb",전남,해남군,287,35923,570,36780,"2017-02-01",2017
"17-Feb",전남,화순군,193,29643,2130,31966,"2017-02-01",2017
"17-Feb",경북,경산시,382,124423,4236,129041,"2017-02-01",2017
"17-Feb",경북,경주시,502,129831,5146,135479,"2017-02-01",2017
"17-Feb",경북,고령군,140,19842,459,20441,"2017-02-01",2017
"17-Feb",경북,구미시,441,194018,7403,201862,"2017-02-01",2017
"17-Feb",경북,군위군,104,13562,255,13921,"2017-02-01",2017
"17-Feb",경북,김천시,318,67182,1757,69257,"2017-02-01",2017
"17-Feb",경북,문경시,251,33572,780,34603,"2017-02-01",2017
"17-Feb",경북,봉화군,182,16333,206,16721,"2017-02-01",2017
"17-Feb",경북,상주시,343,49045,1807,51195,"2017-02-01",2017
"17-Feb",경북,성주군,170,27906,1480,29556,"2017-02-01",2017
"17-Feb",경북,안동시,520,77542,2550,80612,"2017-02-01",2017
"17-Feb",경북,영덕군,215,17775,308,18298,"2017-02-01",2017
"17-Feb",경북,영양군,125,8710,99,8934,"2017-02-01",2017
"17-Feb",경북,영주시,307,52691,1551,54549,"2017-02-01",2017
"17-Feb",경북,영천시,235,53381,2655,56271,"2017-02-01",2017
"17-Feb",경북,예천군,171,22099,422,22692,"2017-02-01",2017
"17-Feb",경북,울릉군,129,4720,393,5242,"2017-02-01",2017
"17-Feb",경북,울진군,242,24247,376,24865,"2017-02-01",2017
"17-Feb",경북,의성군,271,27782,976,29029,"2017-02-01",2017
"17-Feb",경북,청도군,139,22903,625,23667,"2017-02-01",2017
"17-Feb",경북,청송군,183,14065,204,14452,"2017-02-01",2017
"17-Feb",경북,칠곡군,303,65586,2156,68045,"2017-02-01",2017
"17-Feb",경북,포항시 남구,348,115728,9011,125087,"2017-02-01",2017
"17-Feb",경북,포항시 북구,310,123913,3866,128089,"2017-02-01",2017
"17-Feb",경북,계,6331,1306856,48721,1361908,"2017-02-01",2017
"17-Feb",경남,계,6306,1544956,83697,1634959,"2017-02-01",2017
"17-Feb",경남,거제시,302,102689,2665,105656,"2017-02-01",2017
"17-Feb",경남,거창군,229,29097,788,30114,"2017-02-01",2017
"17-Feb",경남,고성군,199,25157,710,26066,"2017-02-01",2017
"17-Feb",경남,김해시,583,244465,6539,251587,"2017-02-01",2017
"17-Feb",경남,남해군,205,17944,513,18662,"2017-02-01",2017
"17-Feb",경남,밀양시,285,51825,4282,56392,"2017-02-01",2017
"17-Feb",경남,사천시,282,51531,1544,53357,"2017-02-01",2017
"17-Feb",경남,산청군,196,18039,765,19000,"2017-02-01",2017
"17-Feb",경남,양산시,346,137775,8850,146971,"2017-02-01",2017
"17-Feb",경남,의령군,167,12913,787,13867,"2017-02-01",2017
"17-Feb",경남,진주시,546,149733,6854,157133,"2017-02-01",2017
"17-Feb",경남,창녕군,204,32721,771,33696,"2017-02-01",2017
"17-Feb",경남,창원시 마산합포구,314,96178,3067,99559,"2017-02-01",2017
"17-Feb",경남,창원시 마산회원구,164,97770,5421,103355,"2017-02-01",2017
"17-Feb",경남,창원시 성산구,142,121778,19202,141122,"2017-02-01",2017
"17-Feb",경남,창원시 의창구,849,121830,5925,128604,"2017-02-01",2017
"17-Feb",경남,창원시 진해구,189,79586,1595,81370,"2017-02-01",2017
"17-Feb",경남,통영시,296,50957,1485,52738,"2017-02-01",2017
"17-Feb",경남,하동군,199,23098,463,23760,"2017-02-01",2017
"17-Feb",경남,함안군,177,40447,9991,50615,"2017-02-01",2017
"17-Feb",경남,함양군,195,17974,408,18577,"2017-02-01",2017
"17-Feb",경남,합천군,237,21449,1072,22758,"2017-02-01",2017
"17-Feb",제주,계,1973,356013,112827,470813,"2017-02-01",2017
"17-Feb",제주,서귀포시,634,91616,2313,94563,"2017-02-01",2017
"17-Feb",제주,제주시,1339,264397,110514,376250,"2017-02-01",2017
"17-Mar",서울,계,11259,2888504,195850,3095613,"2017-03-01",2017
"17-Mar",서울,강남구,351,223686,19920,243957,"2017-03-01",2017
"17-Mar",서울,강동구,237,130010,8397,138644,"2017-03-01",2017
"17-Mar",서울,강북구,276,72142,4804,77222,"2017-03-01",2017
"17-Mar",서울,강서구,293,182109,15176,197578,"2017-03-01",2017
"17-Mar",서울,관악구,262,116124,5735,122121,"2017-03-01",2017
"17-Mar",서울,광진구,276,91482,5592,97350,"2017-03-01",2017
"17-Mar",서울,구로구,255,129760,11291,141306,"2017-03-01",2017
"17-Mar",서울,금천구,99,78329,7012,85440,"2017-03-01",2017
"17-Mar",서울,노원구,251,146194,9548,155993,"2017-03-01",2017
"17-Mar",서울,도봉구,230,89157,7653,97040,"2017-03-01",2017
"17-Mar",서울,동대문구,278,91431,5703,97412,"2017-03-01",2017
"17-Mar",서울,동작구,274,101415,2768,104457,"2017-03-01",2017
"17-Mar",서울,마포구,304,109382,7338,117024,"2017-03-01",2017
"17-Mar",서울,서대문구,428,79218,5334,84980,"2017-03-01",2017
"17-Mar",서울,서초구,595,169113,10249,179957,"2017-03-01",2017
"17-Mar",서울,성동구,282,91268,9276,100826,"2017-03-01",2017
"17-Mar",서울,성북구,226,111204,5472,116902,"2017-03-01",2017
"17-Mar",서울,송파구,336,212742,11796,224874,"2017-03-01",2017
"17-Mar",서울,양천구,307,141221,8797,150325,"2017-03-01",2017
"17-Mar",서울,영등포구,322,135350,9790,145462,"2017-03-01",2017
"17-Mar",서울,용산구,346,73090,2216,75652,"2017-03-01",2017
"17-Mar",서울,은평구,230,120905,6880,128015,"2017-03-01",2017
"17-Mar",서울,종로구,3617,44181,1618,49416,"2017-03-01",2017
"17-Mar",서울,중구,991,46384,3863,51238,"2017-03-01",2017
"17-Mar",서울,중랑구,193,102607,9622,112422,"2017-03-01",2017
"17-Mar",부산,계,4317,1219839,79753,1303909,"2017-03-01",2017
"17-Mar",부산,강서구,299,61327,3902,65528,"2017-03-01",2017
"17-Mar",부산,금정구,270,79532,7469,87271,"2017-03-01",2017
"17-Mar",부산,기장군,222,66354,2101,68677,"2017-03-01",2017
"17-Mar",부산,남구,203,86745,8788,95736,"2017-03-01",2017
"17-Mar",부산,동구,220,40410,5223,45853,"2017-03-01",2017
"17-Mar",부산,동래구,164,87660,4356,92180,"2017-03-01",2017
"17-Mar",부산,부산진구,367,121274,6709,128350,"2017-03-01",2017
"17-Mar",부산,북구,213,101073,3260,104546,"2017-03-01",2017
"17-Mar",부산,사상구,259,84741,6258,91258,"2017-03-01",2017
"17-Mar",부산,사하구,237,107292,7092,114621,"2017-03-01",2017
"17-Mar",부산,서구,132,27405,1337,28874,"2017-03-01",2017
"17-Mar",부산,수영구,149,64691,3185,68025,"2017-03-01",2017
"17-Mar",부산,연제구,800,84734,5561,91095,"2017-03-01",2017
"17-Mar",부산,영도구,216,31663,2613,34492,"2017-03-01",2017
"17-Mar",부산,중구,305,17492,6516,24313,"2017-03-01",2017
"17-Mar",부산,해운대구,261,157446,5383,163090,"2017-03-01",2017
"17-Mar",대구,계,2859,1086760,48649,1138268,"2017-03-01",2017
"17-Mar",대구,남구,311,56257,2046,58614,"2017-03-01",2017
"17-Mar",대구,달서구,432,253581,12318,266331,"2017-03-01",2017
"17-Mar",대구,달성군,426,106975,3869,111270,"2017-03-01",2017
"17-Mar",대구,동구,298,145354,10478,156130,"2017-03-01",2017
"17-Mar",대구,북구,423,186044,8499,194966,"2017-03-01",2017
"17-Mar",대구,서구,204,75598,4501,80303,"2017-03-01",2017
"17-Mar",대구,수성구,501,206321,5232,212054,"2017-03-01",2017
"17-Mar",대구,중구,264,56630,1706,58600,"2017-03-01",2017
"17-Mar",인천,계,3439,1180027,271298,1454764,"2017-03-01",2017
"17-Mar",인천,강화군,290,30565,2656,33511,"2017-03-01",2017
"17-Mar",인천,계양구,250,121163,135642,257055,"2017-03-01",2017
"17-Mar",인천,남구,359,141492,53935,195786,"2017-03-01",2017
"17-Mar",인천,남동구,785,231870,34638,267293,"2017-03-01",2017
"17-Mar",인천,동구,91,25744,2574,28409,"2017-03-01",2017
"17-Mar",인천,부평구,319,208887,7153,216359,"2017-03-01",2017
"17-Mar",인천,서구,342,207217,10474,218033,"2017-03-01",2017
"17-Mar",인천,연수구,291,150432,7375,158098,"2017-03-01",2017
"17-Mar",인천,옹진군,163,11006,158,11327,"2017-03-01",2017
"17-Mar",인천,중구,549,51651,16693,68893,"2017-03-01",2017
"17-Mar",광주,계,1985,602818,33253,638056,"2017-03-01",2017
"17-Mar",광주,광산구,465,172402,10124,182991,"2017-03-01",2017
"17-Mar",광주,남구,186,82930,3093,86209,"2017-03-01",2017
"17-Mar",광주,동구,219,35411,1134,36764,"2017-03-01",2017
"17-Mar",광주,북구,456,174157,9291,183904,"2017-03-01",2017
"17-Mar",광주,서구,659,137918,9611,148188,"2017-03-01",2017
"17-Mar",대전,계,1756,622347,27851,651954,"2017-03-01",2017
"17-Mar",대전,대덕구,209,85308,6618,92135,"2017-03-01",2017
"17-Mar",대전,동구,217,86775,4117,91109,"2017-03-01",2017
"17-Mar",대전,서구,744,196899,7172,204815,"2017-03-01",2017
"17-Mar",대전,유성구,366,157712,4297,162375,"2017-03-01",2017
"17-Mar",대전,중구,220,95653,5647,101520,"2017-03-01",2017
"17-Mar",울산,계,1592,519472,21370,542434,"2017-03-01",2017
"17-Mar",울산,남구,638,150967,7315,158920,"2017-03-01",2017
"17-Mar",울산,동구,195,62971,928,64094,"2017-03-01",2017
"17-Mar",울산,북구,115,92681,4396,97192,"2017-03-01",2017
"17-Mar",울산,울주군,328,110311,5913,116552,"2017-03-01",2017
"17-Mar",울산,중구,316,102542,2818,105676,"2017-03-01",2017
"17-Mar",세종,계,636,111690,2308,114634,"2017-03-01",2017
"17-Mar",세종,세종특별자치시,636,111690,2308,114634,"2017-03-01",2017
"17-Mar",경기,계,15039,4976045,220824,5211908,"2017-03-01",2017
"17-Mar",경기,가평군,342,27579,708,28629,"2017-03-01",2017
"17-Mar",경기,고양시 덕양구,592,152889,3747,157228,"2017-03-01",2017
"17-Mar",경기,고양시 일산동구,246,113194,6890,120330,"2017-03-01",2017
"17-Mar",경기,고양시 일산서구,111,106137,3147,109395,"2017-03-01",2017
"17-Mar",경기,과천시,686,20422,540,21648,"2017-03-01",2017
"17-Mar",경기,광명시,281,101856,4270,106407,"2017-03-01",2017
"17-Mar",경기,광주시,355,156413,7795,164563,"2017-03-01",2017
"17-Mar",경기,구리시,206,63970,2379,66555,"2017-03-01",2017
"17-Mar",경기,군포시,241,93941,4850,99032,"2017-03-01",2017
"17-Mar",경기,김포시,397,161233,6243,167873,"2017-03-01",2017
"17-Mar",경기,남양주시,559,251028,6874,258461,"2017-03-01",2017
"17-Mar",경기,동두천시,194,35657,1281,37132,"2017-03-01",2017
"17-Mar",경기,부천시,656,283388,11868,295912,"2017-03-01",2017
"17-Mar",경기,성남시 분당구,312,182488,6520,189320,"2017-03-01",2017
"17-Mar",경기,성남시 수정구,295,66972,2378,69645,"2017-03-01",2017
"17-Mar",경기,성남시 중원구,258,71899,3828,75985,"2017-03-01",2017
"17-Mar",경기,수원시 권선구,311,155895,7263,163469,"2017-03-01",2017
"17-Mar",경기,수원시 영통구,197,126460,2744,129401,"2017-03-01",2017
"17-Mar",경기,수원시 장안구,553,103854,4066,108473,"2017-03-01",2017
"17-Mar",경기,수원시 팔달구,448,71369,3333,75150,"2017-03-01",2017
"17-Mar",경기,시흥시,420,183570,7393,191383,"2017-03-01",2017
"17-Mar",경기,안산시 단원구,515,142744,8167,151426,"2017-03-01",2017
"17-Mar",경기,안산시 상록구,159,136520,4669,141348,"2017-03-01",2017
"17-Mar",경기,안성시,330,90328,5089,95747,"2017-03-01",2017
"17-Mar",경기,안양시 동안구,368,118150,6565,125083,"2017-03-01",2017
"17-Mar",경기,안양시 만안구,145,81991,3850,85986,"2017-03-01",2017
"17-Mar",경기,양주시,320,87157,2952,90429,"2017-03-01",2017
"17-Mar",경기,양평군,439,52060,1671,54170,"2017-03-01",2017
"17-Mar",경기,여주시,367,56942,7347,64656,"2017-03-01",2017
"17-Mar",경기,연천군,257,22041,5657,27955,"2017-03-01",2017
"17-Mar",경기,오산시,212,86281,3131,89624,"2017-03-01",2017
"17-Mar",경기,용인시 기흥구,95,164059,7953,172107,"2017-03-01",2017
"17-Mar",경기,용인시 수지구,45,126608,2037,128690,"2017-03-01",2017
"17-Mar",경기,용인시 처인구,603,105368,6718,112689,"2017-03-01",2017
"17-Mar",경기,의왕시,271,56075,2828,59174,"2017-03-01",2017
"17-Mar",경기,의정부시,518,139837,4774,145129,"2017-03-01",2017
"17-Mar",경기,이천시,357,98350,5755,104462,"2017-03-01",2017
"17-Mar",경기,파주시,427,180294,10138,190859,"2017-03-01",2017
"17-Mar",경기,평택시,601,221447,10533,232581,"2017-03-01",2017
"17-Mar",경기,포천시,338,78470,10142,88950,"2017-03-01",2017
"17-Mar",경기,하남시,311,84592,2124,87027,"2017-03-01",2017
"17-Mar",경기,화성시,701,316517,10607,327825,"2017-03-01",2017
"17-Mar",강원,계,5149,698765,24324,728238,"2017-03-01",2017
"17-Mar",강원,강릉시,477,97675,4158,102310,"2017-03-01",2017
"17-Mar",강원,고성군,170,13038,238,13446,"2017-03-01",2017
"17-Mar",강원,동해시,284,41199,1367,42850,"2017-03-01",2017
"17-Mar",강원,삼척시,333,29322,758,30413,"2017-03-01",2017
"17-Mar",강원,속초시,274,33682,1226,35182,"2017-03-01",2017
"17-Mar",강원,양구군,124,10954,125,11203,"2017-03-01",2017
"17-Mar",강원,양양군,157,13536,230,13923,"2017-03-01",2017
"17-Mar",강원,영월군,296,19208,391,19895,"2017-03-01",2017
"17-Mar",강원,원주시,500,150074,5814,156388,"2017-03-01",2017
"17-Mar",강원,인제군,182,16484,203,16869,"2017-03-01",2017
"17-Mar",강원,정선군,287,19104,473,19864,"2017-03-01",2017
"17-Mar",강원,철원군,192,22330,303,22825,"2017-03-01",2017
"17-Mar",강원,춘천시,684,118567,5731,124982,"2017-03-01",2017
"17-Mar",강원,태백시,199,19933,842,20974,"2017-03-01",2017
"17-Mar",강원,평창군,269,23921,416,24606,"2017-03-01",2017
"17-Mar",강원,홍천군,334,34972,1109,36415,"2017-03-01",2017
"17-Mar",강원,화천군,175,11654,135,11964,"2017-03-01",2017
"17-Mar",강원,횡성군,212,23112,805,24129,"2017-03-01",2017
"17-Mar",충북,계,3468,732863,32651,768982,"2017-03-01",2017
"17-Mar",충북,괴산군,173,20411,363,20947,"2017-03-01",2017
"17-Mar",충북,단양군,152,14627,857,15636,"2017-03-01",2017
"17-Mar",충북,보은군,189,16512,948,17649,"2017-03-01",2017
"17-Mar",충북,영동군,204,23523,380,24107,"2017-03-01",2017
"17-Mar",충북,옥천군,186,24419,1039,25644,"2017-03-01",2017
"17-Mar",충북,음성군,200,53894,1717,55811,"2017-03-01",2017
"17-Mar",충북,제천시,308,61832,3317,65457,"2017-03-01",2017
"17-Mar",충북,증평군,79,17250,748,18077,"2017-03-01",2017
"17-Mar",충북,진천군,181,37660,1124,38965,"2017-03-01",2017
"17-Mar",충북,청원군,1,34,1,36,"2017-03-01",2017
"17-Mar",충북,청주시 상당구,405,73415,2592,76412,"2017-03-01",2017
"17-Mar",충북,청주시 서원구,220,90004,6061,96285,"2017-03-01",2017
"17-Mar",충북,청주시 청원구,316,91885,3755,95956,"2017-03-01",2017
"17-Mar",충북,청주시 흥덕구,349,110482,5989,116820,"2017-03-01",2017
"17-Mar",충북,충주시,505,96915,3760,101180,"2017-03-01",2017
"17-Mar",충남,계,4837,984288,38937,1028062,"2017-03-01",2017
"17-Mar",충남,계룡시,136,19916,518,20570,"2017-03-01",2017
"17-Mar",충남,공주시,489,50265,2063,52817,"2017-03-01",2017
"17-Mar",충남,금산군,167,26715,2278,29160,"2017-03-01",2017
"17-Mar",충남,논산시,322,56809,2146,59277,"2017-03-01",2017
"17-Mar",충남,당진시,338,85101,3691,89130,"2017-03-01",2017
"17-Mar",충남,보령시,340,48047,1268,49655,"2017-03-01",2017
"17-Mar",충남,부여군,233,32219,1379,33831,"2017-03-01",2017
"17-Mar",충남,서산시,374,82282,3460,86116,"2017-03-01",2017
"17-Mar",충남,서천군,201,25882,976,27059,"2017-03-01",2017
"17-Mar",충남,아산시,387,143801,6258,150446,"2017-03-01",2017
"17-Mar",충남,예산군,314,39566,1376,41256,"2017-03-01",2017
"17-Mar",충남,천안시 동남구,244,117006,4825,122075,"2017-03-01",2017
"17-Mar",충남,천안시 서북구,497,162646,5855,168998,"2017-03-01",2017
"17-Mar",충남,청양군,208,15470,990,16668,"2017-03-01",2017
"17-Mar",충남,태안군,215,30948,499,31662,"2017-03-01",2017
"17-Mar",충남,홍성군,372,47615,1355,49342,"2017-03-01",2017
"17-Mar",전북,계,4379,833252,37659,875290,"2017-03-01",2017
"17-Mar",전북,고창군,224,28285,556,29065,"2017-03-01",2017
"17-Mar",전북,군산시,435,121745,6884,129064,"2017-03-01",2017
"17-Mar",전북,김제시,253,42190,1780,44223,"2017-03-01",2017
"17-Mar",전북,남원시,372,37440,3186,40998,"2017-03-01",2017
"17-Mar",전북,무주군,154,11753,366,12273,"2017-03-01",2017
"17-Mar",전북,부안군,238,25980,605,26823,"2017-03-01",2017
"17-Mar",전북,순창군,180,13432,226,13838,"2017-03-01",2017
"17-Mar",전북,완주군,290,48012,3453,51755,"2017-03-01",2017
"17-Mar",전북,익산시,444,130895,6130,137469,"2017-03-01",2017
"17-Mar",전북,임실군,178,13374,405,13957,"2017-03-01",2017
"17-Mar",전북,장수군,187,11117,174,11478,"2017-03-01",2017
"17-Mar",전북,전주시 덕진구,364,140516,7434,148314,"2017-03-01",2017
"17-Mar",전북,전주시 완산구,575,145787,4037,150399,"2017-03-01",2017
"17-Mar",전북,정읍시,282,50004,2234,52520,"2017-03-01",2017
"17-Mar",전북,진안군,203,12722,189,13114,"2017-03-01",2017
"17-Mar",전남,계,5359,850279,106985,962623,"2017-03-01",2017
"17-Mar",전남,강진군,187,17216,1082,18485,"2017-03-01",2017
"17-Mar",전남,고흥군,231,28541,681,29453,"2017-03-01",2017
"17-Mar",전남,곡성군,137,13706,955,14798,"2017-03-01",2017
"17-Mar",전남,광양시,228,73621,5848,79697,"2017-03-01",2017
"17-Mar",전남,구례군,102,12208,645,12955,"2017-03-01",2017
"17-Mar",전남,나주시,371,52733,3109,56213,"2017-03-01",2017
"17-Mar",전남,담양군,187,24216,1508,25911,"2017-03-01",2017
"17-Mar",전남,목포시,433,90771,6092,97296,"2017-03-01",2017
"17-Mar",전남,무안군,463,38738,1044,40245,"2017-03-01",2017
"17-Mar",전남,보성군,211,20087,51397,71695,"2017-03-01",2017
"17-Mar",전남,순천시,438,122818,4869,128125,"2017-03-01",2017
"17-Mar",전남,신안군,192,18980,650,19822,"2017-03-01",2017
"17-Mar",전남,여수시,488,118957,6594,126039,"2017-03-01",2017
"17-Mar",전남,영광군,205,25255,705,26165,"2017-03-01",2017
"17-Mar",전남,영암군,221,30471,16306,46998,"2017-03-01",2017
"17-Mar",전남,완도군,194,22869,475,23538,"2017-03-01",2017
"17-Mar",전남,장성군,135,23428,1214,24777,"2017-03-01",2017
"17-Mar",전남,장흥군,170,18411,438,19019,"2017-03-01",2017
"17-Mar",전남,진도군,131,15154,297,15582,"2017-03-01",2017
"17-Mar",전남,함평군,148,16366,384,16898,"2017-03-01",2017
"17-Mar",전남,해남군,290,36008,575,36873,"2017-03-01",2017
"17-Mar",전남,화순군,197,29725,2117,32039,"2017-03-01",2017
"17-Mar",경북,경주시,510,130093,5169,135772,"2017-03-01",2017
"17-Mar",경북,고령군,142,19829,471,20442,"2017-03-01",2017
"17-Mar",경북,구미시,447,194451,7333,202231,"2017-03-01",2017
"17-Mar",경북,군위군,104,13620,256,13980,"2017-03-01",2017
"17-Mar",경북,김천시,320,67484,1756,69560,"2017-03-01",2017
"17-Mar",경북,문경시,250,33694,775,34719,"2017-03-01",2017
"17-Mar",경북,봉화군,184,16348,205,16737,"2017-03-01",2017
"17-Mar",경북,상주시,343,49073,1816,51232,"2017-03-01",2017
"17-Mar",경북,성주군,173,28003,1483,29659,"2017-03-01",2017
"17-Mar",경북,안동시,528,77650,2561,80739,"2017-03-01",2017
"17-Mar",경북,영덕군,219,17854,312,18385,"2017-03-01",2017
"17-Mar",경북,영양군,128,8734,96,8958,"2017-03-01",2017
"17-Mar",경북,영주시,312,52878,1540,54730,"2017-03-01",2017
"17-Mar",경북,영천시,236,53628,2654,56518,"2017-03-01",2017
"17-Mar",경북,예천군,173,22207,424,22804,"2017-03-01",2017
"17-Mar",경북,울릉군,131,4746,402,5279,"2017-03-01",2017
"17-Mar",경북,울진군,247,24239,368,24854,"2017-03-01",2017
"17-Mar",경북,의성군,275,27906,981,29162,"2017-03-01",2017
"17-Mar",경북,청도군,144,22908,625,23677,"2017-03-01",2017
"17-Mar",경북,청송군,183,14090,204,14477,"2017-03-01",2017
"17-Mar",경북,칠곡군,306,65771,2168,68245,"2017-03-01",2017
"17-Mar",경북,포항시 남구,352,115906,8978,125236,"2017-03-01",2017
"17-Mar",경북,포항시 북구,315,124308,3831,128454,"2017-03-01",2017
"17-Mar",경북,계,6415,1310151,48623,1365189,"2017-03-01",2017
"17-Mar",경남,계,6362,1548977,84061,1639400,"2017-03-01",2017
"17-Mar",경남,거제시,316,102793,2737,105846,"2017-03-01",2017
"17-Mar",경남,거창군,231,29172,788,30191,"2017-03-01",2017
"17-Mar",경남,고성군,200,25253,702,26155,"2017-03-01",2017
"17-Mar",경남,김해시,586,245076,6501,252163,"2017-03-01",2017
"17-Mar",경남,남해군,211,18035,509,18755,"2017-03-01",2017
"17-Mar",경남,밀양시,289,51966,4267,56522,"2017-03-01",2017
"17-Mar",경남,사천시,283,51697,1537,53517,"2017-03-01",2017
"17-Mar",경남,산청군,206,18173,765,19144,"2017-03-01",2017
"17-Mar",경남,양산시,347,138731,8873,147951,"2017-03-01",2017
"17-Mar",경남,의령군,169,12978,787,13934,"2017-03-01",2017
"17-Mar",경남,진주시,550,150014,6856,157420,"2017-03-01",2017
"17-Mar",경남,창녕군,205,32869,762,33836,"2017-03-01",2017
"17-Mar",경남,창원시 마산합포구,315,96566,3064,99945,"2017-03-01",2017
"17-Mar",경남,창원시 마산회원구,164,97601,5429,103194,"2017-03-01",2017
"17-Mar",경남,창원시 성산구,142,121756,19597,141495,"2017-03-01",2017
"17-Mar",경남,창원시 의창구,844,122017,6003,128864,"2017-03-01",2017
"17-Mar",경남,창원시 진해구,190,80139,1591,81920,"2017-03-01",2017
"17-Mar",경남,통영시,299,50956,1399,52654,"2017-03-01",2017
"17-Mar",경남,하동군,203,23183,466,23852,"2017-03-01",2017
"17-Mar",경남,함안군,178,40416,9952,50546,"2017-03-01",2017
"17-Mar",경남,함양군,197,18080,408,18685,"2017-03-01",2017
"17-Mar",경남,합천군,237,21506,1068,22811,"2017-03-01",2017
"17-Mar",제주,계,2058,356467,116364,474889,"2017-03-01",2017
"17-Mar",제주,서귀포시,668,92210,2265,95143,"2017-03-01",2017
"17-Mar",제주,제주시,1390,264257,114099,379746,"2017-03-01",2017
"17-Apr",서울,계,11343,2891549,196364,3099256,"2017-04-01",2017
"17-Apr",서울,강남구,354,220879,19955,241188,"2017-04-01",2017
"17-Apr",서울,강동구,236,130433,8396,139065,"2017-04-01",2017
"17-Apr",서울,강북구,276,72338,4795,77409,"2017-04-01",2017
"17-Apr",서울,강서구,295,182579,15256,198130,"2017-04-01",2017
"17-Apr",서울,관악구,267,116136,5750,122153,"2017-04-01",2017
"17-Apr",서울,광진구,277,91569,5552,97398,"2017-04-01",2017
"17-Apr",서울,구로구,258,129954,11577,141789,"2017-04-01",2017
"17-Apr",서울,금천구,100,78570,6945,85615,"2017-04-01",2017
"17-Apr",서울,노원구,248,146433,9543,156224,"2017-04-01",2017
"17-Apr",서울,도봉구,233,89112,7644,96989,"2017-04-01",2017
"17-Apr",서울,동대문구,276,91592,5667,97535,"2017-04-01",2017
"17-Apr",서울,동작구,286,101542,2761,104589,"2017-04-01",2017
"17-Apr",서울,마포구,309,109434,7341,117084,"2017-04-01",2017
"17-Apr",서울,서대문구,418,79493,5355,85266,"2017-04-01",2017
"17-Apr",서울,서초구,595,168832,10217,179644,"2017-04-01",2017
"17-Apr",서울,성동구,288,91600,9795,101683,"2017-04-01",2017
"17-Apr",서울,성북구,234,111376,5456,117066,"2017-04-01",2017
"17-Apr",서울,송파구,339,215961,11810,228110,"2017-04-01",2017
"17-Apr",서울,양천구,314,141326,8694,150334,"2017-04-01",2017
"17-Apr",서울,영등포구,323,135349,9724,145396,"2017-04-01",2017
"17-Apr",서울,용산구,345,72897,2215,75457,"2017-04-01",2017
"17-Apr",서울,은평구,245,120920,6871,128036,"2017-04-01",2017
"17-Apr",서울,종로구,3634,44511,1604,49749,"2017-04-01",2017
"17-Apr",서울,중구,991,46064,3830,50885,"2017-04-01",2017
"17-Apr",서울,중랑구,202,102649,9611,112462,"2017-04-01",2017
"17-Apr",부산,계,4336,1222264,80846,1307446,"2017-04-01",2017
"17-Apr",부산,강서구,299,61865,3925,66089,"2017-04-01",2017
"17-Apr",부산,금정구,267,79634,7462,87363,"2017-04-01",2017
"17-Apr",부산,기장군,222,66571,2094,68887,"2017-04-01",2017
"17-Apr",부산,남구,205,86600,8774,95579,"2017-04-01",2017
"17-Apr",부산,동구,219,40365,5176,45760,"2017-04-01",2017
"17-Apr",부산,동래구,165,87825,4364,92354,"2017-04-01",2017
"17-Apr",부산,부산진구,363,121567,7210,129140,"2017-04-01",2017
"17-Apr",부산,북구,216,101282,3260,104758,"2017-04-01",2017
"17-Apr",부산,사상구,260,84730,6214,91204,"2017-04-01",2017
"17-Apr",부산,사하구,236,107360,7080,114676,"2017-04-01",2017
"17-Apr",부산,서구,133,27403,1340,28876,"2017-04-01",2017
"17-Apr",부산,수영구,149,64816,3905,68870,"2017-04-01",2017
"17-Apr",부산,연제구,809,85058,5555,91422,"2017-04-01",2017
"17-Apr",부산,영도구,214,31651,2597,34462,"2017-04-01",2017
"17-Apr",부산,중구,308,17803,6501,24612,"2017-04-01",2017
"17-Apr",부산,해운대구,271,157734,5389,163394,"2017-04-01",2017
"17-Apr",대구,계,2875,1089484,48520,1140879,"2017-04-01",2017
"17-Apr",대구,남구,309,56287,2026,58622,"2017-04-01",2017
"17-Apr",대구,달서구,435,253877,12318,266630,"2017-04-01",2017
"17-Apr",대구,달성군,427,108204,3869,112500,"2017-04-01",2017
"17-Apr",대구,동구,300,145894,10419,156613,"2017-04-01",2017
"17-Apr",대구,북구,432,186451,8497,195380,"2017-04-01",2017
"17-Apr",대구,서구,205,75693,4484,80382,"2017-04-01",2017
"17-Apr",대구,수성구,502,206678,5204,212384,"2017-04-01",2017
"17-Apr",대구,중구,265,56400,1703,58368,"2017-04-01",2017
"17-Apr",인천,계,3445,1183804,274324,1461573,"2017-04-01",2017
"17-Apr",인천,강화군,285,30653,2633,33571,"2017-04-01",2017
"17-Apr",인천,계양구,248,121351,137832,259431,"2017-04-01",2017
"17-Apr",인천,남구,362,141944,53584,195890,"2017-04-01",2017
"17-Apr",인천,남동구,790,232494,35703,268987,"2017-04-01",2017
"17-Apr",인천,동구,86,25840,2578,28504,"2017-04-01",2017
"17-Apr",인천,부평구,321,209751,7172,217244,"2017-04-01",2017
"17-Apr",인천,서구,344,207573,10515,218432,"2017-04-01",2017
"17-Apr",인천,연수구,293,151423,7347,159063,"2017-04-01",2017
"17-Apr",인천,옹진군,163,11030,160,11353,"2017-04-01",2017
"17-Apr",인천,중구,553,51745,16800,69098,"2017-04-01",2017
"17-Apr",광주,계,1989,603949,33347,639285,"2017-04-01",2017
"17-Apr",광주,광산구,467,172738,10192,183397,"2017-04-01",2017
"17-Apr",광주,남구,186,82942,2945,86073,"2017-04-01",2017
"17-Apr",광주,동구,219,35640,1066,36925,"2017-04-01",2017
"17-Apr",광주,북구,451,174484,9304,184239,"2017-04-01",2017
"17-Apr",광주,서구,666,138145,9840,148651,"2017-04-01",2017
"17-Apr",대전,계,1780,623562,27863,653205,"2017-04-01",2017
"17-Apr",대전,대덕구,215,85334,6631,92180,"2017-04-01",2017
"17-Apr",대전,동구,220,86812,4119,91151,"2017-04-01",2017
"17-Apr",대전,서구,759,197248,7222,205229,"2017-04-01",2017
"17-Apr",대전,유성구,368,158318,4293,162979,"2017-04-01",2017
"17-Apr",대전,중구,218,95850,5598,101666,"2017-04-01",2017
"17-Apr",울산,계,1609,520304,21390,543303,"2017-04-01",2017
"17-Apr",울산,남구,646,151160,7330,159136,"2017-04-01",2017
"17-Apr",울산,동구,198,62793,945,63936,"2017-04-01",2017
"17-Apr",울산,북구,117,93129,4344,97590,"2017-04-01",2017
"17-Apr",울산,울주군,331,110532,5964,116827,"2017-04-01",2017
"17-Apr",울산,중구,317,102690,2807,105814,"2017-04-01",2017
"17-Apr",세종,계,640,113411,2312,116363,"2017-04-01",2017
"17-Apr",세종,세종특별자치시,640,113411,2312,116363,"2017-04-01",2017
"17-Apr",경기,계,15163,4995336,221532,5232031,"2017-04-01",2017
"17-Apr",경기,가평군,341,27624,703,28668,"2017-04-01",2017
"17-Apr",경기,고양시 덕양구,587,153376,3739,157702,"2017-04-01",2017
"17-Apr",경기,고양시 일산동구,252,113602,7201,121055,"2017-04-01",2017
"17-Apr",경기,고양시 일산서구,115,106562,3185,109862,"2017-04-01",2017
"17-Apr",경기,과천시,684,20247,543,21474,"2017-04-01",2017
"17-Apr",경기,광명시,278,101805,4262,106345,"2017-04-01",2017
"17-Apr",경기,광주시,356,157192,7810,165358,"2017-04-01",2017
"17-Apr",경기,구리시,206,64299,2330,66835,"2017-04-01",2017
"17-Apr",경기,군포시,253,94018,4896,99167,"2017-04-01",2017
"17-Apr",경기,김포시,402,162380,6242,169024,"2017-04-01",2017
"17-Apr",경기,남양주시,566,251843,6866,259275,"2017-04-01",2017
"17-Apr",경기,동두천시,195,35743,1288,37226,"2017-04-01",2017
"17-Apr",경기,부천시,670,284147,11893,296710,"2017-04-01",2017
"17-Apr",경기,성남시 분당구,313,182915,6518,189746,"2017-04-01",2017
"17-Apr",경기,성남시 수정구,300,67179,2391,69870,"2017-04-01",2017
"17-Apr",경기,성남시 중원구,269,71926,3896,76091,"2017-04-01",2017
"17-Apr",경기,수원시 권선구,311,156618,7181,164110,"2017-04-01",2017
"17-Apr",경기,수원시 영통구,192,127062,2744,129998,"2017-04-01",2017
"17-Apr",경기,수원시 장안구,549,104269,4010,108828,"2017-04-01",2017
"17-Apr",경기,수원시 팔달구,460,71636,3383,75479,"2017-04-01",2017
"17-Apr",경기,시흥시,432,184491,7416,192339,"2017-04-01",2017
"17-Apr",경기,안산시 단원구,509,143032,8143,151684,"2017-04-01",2017
"17-Apr",경기,안산시 상록구,155,136832,4674,141661,"2017-04-01",2017
"17-Apr",경기,안성시,329,90746,5099,96174,"2017-04-01",2017
"17-Apr",경기,안양시 동안구,369,118095,6557,125021,"2017-04-01",2017
"17-Apr",경기,안양시 만안구,144,82247,3813,86204,"2017-04-01",2017
"17-Apr",경기,양주시,320,87631,2980,90931,"2017-04-01",2017
"17-Apr",경기,양평군,447,52369,1663,54479,"2017-04-01",2017
"17-Apr",경기,여주시,367,57199,7438,65004,"2017-04-01",2017
"17-Apr",경기,연천군,259,22050,5663,27972,"2017-04-01",2017
"17-Apr",경기,오산시,216,86803,3129,90148,"2017-04-01",2017
"17-Apr",경기,용인시 기흥구,96,164664,8454,173214,"2017-04-01",2017
"17-Apr",경기,용인시 수지구,45,126937,2030,129012,"2017-04-01",2017
"17-Apr",경기,용인시 처인구,611,105924,6727,113262,"2017-04-01",2017
"17-Apr",경기,의왕시,273,56179,2823,59275,"2017-04-01",2017
"17-Apr",경기,의정부시,524,140074,4683,145281,"2017-04-01",2017
"17-Apr",경기,이천시,362,98712,5767,104841,"2017-04-01",2017
"17-Apr",경기,파주시,433,180865,10134,191432,"2017-04-01",2017
"17-Apr",경기,평택시,613,222728,10539,233880,"2017-04-01",2017
"17-Apr",경기,포천시,338,78690,10047,89075,"2017-04-01",2017
"17-Apr",경기,하남시,312,85529,2141,87982,"2017-04-01",2017
"17-Apr",경기,화성시,710,319096,10531,330337,"2017-04-01",2017
"17-Apr",강원,계,5197,700920,24326,730443,"2017-04-01",2017
"17-Apr",강원,강릉시,477,97988,4168,102633,"2017-04-01",2017
"17-Apr",강원,고성군,172,13091,239,13502,"2017-04-01",2017
"17-Apr",강원,동해시,283,41342,1382,43007,"2017-04-01",2017
"17-Apr",강원,삼척시,335,29367,755,30457,"2017-04-01",2017
"17-Apr",강원,속초시,276,33741,1226,35243,"2017-04-01",2017
"17-Apr",강원,양구군,127,11025,125,11277,"2017-04-01",2017
"17-Apr",강원,양양군,160,13595,231,13986,"2017-04-01",2017
"17-Apr",강원,영월군,303,19297,388,19988,"2017-04-01",2017
"17-Apr",강원,원주시,507,150543,5797,156847,"2017-04-01",2017
"17-Apr",강원,인제군,184,16536,205,16925,"2017-04-01",2017
"17-Apr",강원,정선군,297,19160,473,19930,"2017-04-01",2017
"17-Apr",강원,철원군,196,22383,302,22881,"2017-04-01",2017
"17-Apr",강원,춘천시,694,118808,5709,125211,"2017-04-01",2017
"17-Apr",강원,태백시,197,19989,846,21032,"2017-04-01",2017
"17-Apr",강원,평창군,266,23975,416,24657,"2017-04-01",2017
"17-Apr",강원,홍천군,335,35160,1105,36600,"2017-04-01",2017
"17-Apr",강원,화천군,176,11724,134,12034,"2017-04-01",2017
"17-Apr",강원,횡성군,212,23196,825,24233,"2017-04-01",2017
"17-Apr",충북,계,3481,735230,32711,771422,"2017-04-01",2017
"17-Apr",충북,괴산군,173,20495,362,21030,"2017-04-01",2017
"17-Apr",충북,단양군,155,14675,849,15679,"2017-04-01",2017
"17-Apr",충북,보은군,189,16583,947,17719,"2017-04-01",2017
"17-Apr",충북,영동군,203,23722,376,24301,"2017-04-01",2017
"17-Apr",충북,옥천군,187,24481,1042,25710,"2017-04-01",2017
"17-Apr",충북,음성군,202,54041,1730,55973,"2017-04-01",2017
"17-Apr",충북,제천시,309,62071,3329,65709,"2017-04-01",2017
"17-Apr",충북,증평군,81,17324,746,18151,"2017-04-01",2017
"17-Apr",충북,진천군,183,37876,1126,39185,"2017-04-01",2017
"17-Apr",충북,청원군,1,33,1,35,"2017-04-01",2017
"17-Apr",충북,청주시 상당구,406,73459,2586,76451,"2017-04-01",2017
"17-Apr",충북,청주시 서원구,221,90232,6043,96496,"2017-04-01",2017
"17-Apr",충북,청주시 청원구,316,92195,3782,96293,"2017-04-01",2017
"17-Apr",충북,청주시 흥덕구,351,110826,6036,117213,"2017-04-01",2017
"17-Apr",충북,충주시,504,97217,3756,101477,"2017-04-01",2017
"17-Apr",충남,계,4846,988448,38849,1032143,"2017-04-01",2017
"17-Apr",충남,계룡시,132,20028,510,20670,"2017-04-01",2017
"17-Apr",충남,공주시,491,50369,2065,52925,"2017-04-01",2017
"17-Apr",충남,금산군,168,26805,2284,29257,"2017-04-01",2017
"17-Apr",충남,논산시,323,56974,2182,59479,"2017-04-01",2017
"17-Apr",충남,당진시,343,85326,3697,89366,"2017-04-01",2017
"17-Apr",충남,보령시,343,48253,1264,49860,"2017-04-01",2017
"17-Apr",충남,부여군,237,32295,1380,33912,"2017-04-01",2017
"17-Apr",충남,서산시,370,82588,3436,86394,"2017-04-01",2017
"17-Apr",충남,서천군,201,25964,975,27140,"2017-04-01",2017
"17-Apr",충남,아산시,387,144847,6215,151449,"2017-04-01",2017
"17-Apr",충남,예산군,319,39724,1363,41406,"2017-04-01",2017
"17-Apr",충남,천안시 동남구,241,117083,4810,122134,"2017-04-01",2017
"17-Apr",충남,천안시 서북구,492,163754,5818,170064,"2017-04-01",2017
"17-Apr",충남,청양군,212,15502,987,16701,"2017-04-01",2017
"17-Apr",충남,태안군,217,31126,497,31840,"2017-04-01",2017
"17-Apr",충남,홍성군,370,47810,1366,49546,"2017-04-01",2017
"17-Apr",전북,계,4400,835363,37855,877618,"2017-04-01",2017
"17-Apr",전북,고창군,223,28304,557,29084,"2017-04-01",2017
"17-Apr",전북,군산시,438,121953,6880,129271,"2017-04-01",2017
"17-Apr",전북,김제시,253,42322,1770,44345,"2017-04-01",2017
"17-Apr",전북,남원시,372,37569,3166,41107,"2017-04-01",2017
"17-Apr",전북,무주군,156,11759,364,12279,"2017-04-01",2017
"17-Apr",전북,부안군,237,26104,605,26946,"2017-04-01",2017
"17-Apr",전북,순창군,181,13455,226,13862,"2017-04-01",2017
"17-Apr",전북,완주군,300,48191,3446,51937,"2017-04-01",2017
"17-Apr",전북,익산시,443,131143,6123,137709,"2017-04-01",2017
"17-Apr",전북,임실군,180,13398,405,13983,"2017-04-01",2017
"17-Apr",전북,장수군,189,11147,175,11511,"2017-04-01",2017
"17-Apr",전북,전주시 덕진구,362,140853,7424,148639,"2017-04-01",2017
"17-Apr",전북,전주시 완산구,571,146212,4028,150811,"2017-04-01",2017
"17-Apr",전북,정읍시,282,50191,2498,52971,"2017-04-01",2017
"17-Apr",전북,진안군,213,12762,188,13163,"2017-04-01",2017
"17-Apr",전남,계,5380,853463,108644,967487,"2017-04-01",2017
"17-Apr",전남,강진군,189,17213,1077,18479,"2017-04-01",2017
"17-Apr",전남,고흥군,238,28646,681,29565,"2017-04-01",2017
"17-Apr",전남,곡성군,137,13781,938,14856,"2017-04-01",2017
"17-Apr",전남,광양시,227,73713,5853,79793,"2017-04-01",2017
"17-Apr",전남,구례군,105,12221,640,12966,"2017-04-01",2017
"17-Apr",전남,나주시,367,53292,3113,56772,"2017-04-01",2017
"17-Apr",전남,담양군,189,24340,1503,26032,"2017-04-01",2017
"17-Apr",전남,목포시,434,90970,6076,97480,"2017-04-01",2017
"17-Apr",전남,무안군,467,38892,1038,40397,"2017-04-01",2017
"17-Apr",전남,보성군,215,20149,53735,74099,"2017-04-01",2017
"17-Apr",전남,순천시,440,123311,4890,128641,"2017-04-01",2017
"17-Apr",전남,신안군,195,19104,652,19951,"2017-04-01",2017
"17-Apr",전남,여수시,490,119180,6621,126291,"2017-04-01",2017
"17-Apr",전남,영광군,203,25316,704,26223,"2017-04-01",2017
"17-Apr",전남,영암군,219,30515,15760,46494,"2017-04-01",2017
"17-Apr",전남,완도군,193,22964,477,23634,"2017-04-01",2017
"17-Apr",전남,장성군,136,23594,1090,24820,"2017-04-01",2017
"17-Apr",전남,장흥군,173,18514,439,19126,"2017-04-01",2017
"17-Apr",전남,진도군,133,15215,296,15644,"2017-04-01",2017
"17-Apr",전남,함평군,148,16522,383,17053,"2017-04-01",2017
"17-Apr",전남,해남군,286,36150,574,37010,"2017-04-01",2017
"17-Apr",전남,화순군,196,29861,2104,32161,"2017-04-01",2017
"17-Apr",경북,계,6463,1313386,48610,1368459,"2017-04-01",2017
"17-Apr",경북,경산시,399,125202,4217,129818,"2017-04-01",2017
"17-Apr",경북,경주시,518,130380,5127,136025,"2017-04-01",2017
"17-Apr",경북,고령군,146,19861,480,20487,"2017-04-01",2017
"17-Apr",경북,구미시,454,194993,7329,202776,"2017-04-01",2017
"17-Apr",경북,군위군,102,13653,258,14013,"2017-04-01",2017
"17-Apr",경북,김천시,322,67677,1764,69763,"2017-04-01",2017
"17-Apr",경북,문경시,251,33759,772,34782,"2017-04-01",2017
"17-Apr",경북,봉화군,184,16380,206,16770,"2017-04-01",2017
"17-Apr",경북,상주시,343,49146,1814,51303,"2017-04-01",2017
"17-Apr",경북,성주군,170,28106,1460,29736,"2017-04-01",2017
"17-Apr",경북,안동시,531,77854,2545,80930,"2017-04-01",2017
"17-Apr",경북,영덕군,223,17861,314,18398,"2017-04-01",2017
"17-Apr",경북,영양군,130,8769,96,8995,"2017-04-01",2017
"17-Apr",경북,영주시,314,52933,1526,54773,"2017-04-01",2017
"17-Apr",경북,영천시,238,53756,2665,56659,"2017-04-01",2017
"17-Apr",경북,예천군,173,22290,426,22889,"2017-04-01",2017
"17-Apr",경북,울릉군,131,4783,410,5324,"2017-04-01",2017
"17-Apr",경북,울진군,247,24251,365,24863,"2017-04-01",2017
"17-Apr",경북,의성군,281,27963,982,29226,"2017-04-01",2017
"17-Apr",경북,청도군,150,22906,636,23692,"2017-04-01",2017
"17-Apr",경북,청송군,185,14122,205,14512,"2017-04-01",2017
"17-Apr",경북,칠곡군,307,65928,2198,68433,"2017-04-01",2017
"17-Apr",경북,포항시 남구,351,115979,8974,125304,"2017-04-01",2017
"17-Apr",경북,포항시 북구,313,124834,3841,128988,"2017-04-01",2017
"17-Apr",경남,계,6400,1552763,83838,1643001,"2017-04-01",2017
"17-Apr",경남,거제시,317,102933,2716,105966,"2017-04-01",2017
"17-Apr",경남,거창군,237,29261,786,30284,"2017-04-01",2017
"17-Apr",경남,고성군,199,25319,703,26221,"2017-04-01",2017
"17-Apr",경남,김해시,590,245832,6498,252920,"2017-04-01",2017
"17-Apr",경남,남해군,214,18045,511,18770,"2017-04-01",2017
"17-Apr",경남,밀양시,288,52128,4264,56680,"2017-04-01",2017
"17-Apr",경남,사천시,285,51883,1533,53701,"2017-04-01",2017
"17-Apr",경남,산청군,207,18239,748,19194,"2017-04-01",2017
"17-Apr",경남,양산시,345,139708,8875,148928,"2017-04-01",2017
"17-Apr",경남,의령군,169,13028,787,13984,"2017-04-01",2017
"17-Apr",경남,진주시,555,150379,6842,157776,"2017-04-01",2017
"17-Apr",경남,창녕군,204,32978,757,33939,"2017-04-01",2017
"17-Apr",경남,창원시 마산합포구,320,96913,3044,100277,"2017-04-01",2017
"17-Apr",경남,창원시 마산회원구,165,97379,5442,102986,"2017-04-01",2017
"17-Apr",경남,창원시 성산구,143,121783,19548,141474,"2017-04-01",2017
"17-Apr",경남,창원시 의창구,847,122067,5838,128752,"2017-04-01",2017
"17-Apr",경남,창원시 진해구,189,80556,1593,82338,"2017-04-01",2017
"17-Apr",경남,통영시,305,51007,1403,52715,"2017-04-01",2017
"17-Apr",경남,하동군,205,23232,453,23890,"2017-04-01",2017
"17-Apr",경남,함안군,180,40394,10017,50591,"2017-04-01",2017
"17-Apr",경남,함양군,199,18115,407,18721,"2017-04-01",2017
"17-Apr",경남,합천군,237,21584,1073,22894,"2017-04-01",2017
"17-Apr",제주,계,2103,356999,118877,477979,"2017-04-01",2017
"17-Apr",제주,서귀포시,683,92771,2326,95780,"2017-04-01",2017
"17-Apr",제주,제주시,1420,264228,116551,382199,"2017-04-01",2017
"17-May",서울,계,11426,2895370,196561,3103357,"2017-05-01",2017
"17-May",서울,강남구,354,220982,20010,241346,"2017-05-01",2017
"17-May",서울,강동구,231,130796,8340,139367,"2017-05-01",2017
"17-May",서울,강북구,279,72424,4794,77497,"2017-05-01",2017
"17-May",서울,강서구,308,183113,15300,198721,"2017-05-01",2017
"17-May",서울,관악구,271,116351,5679,122301,"2017-05-01",2017
"17-May",서울,광진구,282,91565,5540,97387,"2017-05-01",2017
"17-May",서울,구로구,258,130161,12129,142548,"2017-05-01",2017
"17-May",서울,금천구,102,78783,6893,85778,"2017-05-01",2017
"17-May",서울,노원구,258,146482,9501,156241,"2017-05-01",2017
"17-May",서울,도봉구,241,89273,7608,97122,"2017-05-01",2017
"17-May",서울,동대문구,286,91631,5723,97640,"2017-05-01",2017
"17-May",서울,동작구,286,101656,2757,104699,"2017-05-01",2017
"17-May",서울,마포구,308,109581,7251,117140,"2017-05-01",2017
"17-May",서울,서대문구,427,79609,5343,85379,"2017-05-01",2017
"17-May",서울,서초구,596,168538,10358,179492,"2017-05-01",2017
"17-May",서울,성동구,284,91820,9390,101494,"2017-05-01",2017
"17-May",서울,성북구,239,111481,5447,117167,"2017-05-01",2017
"17-May",서울,송파구,342,216440,11919,228701,"2017-05-01",2017
"17-May",서울,양천구,323,141304,8732,150359,"2017-05-01",2017
"17-May",서울,영등포구,321,135898,9744,145963,"2017-05-01",2017
"17-May",서울,용산구,349,72860,2231,75440,"2017-05-01",2017
"17-May",서울,은평구,245,120928,6867,128040,"2017-05-01",2017
"17-May",서울,종로구,3651,44672,1605,49928,"2017-05-01",2017
"17-May",서울,중구,990,46102,3796,50888,"2017-05-01",2017
"17-May",서울,중랑구,195,102920,9604,112719,"2017-05-01",2017
"17-May",부산,계,4335,1224718,82166,1311219,"2017-05-01",2017
"17-May",부산,강서구,298,62365,3887,66550,"2017-05-01",2017
"17-May",부산,금정구,271,79612,7476,87359,"2017-05-01",2017
"17-May",부산,기장군,219,66734,2093,69046,"2017-05-01",2017
"17-May",부산,남구,203,86736,8829,95768,"2017-05-01",2017
"17-May",부산,동구,219,40604,5140,45963,"2017-05-01",2017
"17-May",부산,동래구,164,87847,4364,92375,"2017-05-01",2017
"17-May",부산,부산진구,361,121693,7666,129720,"2017-05-01",2017
"17-May",부산,북구,214,101215,3267,104696,"2017-05-01",2017
"17-May",부산,사상구,264,84753,6188,91205,"2017-05-01",2017
"17-May",부산,사하구,236,107616,7062,114914,"2017-05-01",2017
"17-May",부산,서구,133,27429,1348,28910,"2017-05-01",2017
"17-May",부산,수영구,147,65015,4777,69939,"2017-05-01",2017
"17-May",부산,연제구,825,85259,5646,91730,"2017-05-01",2017
"17-May",부산,영도구,213,31652,2616,34481,"2017-05-01",2017
"17-May",부산,중구,304,18187,6426,24917,"2017-05-01",2017
"17-May",부산,해운대구,264,158001,5381,163646,"2017-05-01",2017
"17-May",대구,계,2907,1093022,48347,1144276,"2017-05-01",2017
"17-May",대구,남구,307,56267,2017,58591,"2017-05-01",2017
"17-May",대구,달서구,436,256140,12317,268893,"2017-05-01",2017
"17-May",대구,달성군,425,109306,3889,113620,"2017-05-01",2017
"17-May",대구,동구,310,145997,10319,156626,"2017-05-01",2017
"17-May",대구,북구,440,186755,8437,195632,"2017-05-01",2017
"17-May",대구,서구,212,75678,4399,80289,"2017-05-01",2017
"17-May",대구,수성구,508,206706,5191,212405,"2017-05-01",2017
"17-May",대구,중구,269,56173,1778,58220,"2017-05-01",2017
"17-May",인천,계,3429,1185402,277081,1465912,"2017-05-01",2017
"17-May",인천,강화군,285,30765,2611,33661,"2017-05-01",2017
"17-May",인천,계양구,250,121554,139843,261647,"2017-05-01",2017
"17-May",인천,남구,362,142571,53779,196712,"2017-05-01",2017
"17-May",인천,남동구,783,231344,36358,268485,"2017-05-01",2017
"17-May",인천,동구,83,25977,2627,28687,"2017-05-01",2017
"17-May",인천,부평구,319,210302,7181,217802,"2017-05-01",2017
"17-May",인천,서구,344,207737,10461,218542,"2017-05-01",2017
"17-May",인천,연수구,287,152071,7409,159767,"2017-05-01",2017
"17-May",인천,옹진군,165,11119,157,11441,"2017-05-01",2017
"17-May",인천,중구,551,51962,16655,69168,"2017-05-01",2017
"17-May",광주,계,1973,605188,33299,640460,"2017-05-01",2017
"17-May",광주,광산구,457,173129,10241,183827,"2017-05-01",2017
"17-May",광주,남구,181,83192,2959,86332,"2017-05-01",2017
"17-May",광주,동구,218,35690,1078,36986,"2017-05-01",2017
"17-May",광주,북구,451,174814,9219,184484,"2017-05-01",2017
"17-May",광주,서구,666,138363,9802,148831,"2017-05-01",2017
"17-May",대전,계,1782,623997,28036,653815,"2017-05-01",2017
"17-May",대전,대덕구,211,85183,6563,91957,"2017-05-01",2017
"17-May",대전,동구,220,86781,4119,91120,"2017-05-01",2017
"17-May",대전,서구,767,197236,7238,205241,"2017-05-01",2017
"17-May",대전,유성구,369,158953,4503,163825,"2017-05-01",2017
"17-May",대전,중구,215,95844,5613,101672,"2017-05-01",2017
"17-May",울산,계,1618,521127,21409,544154,"2017-05-01",2017
"17-May",울산,남구,653,151168,7331,159152,"2017-05-01",2017
"17-May",울산,동구,194,62894,948,64036,"2017-05-01",2017
"17-May",울산,북구,119,93471,4326,97916,"2017-05-01",2017
"17-May",울산,울주군,333,110792,5979,117104,"2017-05-01",2017
"17-May",울산,중구,319,102802,2825,105946,"2017-05-01",2017
"17-May",세종,계,645,115753,2328,118726,"2017-05-01",2017
"17-May",세종,세종특별자치시,645,115753,2328,118726,"2017-05-01",2017
"17-May",경기,계,15237,5010555,221962,5247754,"2017-05-01",2017
"17-May",경기,가평군,347,27709,707,28763,"2017-05-01",2017
"17-May",경기,고양시 덕양구,586,153764,3795,158145,"2017-05-01",2017
"17-May",경기,고양시 일산동구,255,113931,7207,121393,"2017-05-01",2017
"17-May",경기,고양시 일산서구,115,106841,3186,110142,"2017-05-01",2017
"17-May",경기,과천시,679,20138,546,21363,"2017-05-01",2017
"17-May",경기,광명시,281,101726,4275,106282,"2017-05-01",2017
"17-May",경기,광주시,357,158027,7709,166093,"2017-05-01",2017
"17-May",경기,구리시,209,64475,2338,67022,"2017-05-01",2017
"17-May",경기,군포시,254,94175,4937,99366,"2017-05-01",2017
"17-May",경기,김포시,403,163712,6269,170384,"2017-05-01",2017
"17-May",경기,남양주시,563,252783,6843,260189,"2017-05-01",2017
"17-May",경기,동두천시,195,35777,1276,37248,"2017-05-01",2017
"17-May",경기,부천시,670,284538,11839,297047,"2017-05-01",2017
"17-May",경기,성남시 분당구,316,183237,6674,190227,"2017-05-01",2017
"17-May",경기,성남시 수정구,305,67452,2464,70221,"2017-05-01",2017
"17-May",경기,성남시 중원구,269,71913,3926,76108,"2017-05-01",2017
"17-May",경기,수원시 권선구,312,156920,7181,164413,"2017-05-01",2017
"17-May",경기,수원시 영통구,196,127775,2721,130692,"2017-05-01",2017
"17-May",경기,수원시 장안구,551,104329,4019,108899,"2017-05-01",2017
"17-May",경기,수원시 팔달구,465,71687,3489,75641,"2017-05-01",2017
"17-May",경기,시흥시,440,185066,7364,192870,"2017-05-01",2017
"17-May",경기,안산시 단원구,509,143340,8139,151988,"2017-05-01",2017
"17-May",경기,안산시 상록구,157,137124,4667,141948,"2017-05-01",2017
"17-May",경기,안성시,334,90696,5107,96137,"2017-05-01",2017
"17-May",경기,안양시 동안구,368,117980,6567,124915,"2017-05-01",2017
"17-May",경기,안양시 만안구,145,82603,3824,86572,"2017-05-01",2017
"17-May",경기,양주시,324,88113,2986,91423,"2017-05-01",2017
"17-May",경기,양평군,446,52654,1685,54785,"2017-05-01",2017
"17-May",경기,여주시,370,57373,7492,65235,"2017-05-01",2017
"17-May",경기,연천군,262,22123,5664,28049,"2017-05-01",2017
"17-May",경기,오산시,219,87071,3157,90447,"2017-05-01",2017
"17-May",경기,용인시 기흥구,96,164988,8400,173484,"2017-05-01",2017
"17-May",경기,용인시 수지구,46,127300,2026,129372,"2017-05-01",2017
"17-May",경기,용인시 처인구,635,106393,6726,113754,"2017-05-01",2017
"17-May",경기,의왕시,273,56188,2823,59284,"2017-05-01",2017
"17-May",경기,의정부시,523,140365,4675,145563,"2017-05-01",2017
"17-May",경기,이천시,362,99075,5771,105208,"2017-05-01",2017
"17-May",경기,파주시,447,181482,10090,192019,"2017-05-01",2017
"17-May",경기,평택시,614,223630,10575,234819,"2017-05-01",2017
"17-May",경기,포천시,330,78842,10056,89228,"2017-05-01",2017
"17-May",경기,하남시,315,86147,2142,88604,"2017-05-01",2017
"17-May",경기,화성시,694,321093,10625,332412,"2017-05-01",2017
"17-May",강원,계,5215,702980,24319,732514,"2017-05-01",2017
"17-May",강원,강릉시,474,98225,4172,102871,"2017-05-01",2017
"17-May",강원,고성군,170,13143,238,13551,"2017-05-01",2017
"17-May",강원,동해시,283,41442,1378,43103,"2017-05-01",2017
"17-May",강원,삼척시,335,29465,751,30551,"2017-05-01",2017
"17-May",강원,속초시,275,33823,1243,35341,"2017-05-01",2017
"17-May",강원,양구군,128,11085,125,11338,"2017-05-01",2017
"17-May",강원,양양군,165,13614,233,14012,"2017-05-01",2017
"17-May",강원,영월군,310,19400,387,20097,"2017-05-01",2017
"17-May",강원,원주시,510,151111,5822,157443,"2017-05-01",2017
"17-May",강원,인제군,184,16604,204,16992,"2017-05-01",2017
"17-May",강원,정선군,296,19186,472,19954,"2017-05-01",2017
"17-May",강원,철원군,199,22425,303,22927,"2017-05-01",2017
"17-May",강원,춘천시,695,119088,5680,125463,"2017-05-01",2017
"17-May",강원,태백시,192,20039,842,21073,"2017-05-01",2017
"17-May",강원,평창군,267,24066,413,24746,"2017-05-01",2017
"17-May",강원,홍천군,339,35284,1102,36725,"2017-05-01",2017
"17-May",강원,화천군,179,11755,134,12068,"2017-05-01",2017
"17-May",강원,횡성군,214,23225,820,24259,"2017-05-01",2017
"17-May",충북,계,3517,737071,32732,773320,"2017-05-01",2017
"17-May",충북,괴산군,174,20498,363,21035,"2017-05-01",2017
"17-May",충북,단양군,161,14712,840,15713,"2017-05-01",2017
"17-May",충북,보은군,191,16634,948,17773,"2017-05-01",2017
"17-May",충북,영동군,204,23816,376,24396,"2017-05-01",2017
"17-May",충북,옥천군,190,24517,1040,25747,"2017-05-01",2017
"17-May",충북,음성군,210,54195,1724,56129,"2017-05-01",2017
"17-May",충북,제천시,313,62118,3340,65771,"2017-05-01",2017
"17-May",충북,증평군,83,17398,750,18231,"2017-05-01",2017
"17-May",충북,진천군,185,38134,1131,39450,"2017-05-01",2017
"17-May",충북,청원군,1,33,1,35,"2017-05-01",2017
"17-May",충북,청주시 상당구,408,73547,2602,76557,"2017-05-01",2017
"17-May",충북,청주시 서원구,220,90487,6020,96727,"2017-05-01",2017
"17-May",충북,청주시 청원구,317,92465,3798,96580,"2017-05-01",2017
"17-May",충북,청주시 흥덕구,355,111016,6033,117404,"2017-05-01",2017
"17-May",충북,충주시,505,97501,3766,101772,"2017-05-01",2017
"17-May",충남,계,4869,992039,38908,1035816,"2017-05-01",2017
"17-May",충남,계룡시,136,20047,522,20705,"2017-05-01",2017
"17-May",충남,공주시,487,50407,2056,52950,"2017-05-01",2017
"17-May",충남,금산군,167,26763,2284,29214,"2017-05-01",2017
"17-May",충남,논산시,324,57113,2206,59643,"2017-05-01",2017
"17-May",충남,당진시,351,85625,3715,89691,"2017-05-01",2017
"17-May",충남,보령시,346,48372,1257,49975,"2017-05-01",2017
"17-May",충남,부여군,238,32377,1381,33996,"2017-05-01",2017
"17-May",충남,서산시,371,82928,3430,86729,"2017-05-01",2017
"17-May",충남,서천군,203,26030,965,27198,"2017-05-01",2017
"17-May",충남,아산시,386,145765,6229,152380,"2017-05-01",2017
"17-May",충남,예산군,323,39787,1370,41480,"2017-05-01",2017
"17-May",충남,천안시 동남구,242,117376,4851,122469,"2017-05-01",2017
"17-May",충남,천안시 서북구,491,164712,5804,171007,"2017-05-01",2017
"17-May",충남,청양군,212,15535,982,16729,"2017-05-01",2017
"17-May",충남,태안군,221,31232,495,31948,"2017-05-01",2017
"17-May",충남,홍성군,371,47970,1361,49702,"2017-05-01",2017
"17-May",전북,계,4421,837139,38176,879736,"2017-05-01",2017
"17-May",전북,고창군,224,28318,553,29095,"2017-05-01",2017
"17-May",전북,군산시,440,122154,6924,129518,"2017-05-01",2017
"17-May",전북,김제시,256,42439,1761,44456,"2017-05-01",2017
"17-May",전북,남원시,375,37746,3157,41278,"2017-05-01",2017
"17-May",전북,무주군,157,11774,364,12295,"2017-05-01",2017
"17-May",전북,부안군,238,26132,601,26971,"2017-05-01",2017
"17-May",전북,순창군,181,13475,224,13880,"2017-05-01",2017
"17-May",전북,완주군,303,48356,3438,52097,"2017-05-01",2017
"17-May",전북,익산시,448,131288,6108,137844,"2017-05-01",2017
"17-May",전북,임실군,180,13414,408,14002,"2017-05-01",2017
"17-May",전북,장수군,195,11154,181,11530,"2017-05-01",2017
"17-May",전북,전주시 덕진구,360,141207,7413,148980,"2017-05-01",2017
"17-May",전북,전주시 완산구,571,146534,4038,151143,"2017-05-01",2017
"17-May",전북,정읍시,279,50340,2817,53436,"2017-05-01",2017
"17-May",전북,진안군,214,12808,189,13211,"2017-05-01",2017
"17-May",전남,계,5405,856065,109551,971021,"2017-05-01",2017
"17-May",전남,강진군,189,17260,1085,18534,"2017-05-01",2017
"17-May",전남,고흥군,270,28715,681,29666,"2017-05-01",2017
"17-May",전남,곡성군,137,13830,944,14911,"2017-05-01",2017
"17-May",전남,광양시,229,73923,5834,79986,"2017-05-01",2017
"17-May",전남,구례군,105,12278,639,13022,"2017-05-01",2017
"17-May",전남,나주시,366,53668,3115,57149,"2017-05-01",2017
"17-May",전남,담양군,189,24432,1504,26125,"2017-05-01",2017
"17-May",전남,목포시,433,91031,6060,97524,"2017-05-01",2017
"17-May",전남,무안군,471,39059,1000,40530,"2017-05-01",2017
"17-May",전남,보성군,191,20251,55446,75888,"2017-05-01",2017
"17-May",전남,순천시,439,123764,4876,129079,"2017-05-01",2017
"17-May",전남,신안군,194,19175,654,20023,"2017-05-01",2017
"17-May",전남,여수시,492,119476,6667,126635,"2017-05-01",2017
"17-May",전남,영광군,203,25374,710,26287,"2017-05-01",2017
"17-May",전남,영암군,220,30493,15006,45719,"2017-05-01",2017
"17-May",전남,완도군,191,23025,479,23695,"2017-05-01",2017
"17-May",전남,장성군,140,23663,1077,24880,"2017-05-01",2017
"17-May",전남,장흥군,175,18574,439,19188,"2017-05-01",2017
"17-May",전남,진도군,135,15229,295,15659,"2017-05-01",2017
"17-May",전남,함평군,149,16591,382,17122,"2017-05-01",2017
"17-May",전남,해남군,289,36270,568,37127,"2017-05-01",2017
"17-May",전남,화순군,198,29984,2090,32272,"2017-05-01",2017
"17-May",경북,계,6509,1316270,48596,1371375,"2017-05-01",2017
"17-May",경북,경산시,399,125482,4201,130082,"2017-05-01",2017
"17-May",경북,경주시,513,130664,5124,136301,"2017-05-01",2017
"17-May",경북,고령군,150,19828,477,20455,"2017-05-01",2017
"17-May",경북,구미시,461,195515,7323,203299,"2017-05-01",2017
"17-May",경북,군위군,103,13666,273,14042,"2017-05-01",2017
"17-May",경북,김천시,323,67882,1767,69972,"2017-05-01",2017
"17-May",경북,문경시,252,33865,774,34891,"2017-05-01",2017
"17-May",경북,봉화군,187,16412,197,16796,"2017-05-01",2017
"17-May",경북,상주시,357,49201,1807,51365,"2017-05-01",2017
"17-May",경북,성주군,169,28184,1454,29807,"2017-05-01",2017
"17-May",경북,안동시,538,78009,2542,81089,"2017-05-01",2017
"17-May",경북,영덕군,225,17884,316,18425,"2017-05-01",2017
"17-May",경북,영양군,125,8805,95,9025,"2017-05-01",2017
"17-May",경북,영주시,313,53087,1529,54929,"2017-05-01",2017
"17-May",경북,영천시,240,53930,2668,56838,"2017-05-01",2017
"17-May",경북,예천군,175,22328,426,22929,"2017-05-01",2017
"17-May",경북,울릉군,133,4813,413,5359,"2017-05-01",2017
"17-May",경북,울진군,242,24326,368,24936,"2017-05-01",2017
"17-May",경북,의성군,285,27954,987,29226,"2017-05-01",2017
"17-May",경북,청도군,150,22958,643,23751,"2017-05-01",2017
"17-May",경북,청송군,185,14201,205,14591,"2017-05-01",2017
"17-May",경북,칠곡군,309,66061,2193,68563,"2017-05-01",2017
"17-May",경북,포항시 남구,356,116088,8958,125402,"2017-05-01",2017
"17-May",경북,포항시 북구,319,125127,3856,129302,"2017-05-01",2017
"17-May",경남,계,6430,1555962,83370,1645762,"2017-05-01",2017
"17-May",경남,거제시,321,103124,2686,106131,"2017-05-01",2017
"17-May",경남,거창군,230,29294,783,30307,"2017-05-01",2017
"17-May",경남,고성군,198,25373,711,26282,"2017-05-01",2017
"17-May",경남,김해시,590,246268,6507,253365,"2017-05-01",2017
"17-May",경남,남해군,219,18079,511,18809,"2017-05-01",2017
"17-May",경남,밀양시,289,52240,4242,56771,"2017-05-01",2017
"17-May",경남,사천시,284,51949,1522,53755,"2017-05-01",2017
"17-May",경남,산청군,206,18265,749,19220,"2017-05-01",2017
"17-May",경남,양산시,347,140764,8827,149938,"2017-05-01",2017
"17-May",경남,의령군,172,13061,788,14021,"2017-05-01",2017
"17-May",경남,진주시,561,150711,6832,158104,"2017-05-01",2017
"17-May",경남,창녕군,206,33004,755,33965,"2017-05-01",2017
"17-May",경남,창원시 마산합포구,322,97207,3036,100565,"2017-05-01",2017
"17-May",경남,창원시 마산회원구,165,97087,5459,102711,"2017-05-01",2017
"17-May",경남,창원시 성산구,140,122031,19510,141681,"2017-05-01",2017
"17-May",경남,창원시 의창구,853,122291,5595,128739,"2017-05-01",2017
"17-May",경남,창원시 진해구,190,80855,1588,82633,"2017-05-01",2017
"17-May",경남,통영시,308,51018,1382,52708,"2017-05-01",2017
"17-May",경남,하동군,207,23277,457,23941,"2017-05-01",2017
"17-May",경남,함안군,178,40330,9959,50467,"2017-05-01",2017
"17-May",경남,함양군,206,18133,404,18743,"2017-05-01",2017
"17-May",경남,합천군,238,21601,1067,22906,"2017-05-01",2017
"17-May",제주,계,2132,357443,120129,479704,"2017-05-01",2017
"17-May",제주,서귀포시,701,93187,2266,96154,"2017-05-01",2017
"17-May",제주,제주시,1431,264256,117863,383550,"2017-05-01",2017
"17-Jun",서울,계,11566,2899436,196933,3107935,"2017-06-01",2017
"17-Jun",서울,강남구,361,221163,20287,241811,"2017-06-01",2017
"17-Jun",서울,강동구,237,130893,8293,139423,"2017-06-01",2017
"17-Jun",서울,강북구,290,72617,4800,77707,"2017-06-01",2017
"17-Jun",서울,강서구,313,183967,15685,199965,"2017-06-01",2017
"17-Jun",서울,관악구,280,116365,5685,122330,"2017-06-01",2017
"17-Jun",서울,광진구,285,91776,5517,97578,"2017-06-01",2017
"17-Jun",서울,구로구,256,130302,12089,142647,"2017-06-01",2017
"17-Jun",서울,금천구,104,78968,6765,85837,"2017-06-01",2017
"17-Jun",서울,노원구,259,146353,9480,156092,"2017-06-01",2017
"17-Jun",서울,도봉구,239,89473,7596,97308,"2017-06-01",2017
"17-Jun",서울,동대문구,290,91668,5708,97666,"2017-06-01",2017
"17-Jun",서울,동작구,295,101738,2750,104783,"2017-06-01",2017
"17-Jun",서울,마포구,307,109727,7026,117060,"2017-06-01",2017
"17-Jun",서울,서대문구,437,79846,5340,85623,"2017-06-01",2017
"17-Jun",서울,서초구,597,168552,10332,179481,"2017-06-01",2017
"17-Jun",서울,성동구,278,92170,9503,101951,"2017-06-01",2017
"17-Jun",서울,성북구,263,111566,5433,117262,"2017-06-01",2017
"17-Jun",서울,송파구,340,216841,12110,229291,"2017-06-01",2017
"17-Jun",서울,양천구,332,141494,8715,150541,"2017-06-01",2017
"17-Jun",서울,영등포구,334,136126,9756,146216,"2017-06-01",2017
"17-Jun",서울,용산구,358,72667,2265,75290,"2017-06-01",2017
"17-Jun",서울,은평구,241,120982,6866,128089,"2017-06-01",2017
"17-Jun",서울,종로구,3674,44798,1577,50049,"2017-06-01",2017
"17-Jun",서울,중구,999,46001,3771,50771,"2017-06-01",2017
"17-Jun",서울,중랑구,197,103383,9584,113164,"2017-06-01",2017
"17-Jun",부산,계,4419,1227636,83483,1315538,"2017-06-01",2017
"17-Jun",부산,강서구,299,62873,3877,67049,"2017-06-01",2017
"17-Jun",부산,금정구,271,79662,7439,87372,"2017-06-01",2017
"17-Jun",부산,기장군,220,66902,2092,69214,"2017-06-01",2017
"17-Jun",부산,남구,206,86918,8808,95932,"2017-06-01",2017
"17-Jun",부산,동구,226,40826,5132,46184,"2017-06-01",2017
"17-Jun",부산,동래구,176,87877,4387,92440,"2017-06-01",2017
"17-Jun",부산,부산진구,361,121800,7927,130088,"2017-06-01",2017
"17-Jun",부산,북구,223,101228,3261,104712,"2017-06-01",2017
"17-Jun",부산,사상구,264,84994,6182,91440,"2017-06-01",2017
"17-Jun",부산,사하구,240,107774,7044,115058,"2017-06-01",2017
"17-Jun",부산,서구,135,27387,1350,28872,"2017-06-01",2017
"17-Jun",부산,수영구,150,64989,5832,70971,"2017-06-01",2017
"17-Jun",부산,연제구,857,85686,5740,92283,"2017-06-01",2017
"17-Jun",부산,영도구,215,31722,2625,34562,"2017-06-01",2017
"17-Jun",부산,중구,308,18569,6472,25349,"2017-06-01",2017
"17-Jun",부산,해운대구,268,158429,5315,164012,"2017-06-01",2017
"17-Jun",대구,계,2925,1095987,48259,1147171,"2017-06-01",2017
"17-Jun",대구,남구,309,56226,2082,58617,"2017-06-01",2017
"17-Jun",대구,달서구,440,256501,12335,269276,"2017-06-01",2017
"17-Jun",대구,달성군,432,110230,4054,114716,"2017-06-01",2017
"17-Jun",대구,동구,312,146618,10163,157093,"2017-06-01",2017
"17-Jun",대구,북구,437,187448,8418,196303,"2017-06-01",2017
"17-Jun",대구,서구,213,75782,4414,80409,"2017-06-01",2017
"17-Jun",대구,수성구,515,207127,5026,212668,"2017-06-01",2017
"17-Jun",대구,중구,267,56055,1767,58089,"2017-06-01",2017
"17-Jun",인천,계,3459,1190413,280448,1474320,"2017-06-01",2017
"17-Jun",인천,강화군,289,30858,2586,33733,"2017-06-01",2017
"17-Jun",인천,계양구,249,121772,141916,263937,"2017-06-01",2017
"17-Jun",인천,남구,360,143526,54078,197964,"2017-06-01",2017
"17-Jun",인천,남동구,788,232203,37085,270076,"2017-06-01",2017
"17-Jun",인천,동구,81,26067,2632,28780,"2017-06-01",2017
"17-Jun",인천,부평구,331,211125,7183,218639,"2017-06-01",2017
"17-Jun",인천,서구,339,208594,10593,219526,"2017-06-01",2017
"17-Jun",인천,연수구,287,153064,7400,160751,"2017-06-01",2017
"17-Jun",인천,옹진군,176,11207,158,11541,"2017-06-01",2017
"17-Jun",인천,중구,559,51997,16817,69373,"2017-06-01",2017
"17-Jun",광주,계,1973,607144,33297,642414,"2017-06-01",2017
"17-Jun",광주,광산구,458,173884,10246,184588,"2017-06-01",2017
"17-Jun",광주,남구,179,83463,2899,86541,"2017-06-01",2017
"17-Jun",광주,동구,217,35715,1083,37015,"2017-06-01",2017
"17-Jun",광주,북구,453,175188,9170,184811,"2017-06-01",2017
"17-Jun",광주,서구,666,138894,9899,149459,"2017-06-01",2017
"17-Jun",대전,계,1802,625020,28158,654980,"2017-06-01",2017
"17-Jun",대전,대덕구,211,85147,6575,91933,"2017-06-01",2017
"17-Jun",대전,동구,227,86769,4142,91138,"2017-06-01",2017
"17-Jun",대전,서구,782,197274,7320,205376,"2017-06-01",2017
"17-Jun",대전,유성구,367,159917,4543,164827,"2017-06-01",2017
"17-Jun",대전,중구,215,95913,5578,101706,"2017-06-01",2017
"17-Jun",울산,계,1621,522311,21357,545289,"2017-06-01",2017
"17-Jun",울산,남구,651,151433,7291,159375,"2017-06-01",2017
"17-Jun",울산,동구,193,62891,955,64039,"2017-06-01",2017
"17-Jun",울산,북구,121,93926,4302,98349,"2017-06-01",2017
"17-Jun",울산,울주군,334,111050,5969,117353,"2017-06-01",2017
"17-Jun",울산,중구,322,103011,2840,106173,"2017-06-01",2017
"17-Jun",세종,계,649,117753,2288,120690,"2017-06-01",2017
"17-Jun",세종,세종특별자치시,649,117753,2288,120690,"2017-06-01",2017
"17-Jun",경기,계,15393,5029461,221988,5266842,"2017-06-01",2017
"17-Jun",경기,가평군,351,27836,713,28900,"2017-06-01",2017
"17-Jun",경기,고양시 덕양구,591,154350,3793,158734,"2017-06-01",2017
"17-Jun",경기,고양시 일산동구,262,114316,7184,121762,"2017-06-01",2017
"17-Jun",경기,고양시 일산서구,116,107105,3189,110410,"2017-06-01",2017
"17-Jun",경기,과천시,695,20037,544,21276,"2017-06-01",2017
"17-Jun",경기,광명시,281,101914,4279,106474,"2017-06-01",2017
"17-Jun",경기,광주시,356,158673,7697,166726,"2017-06-01",2017
"17-Jun",경기,구리시,207,64837,2341,67385,"2017-06-01",2017
"17-Jun",경기,군포시,256,94275,4924,99455,"2017-06-01",2017
"17-Jun",경기,김포시,404,165294,6289,171987,"2017-06-01",2017
"17-Jun",경기,남양주시,580,253875,6807,261262,"2017-06-01",2017
"17-Jun",경기,동두천시,197,35757,1277,37231,"2017-06-01",2017
"17-Jun",경기,부천시,676,285050,11897,297623,"2017-06-01",2017
"17-Jun",경기,성남시 분당구,318,183409,6687,190414,"2017-06-01",2017
"17-Jun",경기,성남시 수정구,307,67765,2465,70537,"2017-06-01",2017
"17-Jun",경기,성남시 중원구,272,71972,3936,76180,"2017-06-01",2017
"17-Jun",경기,수원시 권선구,316,157286,7183,164785,"2017-06-01",2017
"17-Jun",경기,수원시 영통구,197,128444,2829,131470,"2017-06-01",2017
"17-Jun",경기,수원시 장안구,572,104582,4022,109176,"2017-06-01",2017
"17-Jun",경기,수원시 팔달구,468,71831,3474,75773,"2017-06-01",2017
"17-Jun",경기,시흥시,448,186055,7372,193875,"2017-06-01",2017
"17-Jun",경기,안산시 단원구,502,143595,8115,152212,"2017-06-01",2017
"17-Jun",경기,안산시 상록구,163,137586,4671,142420,"2017-06-01",2017
"17-Jun",경기,안성시,337,91264,5086,96687,"2017-06-01",2017
"17-Jun",경기,안양시 동안구,368,117854,6542,124764,"2017-06-01",2017
"17-Jun",경기,안양시 만안구,148,82879,3822,86849,"2017-06-01",2017
"17-Jun",경기,양주시,330,88572,2980,91882,"2017-06-01",2017
"17-Jun",경기,양평군,453,52949,1677,55079,"2017-06-01",2017
"17-Jun",경기,여주시,383,57454,7457,65294,"2017-06-01",2017
"17-Jun",경기,연천군,261,22156,5661,28078,"2017-06-01",2017
"17-Jun",경기,오산시,214,87476,3149,90839,"2017-06-01",2017
"17-Jun",경기,용인시 기흥구,97,165352,8764,174213,"2017-06-01",2017
"17-Jun",경기,용인시 수지구,47,127665,2007,129719,"2017-06-01",2017
"17-Jun",경기,용인시 처인구,641,107065,6616,114322,"2017-06-01",2017
"17-Jun",경기,의왕시,276,56293,2811,59380,"2017-06-01",2017
"17-Jun",경기,의정부시,528,140580,4628,145736,"2017-06-01",2017
"17-Jun",경기,이천시,365,99403,5758,105526,"2017-06-01",2017
"17-Jun",경기,파주시,441,182118,10035,192594,"2017-06-01",2017
"17-Jun",경기,평택시,621,224788,10583,235992,"2017-06-01",2017
"17-Jun",경기,포천시,325,79126,9853,89304,"2017-06-01",2017
"17-Jun",경기,하남시,320,86686,2164,89170,"2017-06-01",2017
"17-Jun",경기,화성시,703,323937,10707,335347,"2017-06-01",2017
"17-Jun",강원,계,5217,705222,24314,734753,"2017-06-01",2017
"17-Jun",강원,강릉시,473,98540,4177,103190,"2017-06-01",2017
"17-Jun",강원,고성군,171,13238,240,13649,"2017-06-01",2017
"17-Jun",강원,동해시,280,41504,1384,43168,"2017-06-01",2017
"17-Jun",강원,삼척시,336,29556,731,30623,"2017-06-01",2017
"17-Jun",강원,속초시,273,33959,1250,35482,"2017-06-01",2017
"17-Jun",강원,양구군,131,11152,123,11406,"2017-06-01",2017
"17-Jun",강원,양양군,164,13701,235,14100,"2017-06-01",2017
"17-Jun",강원,영월군,308,19454,393,20155,"2017-06-01",2017
"17-Jun",강원,원주시,507,151637,5821,157965,"2017-06-01",2017
"17-Jun",강원,인제군,187,16671,202,17060,"2017-06-01",2017
"17-Jun",강원,정선군,293,19204,472,19969,"2017-06-01",2017
"17-Jun",강원,철원군,197,22482,300,22979,"2017-06-01",2017
"17-Jun",강원,춘천시,697,119450,5683,125830,"2017-06-01",2017
"17-Jun",강원,태백시,190,20068,840,21098,"2017-06-01",2017
"17-Jun",강원,평창군,273,24110,410,24793,"2017-06-01",2017
"17-Jun",강원,홍천군,341,35436,1102,36879,"2017-06-01",2017
"17-Jun",강원,화천군,180,11791,135,12106,"2017-06-01",2017
"17-Jun",강원,횡성군,216,23269,816,24301,"2017-06-01",2017
"17-Jun",충북,계,3546,739365,32756,775667,"2017-06-01",2017
"17-Jun",충북,괴산군,174,20546,363,21083,"2017-06-01",2017
"17-Jun",충북,단양군,173,14766,844,15783,"2017-06-01",2017
"17-Jun",충북,보은군,191,16641,968,17800,"2017-06-01",2017
"17-Jun",충북,영동군,210,23837,373,24420,"2017-06-01",2017
"17-Jun",충북,옥천군,187,24584,1049,25820,"2017-06-01",2017
"17-Jun",충북,음성군,208,54054,1722,55984,"2017-06-01",2017
"17-Jun",충북,제천시,317,62336,3346,65999,"2017-06-01",2017
"17-Jun",충북,증평군,83,17492,749,18324,"2017-06-01",2017
"17-Jun",충북,진천군,187,38748,1134,40069,"2017-06-01",2017
"17-Jun",충북,청원군,1,33,1,35,"2017-06-01",2017
"17-Jun",충북,청주시 상당구,409,73585,2599,76593,"2017-06-01",2017
"17-Jun",충북,청주시 서원구,220,90591,5969,96780,"2017-06-01",2017
"17-Jun",충북,청주시 청원구,322,92984,3808,97114,"2017-06-01",2017
"17-Jun",충북,청주시 흥덕구,357,111393,6065,117815,"2017-06-01",2017
"17-Jun",충북,충주시,507,97775,3766,102048,"2017-06-01",2017
"17-Jun",충남,계,4929,995792,38793,1039514,"2017-06-01",2017
"17-Jun",충남,계룡시,136,20119,520,20775,"2017-06-01",2017
"17-Jun",충남,공주시,492,50519,2047,53058,"2017-06-01",2017
"17-Jun",충남,금산군,173,26796,2275,29244,"2017-06-01",2017
"17-Jun",충남,논산시,327,57227,2193,59747,"2017-06-01",2017
"17-Jun",충남,당진시,360,85919,3707,89986,"2017-06-01",2017
"17-Jun",충남,보령시,349,48518,1260,50127,"2017-06-01",2017
"17-Jun",충남,부여군,239,32480,1387,34106,"2017-06-01",2017
"17-Jun",충남,서산시,364,83248,3423,87035,"2017-06-01",2017
"17-Jun",충남,서천군,205,26076,968,27249,"2017-06-01",2017
"17-Jun",충남,아산시,400,146595,6235,153230,"2017-06-01",2017
"17-Jun",충남,예산군,326,39867,1376,41569,"2017-06-01",2017
"17-Jun",충남,천안시 동남구,243,117725,4823,122791,"2017-06-01",2017
"17-Jun",충남,천안시 서북구,492,165576,5750,171818,"2017-06-01",2017
"17-Jun",충남,청양군,219,15604,976,16799,"2017-06-01",2017
"17-Jun",충남,태안군,226,31353,492,32071,"2017-06-01",2017
"17-Jun",충남,홍성군,378,48170,1361,49909,"2017-06-01",2017
"17-Jun",전북,계,4444,838727,38308,881479,"2017-06-01",2017
"17-Jun",전북,고창군,227,28399,551,29177,"2017-06-01",2017
"17-Jun",전북,군산시,441,122395,6841,129677,"2017-06-01",2017
"17-Jun",전북,김제시,254,42539,1767,44560,"2017-06-01",2017
"17-Jun",전북,남원시,382,37828,3122,41332,"2017-06-01",2017
"17-Jun",전북,무주군,157,11807,363,12327,"2017-06-01",2017
"17-Jun",전북,부안군,241,26199,602,27042,"2017-06-01",2017
"17-Jun",전북,순창군,178,13491,229,13898,"2017-06-01",2017
"17-Jun",전북,완주군,307,48549,3429,52285,"2017-06-01",2017
"17-Jun",전북,익산시,445,131536,6152,138133,"2017-06-01",2017
"17-Jun",전북,임실군,180,13479,409,14068,"2017-06-01",2017
"17-Jun",전북,장수군,200,11171,181,11552,"2017-06-01",2017
"17-Jun",전북,전주시 덕진구,361,141156,7404,148921,"2017-06-01",2017
"17-Jun",전북,전주시 완산구,577,146817,4055,151449,"2017-06-01",2017
"17-Jun",전북,정읍시,280,50508,3014,53802,"2017-06-01",2017
"17-Jun",전북,진안군,214,12853,189,13256,"2017-06-01",2017
"17-Jun",전남,계,5435,858262,110904,974601,"2017-06-01",2017
"17-Jun",전남,강진군,194,17319,1083,18596,"2017-06-01",2017
"17-Jun",전남,고흥군,270,28747,671,29688,"2017-06-01",2017
"17-Jun",전남,곡성군,138,13834,939,14911,"2017-06-01",2017
"17-Jun",전남,광양시,229,74071,5843,80143,"2017-06-01",2017
"17-Jun",전남,구례군,107,12334,638,13079,"2017-06-01",2017
"17-Jun",전남,나주시,368,54107,3215,57690,"2017-06-01",2017
"17-Jun",전남,담양군,190,24501,1497,26188,"2017-06-01",2017
"17-Jun",전남,목포시,433,91120,6060,97613,"2017-06-01",2017
"17-Jun",전남,무안군,482,39174,1007,40663,"2017-06-01",2017
"17-Jun",전남,보성군,189,20260,57341,77790,"2017-06-01",2017
"17-Jun",전남,순천시,443,124075,4882,129400,"2017-06-01",2017
"17-Jun",전남,신안군,191,19248,649,20088,"2017-06-01",2017
"17-Jun",전남,여수시,500,119727,6662,126889,"2017-06-01",2017
"17-Jun",전남,영광군,205,25430,710,26345,"2017-06-01",2017
"17-Jun",전남,영암군,223,30528,14336,45087,"2017-06-01",2017
"17-Jun",전남,완도군,192,23063,484,23739,"2017-06-01",2017
"17-Jun",전남,장성군,137,23750,1081,24968,"2017-06-01",2017
"17-Jun",전남,장흥군,174,18632,438,19244,"2017-06-01",2017
"17-Jun",전남,진도군,135,15296,298,15729,"2017-06-01",2017
"17-Jun",전남,함평군,154,16635,382,17171,"2017-06-01",2017
"17-Jun",전남,해남군,290,36365,572,37227,"2017-06-01",2017
"17-Jun",전남,화순군,191,30046,2116,32353,"2017-06-01",2017
"17-Jun",경북,계,6566,1319399,48607,1374572,"2017-06-01",2017
"17-Jun",경북,경산시,406,125602,4212,130220,"2017-06-01",2017
"17-Jun",경북,경주시,515,130905,5142,136562,"2017-06-01",2017
"17-Jun",경북,고령군,149,19868,477,20494,"2017-06-01",2017
"17-Jun",경북,구미시,458,196094,7292,203844,"2017-06-01",2017
"17-Jun",경북,군위군,105,13691,273,14069,"2017-06-01",2017
"17-Jun",경북,김천시,323,68166,1766,70255,"2017-06-01",2017
"17-Jun",경북,문경시,255,33972,770,34997,"2017-06-01",2017
"17-Jun",경북,봉화군,191,16442,197,16830,"2017-06-01",2017
"17-Jun",경북,상주시,368,49291,1808,51467,"2017-06-01",2017
"17-Jun",경북,성주군,171,28259,1457,29887,"2017-06-01",2017
"17-Jun",경북,안동시,531,78252,2561,81344,"2017-06-01",2017
"17-Jun",경북,영덕군,230,17940,316,18486,"2017-06-01",2017
"17-Jun",경북,영양군,131,8813,95,9039,"2017-06-01",2017
"17-Jun",경북,영주시,312,53179,1530,55021,"2017-06-01",2017
"17-Jun",경북,영천시,245,54051,2672,56968,"2017-06-01",2017
"17-Jun",경북,예천군,176,22375,429,22980,"2017-06-01",2017
"17-Jun",경북,울릉군,133,4844,413,5390,"2017-06-01",2017
"17-Jun",경북,울진군,242,24418,358,25018,"2017-06-01",2017
"17-Jun",경북,의성군,289,27995,985,29269,"2017-06-01",2017
"17-Jun",경북,청도군,161,23018,653,23832,"2017-06-01",2017
"17-Jun",경북,청송군,192,14220,201,14613,"2017-06-01",2017
"17-Jun",경북,칠곡군,304,66179,2209,68692,"2017-06-01",2017
"17-Jun",경북,포항시 남구,357,116333,8929,125619,"2017-06-01",2017
"17-Jun",경북,포항시 북구,322,125492,3862,129676,"2017-06-01",2017
"17-Jun",경남,계,6511,1560027,83397,1649935,"2017-06-01",2017
"17-Jun",경남,거제시,323,103009,2634,105966,"2017-06-01",2017
"17-Jun",경남,거창군,231,29355,780,30366,"2017-06-01",2017
"17-Jun",경남,고성군,197,25380,710,26287,"2017-06-01",2017
"17-Jun",경남,김해시,600,247214,6534,254348,"2017-06-01",2017
"17-Jun",경남,남해군,221,18125,509,18855,"2017-06-01",2017
"17-Jun",경남,밀양시,292,52266,4246,56804,"2017-06-01",2017
"17-Jun",경남,사천시,288,52071,1524,53883,"2017-06-01",2017
"17-Jun",경남,산청군,207,18331,757,19295,"2017-06-01",2017
"17-Jun",경남,양산시,356,142046,8869,151271,"2017-06-01",2017
"17-Jun",경남,의령군,176,13071,785,14032,"2017-06-01",2017
"17-Jun",경남,진주시,560,151205,6771,158536,"2017-06-01",2017
"17-Jun",경남,창녕군,208,33114,825,34147,"2017-06-01",2017
"17-Jun",경남,창원시 마산합포구,333,97664,3034,101031,"2017-06-01",2017
"17-Jun",경남,창원시 마산회원구,166,96851,5437,102454,"2017-06-01",2017
"17-Jun",경남,창원시 성산구,142,122385,19473,142000,"2017-06-01",2017
"17-Jun",경남,창원시 의창구,873,122470,5663,129006,"2017-06-01",2017
"17-Jun",경남,창원시 진해구,191,80975,1581,82747,"2017-06-01",2017
"17-Jun",경남,통영시,310,51010,1390,52710,"2017-06-01",2017
"17-Jun",경남,하동군,203,23298,459,23960,"2017-06-01",2017
"17-Jun",경남,함안군,180,40348,9948,50476,"2017-06-01",2017
"17-Jun",경남,함양군,212,18159,404,18775,"2017-06-01",2017
"17-Jun",경남,합천군,242,21680,1064,22986,"2017-06-01",2017
"17-Jun",제주,계,2119,357828,122918,482865,"2017-06-01",2017
"17-Jun",제주,서귀포시,701,93588,2255,96544,"2017-06-01",2017
"17-Jun",제주,제주시,1418,264240,120663,386321,"2017-06-01",2017
"17-Jul",서울,계,11702,2902138,198280,3112120,"2017-07-01",2017
"17-Jul",서울,강남구,366,221101,20338,241805,"2017-07-01",2017
"17-Jul",서울,강동구,241,130652,8282,139175,"2017-07-01",2017
"17-Jul",서울,강북구,292,72607,4792,77691,"2017-07-01",2017
"17-Jul",서울,강서구,320,184089,15801,200210,"2017-07-01",2017
"17-Jul",서울,관악구,288,116348,5590,122226,"2017-07-01",2017
"17-Jul",서울,광진구,288,92023,5446,97757,"2017-07-01",2017
"17-Jul",서울,구로구,262,130475,12725,143462,"2017-07-01",2017
"17-Jul",서울,금천구,103,79104,6750,85957,"2017-07-01",2017
"17-Jul",서울,노원구,267,146203,9533,156003,"2017-07-01",2017
"17-Jul",서울,도봉구,236,89547,7561,97344,"2017-07-01",2017
"17-Jul",서울,동대문구,299,91714,5721,97734,"2017-07-01",2017
"17-Jul",서울,동작구,299,101882,2841,105022,"2017-07-01",2017
"17-Jul",서울,마포구,321,109826,7002,117149,"2017-07-01",2017
"17-Jul",서울,서대문구,420,79982,5337,85739,"2017-07-01",2017
"17-Jul",서울,서초구,605,169006,10330,179941,"2017-07-01",2017
"17-Jul",서울,성동구,285,92311,9984,102580,"2017-07-01",2017
"17-Jul",서울,성북구,271,111740,5349,117360,"2017-07-01",2017
"17-Jul",서울,송파구,341,217038,12386,229765,"2017-07-01",2017
"17-Jul",서울,양천구,329,141596,8707,150632,"2017-07-01",2017
"17-Jul",서울,영등포구,337,136417,9754,146508,"2017-07-01",2017
"17-Jul",서울,용산구,356,72603,2275,75234,"2017-07-01",2017
"17-Jul",서울,은평구,245,121087,6860,128192,"2017-07-01",2017
"17-Jul",서울,종로구,3726,44998,1583,50307,"2017-07-01",2017
"17-Jul",서울,중구,1002,46029,3725,50756,"2017-07-01",2017
"17-Jul",서울,중랑구,203,103760,9608,113571,"2017-07-01",2017
"17-Jul",부산,계,4449,1230213,84390,1319052,"2017-07-01",2017
"17-Jul",부산,강서구,305,63312,3722,67339,"2017-07-01",2017
"17-Jul",부산,금정구,268,79774,7446,87488,"2017-07-01",2017
"17-Jul",부산,기장군,224,67086,2095,69405,"2017-07-01",2017
"17-Jul",부산,남구,204,87073,8785,96062,"2017-07-01",2017
"17-Jul",부산,동구,226,41015,5200,46441,"2017-07-01",2017
"17-Jul",부산,동래구,175,87984,4364,92523,"2017-07-01",2017
"17-Jul",부산,부산진구,363,121934,8065,130362,"2017-07-01",2017
"17-Jul",부산,북구,226,101258,3261,104745,"2017-07-01",2017
"17-Jul",부산,사상구,264,85168,6190,91622,"2017-07-01",2017
"17-Jul",부산,사하구,242,108037,7026,115305,"2017-07-01",2017
"17-Jul",부산,서구,136,27450,1351,28937,"2017-07-01",2017
"17-Jul",부산,수영구,153,65022,6846,72021,"2017-07-01",2017
"17-Jul",부산,연제구,858,86006,5650,92514,"2017-07-01",2017
"17-Jul",부산,영도구,220,31771,2620,34611,"2017-07-01",2017
"17-Jul",부산,중구,314,18844,6478,25636,"2017-07-01",2017
"17-Jul",부산,해운대구,271,158479,5291,164041,"2017-07-01",2017
"17-Jul",대구,계,2913,1098130,48173,1149216,"2017-07-01",2017
"17-Jul",대구,남구,306,56306,2072,58684,"2017-07-01",2017
"17-Jul",대구,달서구,441,256853,12252,269546,"2017-07-01",2017
"17-Jul",대구,달성군,433,111065,4076,115574,"2017-07-01",2017
"17-Jul",대구,동구,307,146817,10168,157292,"2017-07-01",2017
"17-Jul",대구,북구,433,187991,8336,196760,"2017-07-01",2017
"17-Jul",대구,서구,210,75686,4395,80291,"2017-07-01",2017
"17-Jul",대구,수성구,517,207258,5133,212908,"2017-07-01",2017
"17-Jul",대구,중구,266,56154,1741,58161,"2017-07-01",2017
"17-Jul",인천,계,3519,1194501,284485,1482505,"2017-07-01",2017
"17-Jul",인천,강화군,291,30979,2565,33835,"2017-07-01",2017
"17-Jul",인천,계양구,251,122110,144299,266660,"2017-07-01",2017
"17-Jul",인천,남구,364,144596,54757,199717,"2017-07-01",2017
"17-Jul",인천,남동구,833,232966,38008,271807,"2017-07-01",2017
"17-Jul",인천,동구,82,26077,2628,28787,"2017-07-01",2017
"17-Jul",인천,부평구,331,211817,7352,219500,"2017-07-01",2017
"17-Jul",인천,서구,342,208875,10593,219810,"2017-07-01",2017
"17-Jul",인천,연수구,287,153687,7317,161291,"2017-07-01",2017
"17-Jul",인천,옹진군,174,11271,146,11591,"2017-07-01",2017
"17-Jul",인천,중구,564,52123,16820,69507,"2017-07-01",2017
"17-Jul",광주,계,1980,608544,33232,643756,"2017-07-01",2017
"17-Jul",광주,광산구,466,174411,10196,185073,"2017-07-01",2017
"17-Jul",광주,남구,178,83593,2886,86657,"2017-07-01",2017
"17-Jul",광주,동구,214,35773,1072,37059,"2017-07-01",2017
"17-Jul",광주,북구,459,175796,9189,185444,"2017-07-01",2017
"17-Jul",광주,서구,663,138971,9889,149523,"2017-07-01",2017
"17-Jul",대전,계,1837,626054,28298,656189,"2017-07-01",2017
"17-Jul",대전,대덕구,215,85008,6717,91940,"2017-07-01",2017
"17-Jul",대전,동구,232,86964,4139,91335,"2017-07-01",2017
"17-Jul",대전,서구,788,197441,7236,205465,"2017-07-01",2017
"17-Jul",대전,유성구,372,160540,4566,165478,"2017-07-01",2017
"17-Jul",대전,중구,230,96101,5640,101971,"2017-07-01",2017
"17-Jul",울산,계,1618,523323,21226,546167,"2017-07-01",2017
"17-Jul",울산,남구,654,151684,7332,159670,"2017-07-01",2017
"17-Jul",울산,동구,195,62970,959,64124,"2017-07-01",2017
"17-Jul",울산,북구,122,94161,4137,98420,"2017-07-01",2017
"17-Jul",울산,울주군,324,111199,5985,117508,"2017-07-01",2017
"17-Jul",울산,중구,323,103309,2813,106445,"2017-07-01",2017
"17-Jul",세종,계,655,119262,2295,122212,"2017-07-01",2017
"17-Jul",세종,세종특별자치시,655,119262,2295,122212,"2017-07-01",2017
"17-Jul",경기,계,15488,5048770,222382,5286640,"2017-07-01",2017
"17-Jul",경기,가평군,349,28014,707,29070,"2017-07-01",2017
"17-Jul",경기,고양시 덕양구,607,154826,3771,159204,"2017-07-01",2017
"17-Jul",경기,고양시 일산동구,256,114600,7267,122123,"2017-07-01",2017
"17-Jul",경기,고양시 일산서구,116,107138,3105,110359,"2017-07-01",2017
"17-Jul",경기,과천시,695,20000,545,21240,"2017-07-01",2017
"17-Jul",경기,광명시,280,101980,4244,106504,"2017-07-01",2017
"17-Jul",경기,광주시,360,159213,7715,167288,"2017-07-01",2017
"17-Jul",경기,구리시,212,64884,2338,67434,"2017-07-01",2017
"17-Jul",경기,군포시,256,94435,4933,99624,"2017-07-01",2017
"17-Jul",경기,김포시,411,167167,6331,173909,"2017-07-01",2017
"17-Jul",경기,남양주시,585,255096,6808,262489,"2017-07-01",2017
"17-Jul",경기,동두천시,196,35864,1267,37327,"2017-07-01",2017
"17-Jul",경기,부천시,691,285345,12064,298100,"2017-07-01",2017
"17-Jul",경기,성남시 분당구,320,183380,6825,190525,"2017-07-01",2017
"17-Jul",경기,성남시 수정구,317,68157,2476,70950,"2017-07-01",2017
"17-Jul",경기,성남시 중원구,274,72023,3912,76209,"2017-07-01",2017
"17-Jul",경기,수원시 권선구,312,158067,7312,165691,"2017-07-01",2017
"17-Jul",경기,수원시 영통구,202,128794,2809,131805,"2017-07-01",2017
"17-Jul",경기,수원시 장안구,577,104795,4005,109377,"2017-07-01",2017
"17-Jul",경기,수원시 팔달구,475,71964,3469,75908,"2017-07-01",2017
"17-Jul",경기,시흥시,449,187145,7367,194961,"2017-07-01",2017
"17-Jul",경기,안산시 단원구,505,144002,8329,152836,"2017-07-01",2017
"17-Jul",경기,안산시 상록구,164,138083,4660,142907,"2017-07-01",2017
"17-Jul",경기,안성시,334,91799,5059,97192,"2017-07-01",2017
"17-Jul",경기,안양시 동안구,367,117768,6542,124677,"2017-07-01",2017
"17-Jul",경기,안양시 만안구,151,83072,3842,87065,"2017-07-01",2017
"17-Jul",경기,양주시,329,89298,2992,92619,"2017-07-01",2017
"17-Jul",경기,양평군,455,53254,1701,55410,"2017-07-01",2017
"17-Jul",경기,여주시,387,57589,7413,65389,"2017-07-01",2017
"17-Jul",경기,연천군,260,22195,5655,28110,"2017-07-01",2017
"17-Jul",경기,오산시,216,87966,3174,91356,"2017-07-01",2017
"17-Jul",경기,용인시 기흥구,99,166213,8770,175082,"2017-07-01",2017
"17-Jul",경기,용인시 수지구,46,127925,2010,129981,"2017-07-01",2017
"17-Jul",경기,용인시 처인구,644,107652,6615,114911,"2017-07-01",2017
"17-Jul",경기,의왕시,276,56489,2784,59549,"2017-07-01",2017
"17-Jul",경기,의정부시,531,141002,4617,146150,"2017-07-01",2017
"17-Jul",경기,이천시,363,99721,5753,105837,"2017-07-01",2017
"17-Jul",경기,파주시,454,182822,10045,193321,"2017-07-01",2017
"17-Jul",경기,평택시,622,225921,10674,237217,"2017-07-01",2017
"17-Jul",경기,포천시,326,79394,9661,89381,"2017-07-01",2017
"17-Jul",경기,하남시,323,87287,2172,89782,"2017-07-01",2017
"17-Jul",경기,화성시,696,326431,10644,337771,"2017-07-01",2017
"17-Jul",강원,계,5279,707268,24391,736938,"2017-07-01",2017
"17-Jul",강원,강릉시,475,98756,4171,103402,"2017-07-01",2017
"17-Jul",강원,고성군,174,13266,240,13680,"2017-07-01",2017
"17-Jul",강원,동해시,282,41645,1388,43315,"2017-07-01",2017
"17-Jul",강원,삼척시,348,29619,738,30705,"2017-07-01",2017
"17-Jul",강원,속초시,280,34037,1256,35573,"2017-07-01",2017
"17-Jul",강원,양구군,136,11192,123,11451,"2017-07-01",2017
"17-Jul",강원,양양군,161,13767,236,14164,"2017-07-01",2017
"17-Jul",강원,영월군,307,19526,399,20232,"2017-07-01",2017
"17-Jul",강원,원주시,516,152134,5811,158461,"2017-07-01",2017
"17-Jul",강원,인제군,190,16737,217,17144,"2017-07-01",2017
"17-Jul",강원,정선군,294,19265,477,20036,"2017-07-01",2017
"17-Jul",강원,철원군,195,22530,299,23024,"2017-07-01",2017
"17-Jul",강원,춘천시,712,119789,5719,126220,"2017-07-01",2017
"17-Jul",강원,태백시,192,20071,841,21104,"2017-07-01",2017
"17-Jul",강원,평창군,279,24187,412,24878,"2017-07-01",2017
"17-Jul",강원,홍천군,338,35585,1102,37025,"2017-07-01",2017
"17-Jul",강원,화천군,186,11821,136,12143,"2017-07-01",2017
"17-Jul",강원,횡성군,214,23341,826,24381,"2017-07-01",2017
"17-Jul",충북,계,3584,741142,32684,777410,"2017-07-01",2017
"17-Jul",충북,괴산군,175,20565,362,21102,"2017-07-01",2017
"17-Jul",충북,단양군,196,14796,840,15832,"2017-07-01",2017
"17-Jul",충북,보은군,192,16646,981,17819,"2017-07-01",2017
"17-Jul",충북,영동군,214,23890,376,24480,"2017-07-01",2017
"17-Jul",충북,옥천군,188,24638,1047,25873,"2017-07-01",2017
"17-Jul",충북,음성군,212,54172,1715,56099,"2017-07-01",2017
"17-Jul",충북,제천시,301,62483,3353,66137,"2017-07-01",2017
"17-Jul",충북,증평군,83,17562,754,18399,"2017-07-01",2017
"17-Jul",충북,진천군,191,39177,1144,40512,"2017-07-01",2017
"17-Jul",충북,청원군,1,32,1,34,"2017-07-01",2017
"17-Jul",충북,청주시 상당구,410,73508,2603,76521,"2017-07-01",2017
"17-Jul",충북,청주시 서원구,224,90687,5958,96869,"2017-07-01",2017
"17-Jul",충북,청주시 청원구,324,93215,3809,97348,"2017-07-01",2017
"17-Jul",충북,청주시 흥덕구,364,111611,5969,117944,"2017-07-01",2017
"17-Jul",충북,충주시,509,98160,3772,102441,"2017-07-01",2017
"17-Jul",충남,계,4998,999225,38755,1042978,"2017-07-01",2017
"17-Jul",충남,계룡시,135,20243,520,20898,"2017-07-01",2017
"17-Jul",충남,공주시,495,50626,2045,53166,"2017-07-01",2017
"17-Jul",충남,금산군,178,26802,2250,29230,"2017-07-01",2017
"17-Jul",충남,논산시,331,57443,2204,59978,"2017-07-01",2017
"17-Jul",충남,당진시,362,86152,3713,90227,"2017-07-01",2017
"17-Jul",충남,보령시,354,48647,1295,50296,"2017-07-01",2017
"17-Jul",충남,부여군,239,32589,1369,34197,"2017-07-01",2017
"17-Jul",충남,서산시,370,83478,3428,87276,"2017-07-01",2017
"17-Jul",충남,서천군,208,26093,970,27271,"2017-07-01",2017
"17-Jul",충남,아산시,409,147424,6228,154061,"2017-07-01",2017
"17-Jul",충남,예산군,330,39953,1373,41656,"2017-07-01",2017
"17-Jul",충남,천안시 동남구,254,117974,4811,123039,"2017-07-01",2017
"17-Jul",충남,천안시 서북구,497,166332,5728,172557,"2017-07-01",2017
"17-Jul",충남,청양군,221,15636,977,16834,"2017-07-01",2017
"17-Jul",충남,태안군,229,31486,483,32198,"2017-07-01",2017
"17-Jul",충남,홍성군,386,48347,1361,50094,"2017-07-01",2017
"17-Jul",전북,계,4526,840446,38339,883311,"2017-07-01",2017
"17-Jul",전북,고창군,228,28480,552,29260,"2017-07-01",2017
"17-Jul",전북,군산시,447,122544,6809,129800,"2017-07-01",2017
"17-Jul",전북,김제시,262,42562,1746,44570,"2017-07-01",2017
"17-Jul",전북,남원시,396,37929,3103,41428,"2017-07-01",2017
"17-Jul",전북,무주군,160,11820,365,12345,"2017-07-01",2017
"17-Jul",전북,부안군,247,26291,600,27138,"2017-07-01",2017
"17-Jul",전북,순창군,179,13542,232,13953,"2017-07-01",2017
"17-Jul",전북,완주군,306,48644,3417,52367,"2017-07-01",2017
"17-Jul",전북,익산시,449,131667,6133,138249,"2017-07-01",2017
"17-Jul",전북,임실군,188,13457,407,14052,"2017-07-01",2017
"17-Jul",전북,장수군,210,11213,180,11603,"2017-07-01",2017
"17-Jul",전북,전주시 덕진구,362,141550,7408,149320,"2017-07-01",2017
"17-Jul",전북,전주시 완산구,589,147195,4061,151845,"2017-07-01",2017
"17-Jul",전북,정읍시,285,50643,3133,54061,"2017-07-01",2017
"17-Jul",전북,진안군,218,12909,193,13320,"2017-07-01",2017
"17-Jul",전남,계,5461,860574,112449,978484,"2017-07-01",2017
"17-Jul",전남,강진군,196,17330,1084,18610,"2017-07-01",2017
"17-Jul",전남,고흥군,265,28788,668,29721,"2017-07-01",2017
"17-Jul",전남,곡성군,140,13841,929,14910,"2017-07-01",2017
"17-Jul",전남,광양시,228,74221,5848,80297,"2017-07-01",2017
"17-Jul",전남,구례군,107,12365,639,13111,"2017-07-01",2017
"17-Jul",전남,나주시,377,54508,3234,58119,"2017-07-01",2017
"17-Jul",전남,담양군,184,24519,1509,26212,"2017-07-01",2017
"17-Jul",전남,목포시,435,91158,6061,97654,"2017-07-01",2017
"17-Jul",전남,무안군,475,39376,1016,40867,"2017-07-01",2017
"17-Jul",전남,보성군,189,20329,59268,79786,"2017-07-01",2017
"17-Jul",전남,순천시,441,124395,4881,129717,"2017-07-01",2017
"17-Jul",전남,신안군,190,19330,645,20165,"2017-07-01",2017
"17-Jul",전남,여수시,504,120141,6648,127293,"2017-07-01",2017
"17-Jul",전남,영광군,205,25531,714,26450,"2017-07-01",2017
"17-Jul",전남,영암군,228,30548,13966,44742,"2017-07-01",2017
"17-Jul",전남,완도군,206,23142,482,23830,"2017-07-01",2017
"17-Jul",전남,장성군,137,23831,1068,25036,"2017-07-01",2017
"17-Jul",전남,장흥군,175,18666,437,19278,"2017-07-01",2017
"17-Jul",전남,진도군,135,15332,300,15767,"2017-07-01",2017
"17-Jul",전남,함평군,157,16703,376,17236,"2017-07-01",2017
"17-Jul",전남,해남군,288,36424,566,37278,"2017-07-01",2017
"17-Jul",전남,화순군,199,30096,2110,32405,"2017-07-01",2017
"17-Jul",경북,계,6660,1322718,48543,1377921,"2017-07-01",2017
"17-Jul",경북,경산시,404,126027,4210,130641,"2017-07-01",2017
"17-Jul",경북,경주시,528,131352,5144,137024,"2017-07-01",2017
"17-Jul",경북,고령군,150,19897,475,20522,"2017-07-01",2017
"17-Jul",경북,구미시,468,196675,7311,204454,"2017-07-01",2017
"17-Jul",경북,군위군,104,13723,270,14097,"2017-07-01",2017
"17-Jul",경북,김천시,330,68346,1756,70432,"2017-07-01",2017
"17-Jul",경북,문경시,265,34034,769,35068,"2017-07-01",2017
"17-Jul",경북,봉화군,192,16481,198,16871,"2017-07-01",2017
"17-Jul",경북,상주시,373,49436,1806,51615,"2017-07-01",2017
"17-Jul",경북,성주군,176,28320,1457,29953,"2017-07-01",2017
"17-Jul",경북,안동시,540,78266,2533,81339,"2017-07-01",2017
"17-Jul",경북,영덕군,230,17986,308,18524,"2017-07-01",2017
"17-Jul",경북,영양군,132,8836,92,9060,"2017-07-01",2017
"17-Jul",경북,영주시,315,53183,1527,55025,"2017-07-01",2017
"17-Jul",경북,영천시,249,54144,2677,57070,"2017-07-01",2017
"17-Jul",경북,예천군,179,22697,425,23301,"2017-07-01",2017
"17-Jul",경북,울릉군,138,4881,406,5425,"2017-07-01",2017
"17-Jul",경북,울진군,246,24486,353,25085,"2017-07-01",2017
"17-Jul",경북,의성군,296,28085,983,29364,"2017-07-01",2017
"17-Jul",경북,청도군,160,23078,654,23892,"2017-07-01",2017
"17-Jul",경북,청송군,195,14261,200,14656,"2017-07-01",2017
"17-Jul",경북,칠곡군,306,66234,2223,68763,"2017-07-01",2017
"17-Jul",경북,포항시 남구,361,116459,8928,125748,"2017-07-01",2017
"17-Jul",경북,포항시 북구,323,125831,3838,129992,"2017-07-01",2017
"17-Jul",경남,계,6541,1563264,83206,1653011,"2017-07-01",2017
"17-Jul",경남,거제시,320,103019,2536,105875,"2017-07-01",2017
"17-Jul",경남,거창군,233,29443,778,30454,"2017-07-01",2017
"17-Jul",경남,고성군,203,25401,701,26305,"2017-07-01",2017
"17-Jul",경남,김해시,601,247913,6554,255068,"2017-07-01",2017
"17-Jul",경남,남해군,220,18162,508,18890,"2017-07-01",2017
"17-Jul",경남,밀양시,293,52405,4160,56858,"2017-07-01",2017
"17-Jul",경남,사천시,294,52224,1508,54026,"2017-07-01",2017
"17-Jul",경남,산청군,205,18378,756,19339,"2017-07-01",2017
"17-Jul",경남,양산시,359,143415,9129,152903,"2017-07-01",2017
"17-Jul",경남,의령군,176,13095,786,14057,"2017-07-01",2017
"17-Jul",경남,진주시,564,151513,6710,158787,"2017-07-01",2017
"17-Jul",경남,창녕군,211,33245,853,34309,"2017-07-01",2017
"17-Jul",경남,창원시 마산합포구,331,97663,3040,101034,"2017-07-01",2017
"17-Jul",경남,창원시 마산회원구,166,96633,5413,102212,"2017-07-01",2017
"17-Jul",경남,창원시 성산구,141,122126,19424,141691,"2017-07-01",2017
"17-Jul",경남,창원시 의창구,870,122809,5665,129344,"2017-07-01",2017
"17-Jul",경남,창원시 진해구,192,81111,1578,82881,"2017-07-01",2017
"17-Jul",경남,통영시,311,51117,1405,52833,"2017-07-01",2017
"17-Jul",경남,하동군,207,23291,457,23955,"2017-07-01",2017
"17-Jul",경남,함안군,181,40353,9992,50526,"2017-07-01",2017
"17-Jul",경남,함양군,214,18249,404,18867,"2017-07-01",2017
"17-Jul",경남,합천군,249,21699,849,22797,"2017-07-01",2017
"17-Jul",제주,계,2111,358438,126139,486688,"2017-07-01",2017
"17-Jul",제주,서귀포시,697,94125,2246,97068,"2017-07-01",2017
"17-Jul",제주,제주시,1414,264313,123893,389620,"2017-07-01",2017
"17-Aug",서울,계,11780,2902546,199224,3113550,"2017-08-01",2017
"17-Aug",서울,강남구,375,220640,20889,241904,"2017-08-01",2017
"17-Aug",서울,강동구,252,130168,8284,138704,"2017-08-01",2017
"17-Aug",서울,강북구,293,72718,4780,77791,"2017-08-01",2017
"17-Aug",서울,강서구,319,183811,15903,200033,"2017-08-01",2017
"17-Aug",서울,관악구,300,116397,5562,122259,"2017-08-01",2017
"17-Aug",서울,광진구,270,92215,5452,97937,"2017-08-01",2017
"17-Aug",서울,구로구,264,130430,13206,143900,"2017-08-01",2017
"17-Aug",서울,금천구,103,79177,6654,85934,"2017-08-01",2017
"17-Aug",서울,노원구,267,146003,9448,155718,"2017-08-01",2017
"17-Aug",서울,도봉구,244,89619,7549,97412,"2017-08-01",2017
"17-Aug",서울,동대문구,302,91758,5766,97826,"2017-08-01",2017
"17-Aug",서울,동작구,305,101859,2789,104953,"2017-08-01",2017
"17-Aug",서울,마포구,321,109796,6734,116851,"2017-08-01",2017
"17-Aug",서울,서대문구,424,80057,5328,85809,"2017-08-01",2017
"17-Aug",서울,서초구,602,168879,10185,179666,"2017-08-01",2017
"17-Aug",서울,성동구,311,92651,10248,103210,"2017-08-01",2017
"17-Aug",서울,성북구,271,111720,5432,117423,"2017-08-01",2017
"17-Aug",서울,송파구,341,217432,12397,230170,"2017-08-01",2017
"17-Aug",서울,양천구,327,141686,8733,150746,"2017-08-01",2017
"17-Aug",서울,영등포구,350,136213,9750,146313,"2017-08-01",2017
"17-Aug",서울,용산구,359,72675,2305,75339,"2017-08-01",2017
"17-Aug",서울,은평구,242,121247,6864,128353,"2017-08-01",2017
"17-Aug",서울,종로구,3731,45181,1586,50498,"2017-08-01",2017
"17-Aug",서울,중구,1004,46206,3756,50966,"2017-08-01",2017
"17-Aug",서울,중랑구,203,104008,9624,113835,"2017-08-01",2017
"17-Aug",부산,계,4437,1232410,85521,1322368,"2017-08-01",2017
"17-Aug",부산,강서구,310,64025,3707,68042,"2017-08-01",2017
"17-Aug",부산,금정구,267,79792,7422,87481,"2017-08-01",2017
"17-Aug",부산,기장군,226,67475,2099,69800,"2017-08-01",2017
"17-Aug",부산,남구,206,87021,8773,96000,"2017-08-01",2017
"17-Aug",부산,동구,229,41177,5133,46539,"2017-08-01",2017
"17-Aug",부산,동래구,176,88048,4365,92589,"2017-08-01",2017
"17-Aug",부산,부산진구,355,121958,8137,130450,"2017-08-01",2017
"17-Aug",부산,북구,224,101131,3270,104625,"2017-08-01",2017
"17-Aug",부산,사상구,264,85214,6171,91649,"2017-08-01",2017
"17-Aug",부산,사하구,244,108287,7028,115559,"2017-08-01",2017
"17-Aug",부산,서구,136,27456,1349,28941,"2017-08-01",2017
"17-Aug",부산,수영구,150,65188,7774,73112,"2017-08-01",2017
"17-Aug",부산,연제구,845,86090,5887,92822,"2017-08-01",2017
"17-Aug",부산,영도구,225,31813,2631,34669,"2017-08-01",2017
"17-Aug",부산,중구,310,19115,6492,25917,"2017-08-01",2017
"17-Aug",부산,해운대구,270,158620,5283,164173,"2017-08-01",2017
"17-Aug",대구,계,2943,1099093,48111,1150147,"2017-08-01",2017
"17-Aug",대구,남구,308,56313,2023,58644,"2017-08-01",2017
"17-Aug",대구,달서구,444,256572,12152,269168,"2017-08-01",2017
"17-Aug",대구,달성군,435,112534,4192,117161,"2017-08-01",2017
"17-Aug",대구,동구,307,146808,10162,157277,"2017-08-01",2017
"17-Aug",대구,북구,437,188267,8202,196906,"2017-08-01",2017
"17-Aug",대구,서구,210,75588,4453,80251,"2017-08-01",2017
"17-Aug",대구,수성구,530,207218,5225,212973,"2017-08-01",2017
"17-Aug",대구,중구,272,55793,1702,57767,"2017-08-01",2017
"17-Aug",인천,계,3539,1197640,284794,1485973,"2017-08-01",2017
"17-Aug",인천,강화군,293,31068,2561,33922,"2017-08-01",2017
"17-Aug",인천,계양구,251,122375,144563,267189,"2017-08-01",2017
"17-Aug",인천,남구,365,145091,55534,200990,"2017-08-01",2017
"17-Aug",인천,남동구,829,233527,37211,271567,"2017-08-01",2017
"17-Aug",인천,동구,84,26104,2630,28818,"2017-08-01",2017
"17-Aug",인천,부평구,330,212122,7366,219818,"2017-08-01",2017
"17-Aug",인천,서구,359,209289,10541,220189,"2017-08-01",2017
"17-Aug",인천,연수구,289,154429,7344,162062,"2017-08-01",2017
"17-Aug",인천,옹진군,176,11328,148,11652,"2017-08-01",2017
"17-Aug",인천,중구,563,52307,16896,69766,"2017-08-01",2017
"17-Aug",인천,미추홀구,0,0,0,0,"2017-08-01",2017
"17-Aug",광주,계,1990,610006,33183,645179,"2017-08-01",2017
"17-Aug",광주,광산구,467,175211,10220,185898,"2017-08-01",2017
"17-Aug",광주,남구,178,83767,2873,86818,"2017-08-01",2017
"17-Aug",광주,동구,215,35815,1068,37098,"2017-08-01",2017
"17-Aug",광주,북구,459,176276,9077,185812,"2017-08-01",2017
"17-Aug",광주,서구,671,138937,9945,149553,"2017-08-01",2017
"17-Aug",대전,계,1831,626671,28266,656768,"2017-08-01",2017
"17-Aug",대전,대덕구,213,84801,6700,91714,"2017-08-01",2017
"17-Aug",대전,동구,231,87073,4143,91447,"2017-08-01",2017
"17-Aug",대전,서구,784,197586,7213,205583,"2017-08-01",2017
"17-Aug",대전,유성구,371,161020,4589,165980,"2017-08-01",2017
"17-Aug",대전,중구,232,96191,5621,102044,"2017-08-01",2017
"17-Aug",울산,계,1608,523828,21192,546628,"2017-08-01",2017
"17-Aug",울산,남구,650,151655,7342,159647,"2017-08-01",2017
"17-Aug",울산,동구,194,62951,954,64099,"2017-08-01",2017
"17-Aug",울산,북구,124,94324,4063,98511,"2017-08-01",2017
"17-Aug",울산,울주군,318,111534,6016,117868,"2017-08-01",2017
"17-Aug",울산,중구,322,103364,2817,106503,"2017-08-01",2017
"17-Aug",세종,계,652,120956,2293,123901,"2017-08-01",2017
"17-Aug",세종,세종특별자치시,652,120956,2293,123901,"2017-08-01",2017
"17-Aug",경기,계,15549,5063789,222866,5302204,"2017-08-01",2017
"17-Aug",경기,가평군,344,28082,705,29131,"2017-08-01",2017
"17-Aug",경기,고양시 덕양구,608,155115,3728,159451,"2017-08-01",2017
"17-Aug",경기,고양시 일산동구,253,114769,7458,122480,"2017-08-01",2017
"17-Aug",경기,고양시 일산서구,118,107259,3165,110542,"2017-08-01",2017
"17-Aug",경기,과천시,698,20005,550,21253,"2017-08-01",2017
"17-Aug",경기,광명시,281,102174,4244,106699,"2017-08-01",2017
"17-Aug",경기,광주시,357,159886,7693,167936,"2017-08-01",2017
"17-Aug",경기,구리시,220,64988,2338,67546,"2017-08-01",2017
"17-Aug",경기,군포시,256,94414,4897,99567,"2017-08-01",2017
"17-Aug",경기,김포시,413,168883,6340,175636,"2017-08-01",2017
"17-Aug",경기,남양주시,586,255637,6791,263014,"2017-08-01",2017
"17-Aug",경기,동두천시,196,35950,1264,37410,"2017-08-01",2017
"17-Aug",경기,부천시,704,285582,11859,298145,"2017-08-01",2017
"17-Aug",경기,성남시 분당구,320,183320,6772,190412,"2017-08-01",2017
"17-Aug",경기,성남시 수정구,317,68793,2505,71615,"2017-08-01",2017
"17-Aug",경기,성남시 중원구,288,71856,3895,76039,"2017-08-01",2017
"17-Aug",경기,수원시 권선구,318,158219,7220,165757,"2017-08-01",2017
"17-Aug",경기,수원시 영통구,201,128761,2875,131837,"2017-08-01",2017
"17-Aug",경기,수원시 장안구,574,104667,3993,109234,"2017-08-01",2017
"17-Aug",경기,수원시 팔달구,477,71941,3438,75856,"2017-08-01",2017
"17-Aug",경기,시흥시,446,188504,7363,196313,"2017-08-01",2017
"17-Aug",경기,안산시 단원구,505,143986,8319,152810,"2017-08-01",2017
"17-Aug",경기,안산시 상록구,164,138269,4666,143099,"2017-08-01",2017
"17-Aug",경기,안성시,332,91538,5042,96912,"2017-08-01",2017
"17-Aug",경기,안양시 동안구,371,117482,6527,124380,"2017-08-01",2017
"17-Aug",경기,안양시 만안구,153,83057,3829,87039,"2017-08-01",2017
"17-Aug",경기,양주시,328,89791,2998,93117,"2017-08-01",2017
"17-Aug",경기,양평군,455,53588,1706,55749,"2017-08-01",2017
"17-Aug",경기,여주시,400,57812,7398,65610,"2017-08-01",2017
"17-Aug",경기,연천군,262,22273,5635,28170,"2017-08-01",2017
"17-Aug",경기,오산시,221,88353,3178,91752,"2017-08-01",2017
"17-Aug",경기,용인시 기흥구,99,167124,8737,175960,"2017-08-01",2017
"17-Aug",경기,용인시 수지구,46,128032,2008,130086,"2017-08-01",2017
"17-Aug",경기,용인시 처인구,627,107932,6641,115200,"2017-08-01",2017
"17-Aug",경기,의왕시,282,56588,2790,59660,"2017-08-01",2017
"17-Aug",경기,의정부시,544,141413,4618,146575,"2017-08-01",2017
"17-Aug",경기,이천시,362,100002,5764,106128,"2017-08-01",2017
"17-Aug",경기,파주시,456,183514,10006,193976,"2017-08-01",2017
"17-Aug",경기,평택시,620,227330,10768,238718,"2017-08-01",2017
"17-Aug",경기,포천시,329,79613,10247,90189,"2017-08-01",2017
"17-Aug",경기,하남시,322,87770,2187,90279,"2017-08-01",2017
"17-Aug",경기,화성시,696,329517,10709,340922,"2017-08-01",2017
"17-Aug",강원,계,5280,709236,24348,738864,"2017-08-01",2017
"17-Aug",강원,강릉시,476,99072,4164,103712,"2017-08-01",2017
"17-Aug",강원,고성군,170,13265,240,13675,"2017-08-01",2017
"17-Aug",강원,동해시,284,41666,1387,43337,"2017-08-01",2017
"17-Aug",강원,삼척시,345,29650,727,30722,"2017-08-01",2017
"17-Aug",강원,속초시,283,34173,1296,35752,"2017-08-01",2017
"17-Aug",강원,양구군,136,11248,124,11508,"2017-08-01",2017
"17-Aug",강원,양양군,165,13799,193,14157,"2017-08-01",2017
"17-Aug",강원,영월군,303,19596,398,20297,"2017-08-01",2017
"17-Aug",강원,원주시,515,152681,5819,159015,"2017-08-01",2017
"17-Aug",강원,인제군,188,16786,218,17192,"2017-08-01",2017
"17-Aug",강원,정선군,292,19308,470,20070,"2017-08-01",2017
"17-Aug",강원,철원군,198,22608,298,23104,"2017-08-01",2017
"17-Aug",강원,춘천시,714,120101,5700,126515,"2017-08-01",2017
"17-Aug",강원,태백시,191,20079,834,21104,"2017-08-01",2017
"17-Aug",강원,평창군,276,24226,410,24912,"2017-08-01",2017
"17-Aug",강원,홍천군,339,35696,1104,37139,"2017-08-01",2017
"17-Aug",강원,화천군,186,11882,137,12205,"2017-08-01",2017
"17-Aug",강원,횡성군,219,23400,829,24448,"2017-08-01",2017
"17-Aug",충북,계,3618,743348,32725,779691,"2017-08-01",2017
"17-Aug",충북,괴산군,183,20558,358,21099,"2017-08-01",2017
"17-Aug",충북,단양군,198,14833,835,15866,"2017-08-01",2017
"17-Aug",충북,보은군,194,16686,986,17866,"2017-08-01",2017
"17-Aug",충북,영동군,219,23941,378,24538,"2017-08-01",2017
"17-Aug",충북,옥천군,187,24694,1072,25953,"2017-08-01",2017
"17-Aug",충북,음성군,213,54303,1723,56239,"2017-08-01",2017
"17-Aug",충북,제천시,303,62652,3419,66374,"2017-08-01",2017
"17-Aug",충북,증평군,83,17647,747,18477,"2017-08-01",2017
"17-Aug",충북,진천군,190,39575,1143,40908,"2017-08-01",2017
"17-Aug",충북,청원군,1,32,1,34,"2017-08-01",2017
"17-Aug",충북,청주시 상당구,419,73696,2599,76714,"2017-08-01",2017
"17-Aug",충북,청주시 서원구,222,90864,5894,96980,"2017-08-01",2017
"17-Aug",충북,청주시 청원구,329,93541,3795,97665,"2017-08-01",2017
"17-Aug",충북,청주시 흥덕구,361,111852,6000,118213,"2017-08-01",2017
"17-Aug",충북,충주시,516,98474,3775,102765,"2017-08-01",2017
"17-Aug",충남,계,5038,1002473,38716,1046227,"2017-08-01",2017
"17-Aug",충남,계룡시,134,20331,517,20982,"2017-08-01",2017
"17-Aug",충남,공주시,496,50736,2032,53264,"2017-08-01",2017
"17-Aug",충남,금산군,178,26860,2260,29298,"2017-08-01",2017
"17-Aug",충남,논산시,335,57709,2193,60237,"2017-08-01",2017
"17-Aug",충남,당진시,363,86412,3720,90495,"2017-08-01",2017
"17-Aug",충남,보령시,358,48769,1294,50421,"2017-08-01",2017
"17-Aug",충남,부여군,239,32588,1366,34193,"2017-08-01",2017
"17-Aug",충남,서산시,378,83754,3443,87575,"2017-08-01",2017
"17-Aug",충남,서천군,212,26125,971,27308,"2017-08-01",2017
"17-Aug",충남,아산시,415,147977,6216,154608,"2017-08-01",2017
"17-Aug",충남,예산군,335,39956,1385,41676,"2017-08-01",2017
"17-Aug",충남,천안시 동남구,255,117855,4792,122902,"2017-08-01",2017
"17-Aug",충남,천안시 서북구,499,167733,5702,173934,"2017-08-01",2017
"17-Aug",충남,청양군,227,15665,982,16874,"2017-08-01",2017
"17-Aug",충남,태안군,225,31512,481,32218,"2017-08-01",2017
"17-Aug",충남,홍성군,389,48491,1362,50242,"2017-08-01",2017
"17-Aug",전북,계,4545,841907,38330,884782,"2017-08-01",2017
"17-Aug",전북,고창군,235,28534,553,29322,"2017-08-01",2017
"17-Aug",전북,군산시,446,122677,6804,129927,"2017-08-01",2017
"17-Aug",전북,김제시,261,42659,1744,44664,"2017-08-01",2017
"17-Aug",전북,남원시,385,38039,3075,41499,"2017-08-01",2017
"17-Aug",전북,무주군,163,11866,364,12393,"2017-08-01",2017
"17-Aug",전북,부안군,249,26319,603,27171,"2017-08-01",2017
"17-Aug",전북,순창군,188,13567,233,13988,"2017-08-01",2017
"17-Aug",전북,완주군,309,48825,3398,52532,"2017-08-01",2017
"17-Aug",전북,익산시,453,131788,6149,138390,"2017-08-01",2017
"17-Aug",전북,임실군,192,13535,409,14136,"2017-08-01",2017
"17-Aug",전북,장수군,210,11254,176,11640,"2017-08-01",2017
"17-Aug",전북,전주시 덕진구,363,141603,7395,149361,"2017-08-01",2017
"17-Aug",전북,전주시 완산구,586,147550,4050,152186,"2017-08-01",2017
"17-Aug",전북,정읍시,284,50744,3183,54211,"2017-08-01",2017
"17-Aug",전북,진안군,221,12947,194,13362,"2017-08-01",2017
"17-Aug",전남,계,5486,862146,113424,981056,"2017-08-01",2017
"17-Aug",전남,강진군,195,17379,1080,18654,"2017-08-01",2017
"17-Aug",전남,고흥군,262,28847,664,29773,"2017-08-01",2017
"17-Aug",전남,곡성군,137,13849,919,14905,"2017-08-01",2017
"17-Aug",전남,광양시,231,74273,5860,80364,"2017-08-01",2017
"17-Aug",전남,구례군,109,12413,633,13155,"2017-08-01",2017
"17-Aug",전남,나주시,384,54775,3202,58361,"2017-08-01",2017
"17-Aug",전남,담양군,187,24542,1511,26240,"2017-08-01",2017
"17-Aug",전남,목포시,431,91270,6070,97771,"2017-08-01",2017
"17-Aug",전남,무안군,482,39436,1013,40931,"2017-08-01",2017
"17-Aug",전남,보성군,189,20347,60965,81501,"2017-08-01",2017
"17-Aug",전남,순천시,446,124656,4874,129976,"2017-08-01",2017
"17-Aug",전남,신안군,193,19412,637,20242,"2017-08-01",2017
"17-Aug",전남,여수시,503,120299,6664,127466,"2017-08-01",2017
"17-Aug",전남,영광군,208,25577,715,26500,"2017-08-01",2017
"17-Aug",전남,영암군,222,30510,13304,44036,"2017-08-01",2017
"17-Aug",전남,완도군,207,23184,476,23867,"2017-08-01",2017
"17-Aug",전남,장성군,139,23882,1057,25078,"2017-08-01",2017
"17-Aug",전남,장흥군,174,18735,439,19348,"2017-08-01",2017
"17-Aug",전남,진도군,139,15374,299,15812,"2017-08-01",2017
"17-Aug",전남,함평군,157,16747,374,17278,"2017-08-01",2017
"17-Aug",전남,해남군,291,36480,567,37338,"2017-08-01",2017
"17-Aug",전남,화순군,200,30159,2101,32460,"2017-08-01",2017
"17-Aug",경북,계,6647,1325469,48469,1380585,"2017-08-01",2017
"17-Aug",경북,경산시,408,126494,4211,131113,"2017-08-01",2017
"17-Aug",경북,경주시,534,131694,5097,137325,"2017-08-01",2017
"17-Aug",경북,고령군,150,19909,482,20541,"2017-08-01",2017
"17-Aug",경북,구미시,471,197358,7310,205139,"2017-08-01",2017
"17-Aug",경북,군위군,107,13766,269,14142,"2017-08-01",2017
"17-Aug",경북,김천시,321,68507,1772,70600,"2017-08-01",2017
"17-Aug",경북,문경시,265,34033,767,35065,"2017-08-01",2017
"17-Aug",경북,봉화군,187,16484,197,16868,"2017-08-01",2017
"17-Aug",경북,상주시,365,49503,1793,51661,"2017-08-01",2017
"17-Aug",경북,성주군,176,28384,1457,30017,"2017-08-01",2017
"17-Aug",경북,안동시,536,78148,2535,81219,"2017-08-01",2017
"17-Aug",경북,영덕군,227,17980,307,18514,"2017-08-01",2017
"17-Aug",경북,영양군,133,8879,94,9106,"2017-08-01",2017
"17-Aug",경북,영주시,316,53214,1522,55052,"2017-08-01",2017
"17-Aug",경북,영천시,246,54384,2677,57307,"2017-08-01",2017
"17-Aug",경북,예천군,179,23035,425,23639,"2017-08-01",2017
"17-Aug",경북,울릉군,138,4923,405,5466,"2017-08-01",2017
"17-Aug",경북,울진군,252,24568,348,25168,"2017-08-01",2017
"17-Aug",경북,의성군,292,28156,971,29419,"2017-08-01",2017
"17-Aug",경북,청도군,157,23119,651,23927,"2017-08-01",2017
"17-Aug",경북,청송군,194,14270,200,14664,"2017-08-01",2017
"17-Aug",경북,칠곡군,307,66209,2206,68722,"2017-08-01",2017
"17-Aug",경북,포항시 남구,362,116538,8923,125823,"2017-08-01",2017
"17-Aug",경북,포항시 북구,324,125914,3850,130088,"2017-08-01",2017
"17-Aug",경남,계,6559,1565270,82965,1654794,"2017-08-01",2017
"17-Aug",경남,거제시,325,102878,2463,105666,"2017-08-01",2017
"17-Aug",경남,거창군,235,29489,780,30504,"2017-08-01",2017
"17-Aug",경남,고성군,205,25406,700,26311,"2017-08-01",2017
"17-Aug",경남,김해시,604,248300,6555,255459,"2017-08-01",2017
"17-Aug",경남,남해군,220,18179,503,18902,"2017-08-01",2017
"17-Aug",경남,밀양시,298,52440,4156,56894,"2017-08-01",2017
"17-Aug",경남,사천시,298,52360,1504,54162,"2017-08-01",2017
"17-Aug",경남,산청군,210,18407,756,19373,"2017-08-01",2017
"17-Aug",경남,양산시,361,144637,9259,154257,"2017-08-01",2017
"17-Aug",경남,의령군,179,13108,779,14066,"2017-08-01",2017
"17-Aug",경남,진주시,564,151827,6672,159063,"2017-08-01",2017
"17-Aug",경남,창녕군,216,33373,860,34449,"2017-08-01",2017
"17-Aug",경남,창원시 마산합포구,325,97677,3041,101043,"2017-08-01",2017
"17-Aug",경남,창원시 마산회원구,165,96373,5390,101928,"2017-08-01",2017
"17-Aug",경남,창원시 성산구,141,121730,19329,141200,"2017-08-01",2017
"17-Aug",경남,창원시 의창구,864,123225,5708,129797,"2017-08-01",2017
"17-Aug",경남,창원시 진해구,195,81116,1578,82889,"2017-08-01",2017
"17-Aug",경남,통영시,312,51087,1399,52798,"2017-08-01",2017
"17-Aug",경남,하동군,210,23284,459,23953,"2017-08-01",2017
"17-Aug",경남,함안군,183,40315,10030,50528,"2017-08-01",2017
"17-Aug",경남,함양군,202,18296,403,18901,"2017-08-01",2017
"17-Aug",경남,합천군,247,21763,641,22651,"2017-08-01",2017
"17-Aug",제주,계,2114,359479,128081,489674,"2017-08-01",2017
"17-Aug",제주,서귀포시,695,94781,2270,97746,"2017-08-01",2017
"17-Aug",제주,제주시,1419,264698,125811,391928,"2017-08-01",2017
"17-Sep",서울,계,11724,2904536,199504,3115764,"2017-09-01",2017
"17-Sep",서울,강남구,380,220558,21310,242248,"2017-09-01",2017
"17-Sep",서울,강동구,261,129589,8535,138385,"2017-09-01",2017
"17-Sep",서울,강북구,291,72859,4755,77905,"2017-09-01",2017
"17-Sep",서울,강서구,318,184393,15962,200673,"2017-09-01",2017
"17-Sep",서울,관악구,300,116448,5571,122319,"2017-09-01",2017
"17-Sep",서울,광진구,265,92462,5529,98256,"2017-09-01",2017
"17-Sep",서울,구로구,256,130435,13667,144358,"2017-09-01",2017
"17-Sep",서울,금천구,103,79345,6631,86079,"2017-09-01",2017
"17-Sep",서울,노원구,267,145811,9420,155498,"2017-09-01",2017
"17-Sep",서울,도봉구,243,89742,7517,97502,"2017-09-01",2017
"17-Sep",서울,동대문구,302,91878,5463,97643,"2017-09-01",2017
"17-Sep",서울,동작구,300,101950,2789,105039,"2017-09-01",2017
"17-Sep",서울,마포구,329,109733,6691,116753,"2017-09-01",2017
"17-Sep",서울,서대문구,421,80177,5340,85938,"2017-09-01",2017
"17-Sep",서울,서초구,584,168917,10179,179680,"2017-09-01",2017
"17-Sep",서울,성동구,313,92884,9562,102759,"2017-09-01",2017
"17-Sep",서울,성북구,265,111752,5463,117480,"2017-09-01",2017
"17-Sep",서울,송파구,340,217841,12480,230661,"2017-09-01",2017
"17-Sep",서울,양천구,324,141741,8770,150835,"2017-09-01",2017
"17-Sep",서울,영등포구,350,135733,9715,145798,"2017-09-01",2017
"17-Sep",서울,용산구,361,72911,2258,75530,"2017-09-01",2017
"17-Sep",서울,은평구,240,121557,6859,128656,"2017-09-01",2017
"17-Sep",서울,종로구,3691,45286,1594,50571,"2017-09-01",2017
"17-Sep",서울,중구,1017,46404,3763,51184,"2017-09-01",2017
"17-Sep",서울,중랑구,203,104130,9681,114014,"2017-09-01",2017
"17-Sep",부산,계,4503,1234974,87045,1326522,"2017-09-01",2017
"17-Sep",부산,강서구,314,64390,3720,68424,"2017-09-01",2017
"17-Sep",부산,금정구,271,79894,7407,87572,"2017-09-01",2017
"17-Sep",부산,기장군,227,67870,2104,70201,"2017-09-01",2017
"17-Sep",부산,남구,206,87148,8774,96128,"2017-09-01",2017
"17-Sep",부산,동구,230,41661,5073,46964,"2017-09-01",2017
"17-Sep",부산,동래구,175,88047,4355,92577,"2017-09-01",2017
"17-Sep",부산,부산진구,358,121948,8340,130646,"2017-09-01",2017
"17-Sep",부산,북구,240,101092,3264,104596,"2017-09-01",2017
"17-Sep",부산,사상구,266,85348,6180,91794,"2017-09-01",2017
"17-Sep",부산,사하구,258,108575,7013,115846,"2017-09-01",2017
"17-Sep",부산,서구,138,27501,1345,28984,"2017-09-01",2017
"17-Sep",부산,수영구,151,65520,8853,74524,"2017-09-01",2017
"17-Sep",부산,연제구,853,85921,6199,92973,"2017-09-01",2017
"17-Sep",부산,영도구,226,31902,2630,34758,"2017-09-01",2017
"17-Sep",부산,중구,306,19384,6489,26179,"2017-09-01",2017
"17-Sep",부산,해운대구,284,158773,5299,164356,"2017-09-01",2017
"17-Sep",대구,계,3018,1100926,48080,1152024,"2017-09-01",2017
"17-Sep",대구,남구,360,56321,2010,58691,"2017-09-01",2017
"17-Sep",대구,달서구,447,256374,12102,268923,"2017-09-01",2017
"17-Sep",대구,달성군,446,114014,4235,118695,"2017-09-01",2017
"17-Sep",대구,동구,305,146867,10184,157356,"2017-09-01",2017
"17-Sep",대구,북구,442,188890,8191,197523,"2017-09-01",2017
"17-Sep",대구,서구,212,75385,4473,80070,"2017-09-01",2017
"17-Sep",대구,수성구,530,207450,5185,213165,"2017-09-01",2017
"17-Sep",대구,중구,276,55625,1700,57601,"2017-09-01",2017
"17-Sep",인천,계,3606,1202149,286384,1492139,"2017-09-01",2017
"17-Sep",인천,강화군,296,31198,2557,34051,"2017-09-01",2017
"17-Sep",인천,계양구,254,122697,146253,269204,"2017-09-01",2017
"17-Sep",인천,남구,375,145826,54536,200737,"2017-09-01",2017
"17-Sep",인천,남동구,857,233892,38008,272757,"2017-09-01",2017
"17-Sep",인천,동구,84,26234,2631,28949,"2017-09-01",2017
"17-Sep",인천,부평구,333,212981,7374,220688,"2017-09-01",2017
"17-Sep",인천,서구,365,210020,10584,220969,"2017-09-01",2017
"17-Sep",인천,연수구,292,155325,7387,163004,"2017-09-01",2017
"17-Sep",인천,옹진군,178,11350,156,11684,"2017-09-01",2017
"17-Sep",인천,중구,572,52626,16898,70096,"2017-09-01",2017
"17-Sep",인천,미추홀구,0,0,0,0,"2017-09-01",2017
"17-Sep",광주,계,1995,611789,33152,646936,"2017-09-01",2017
"17-Sep",광주,광산구,470,176045,10249,186764,"2017-09-01",2017
"17-Sep",광주,남구,177,84015,2851,87043,"2017-09-01",2017
"17-Sep",광주,동구,214,35770,1062,37046,"2017-09-01",2017
"17-Sep",광주,북구,461,176749,8993,186203,"2017-09-01",2017
"17-Sep",광주,서구,673,139210,9997,149880,"2017-09-01",2017
"17-Sep",대전,계,1833,628001,28259,658093,"2017-09-01",2017
"17-Sep",대전,대덕구,216,84768,6746,91730,"2017-09-01",2017
"17-Sep",대전,동구,232,87155,4161,91548,"2017-09-01",2017
"17-Sep",대전,서구,778,197999,7213,205990,"2017-09-01",2017
"17-Sep",대전,유성구,378,161739,4587,166704,"2017-09-01",2017
"17-Sep",대전,중구,229,96340,5552,102121,"2017-09-01",2017
"17-Sep",울산,계,1605,524823,21120,547548,"2017-09-01",2017
"17-Sep",울산,남구,659,151684,7213,159556,"2017-09-01",2017
"17-Sep",울산,동구,193,62960,953,64106,"2017-09-01",2017
"17-Sep",울산,북구,122,94966,4029,99117,"2017-09-01",2017
"17-Sep",울산,울주군,314,112101,6108,118523,"2017-09-01",2017
"17-Sep",울산,중구,317,103112,2817,106246,"2017-09-01",2017
"17-Sep",세종,계,664,122369,2303,125336,"2017-09-01",2017
"17-Sep",세종,세종특별자치시,664,122369,2303,125336,"2017-09-01",2017
"17-Sep",경기,계,15710,5089491,223479,5328680,"2017-09-01",2017
"17-Sep",경기,가평군,345,28240,705,29290,"2017-09-01",2017
"17-Sep",경기,고양시 덕양구,610,155629,3727,159966,"2017-09-01",2017
"17-Sep",경기,고양시 일산동구,254,115141,7449,122844,"2017-09-01",2017
"17-Sep",경기,고양시 일산서구,119,107442,3173,110734,"2017-09-01",2017
"17-Sep",경기,과천시,691,19960,545,21196,"2017-09-01",2017
"17-Sep",경기,광명시,293,102693,4256,107242,"2017-09-01",2017
"17-Sep",경기,광주시,361,160808,7726,168895,"2017-09-01",2017
"17-Sep",경기,구리시,216,65651,2350,68217,"2017-09-01",2017
"17-Sep",경기,군포시,261,94577,4900,99738,"2017-09-01",2017
"17-Sep",경기,김포시,425,171076,6368,177869,"2017-09-01",2017
"17-Sep",경기,남양주시,594,256671,6747,264012,"2017-09-01",2017
"17-Sep",경기,동두천시,202,36105,1275,37582,"2017-09-01",2017
"17-Sep",경기,부천시,704,286667,12016,299387,"2017-09-01",2017
"17-Sep",경기,성남시 분당구,322,183326,6759,190407,"2017-09-01",2017
"17-Sep",경기,성남시 수정구,316,69147,2512,71975,"2017-09-01",2017
"17-Sep",경기,성남시 중원구,288,71878,3899,76065,"2017-09-01",2017
"17-Sep",경기,수원시 권선구,319,159632,7272,167223,"2017-09-01",2017
"17-Sep",경기,수원시 영통구,205,129642,2935,132782,"2017-09-01",2017
"17-Sep",경기,수원시 장안구,573,104724,3977,109274,"2017-09-01",2017
"17-Sep",경기,수원시 팔달구,475,72114,3475,76064,"2017-09-01",2017
"17-Sep",경기,시흥시,451,190560,7445,198456,"2017-09-01",2017
"17-Sep",경기,안산시 단원구,504,144171,8294,152969,"2017-09-01",2017
"17-Sep",경기,안산시 상록구,164,138546,4667,143377,"2017-09-01",2017
"17-Sep",경기,안성시,335,92184,5054,97573,"2017-09-01",2017
"17-Sep",경기,안양시 동안구,372,117243,6619,124234,"2017-09-01",2017
"17-Sep",경기,안양시 만안구,154,83175,3844,87173,"2017-09-01",2017
"17-Sep",경기,양주시,328,90517,3002,93847,"2017-09-01",2017
"17-Sep",경기,양평군,457,53941,1702,56100,"2017-09-01",2017
"17-Sep",경기,여주시,400,57999,7331,65730,"2017-09-01",2017
"17-Sep",경기,연천군,263,22332,5628,28223,"2017-09-01",2017
"17-Sep",경기,오산시,223,88791,3176,92190,"2017-09-01",2017
"17-Sep",경기,용인시 기흥구,111,168117,8724,176952,"2017-09-01",2017
"17-Sep",경기,용인시 수지구,46,128540,2002,130588,"2017-09-01",2017
"17-Sep",경기,용인시 처인구,640,108418,6654,115712,"2017-09-01",2017
"17-Sep",경기,의왕시,284,56681,2791,59756,"2017-09-01",2017
"17-Sep",경기,의정부시,550,142147,4649,147346,"2017-09-01",2017
"17-Sep",경기,이천시,372,100567,5772,106711,"2017-09-01",2017
"17-Sep",경기,파주시,462,184579,9985,195026,"2017-09-01",2017
"17-Sep",경기,평택시,643,228565,10877,240085,"2017-09-01",2017
"17-Sep",경기,포천시,330,79876,10171,90377,"2017-09-01",2017
"17-Sep",경기,하남시,342,88889,2204,91435,"2017-09-01",2017
"17-Sep",경기,화성시,706,332530,10822,344058,"2017-09-01",2017
"17-Sep",강원,계,5352,711441,24416,741209,"2017-09-01",2017
"17-Sep",강원,강릉시,490,99331,4155,103976,"2017-09-01",2017
"17-Sep",강원,고성군,173,13299,241,13713,"2017-09-01",2017
"17-Sep",강원,동해시,292,41743,1399,43434,"2017-09-01",2017
"17-Sep",강원,삼척시,347,29806,727,30880,"2017-09-01",2017
"17-Sep",강원,속초시,285,34347,1297,35929,"2017-09-01",2017
"17-Sep",강원,양구군,135,11264,122,11521,"2017-09-01",2017
"17-Sep",강원,양양군,166,13892,189,14247,"2017-09-01",2017
"17-Sep",강원,영월군,302,19618,401,20321,"2017-09-01",2017
"17-Sep",강원,원주시,528,153112,5832,159472,"2017-09-01",2017
"17-Sep",강원,인제군,189,16851,218,17258,"2017-09-01",2017
"17-Sep",강원,정선군,297,19385,469,20151,"2017-09-01",2017
"17-Sep",강원,철원군,197,22623,298,23118,"2017-09-01",2017
"17-Sep",강원,춘천시,728,120544,5740,127012,"2017-09-01",2017
"17-Sep",강원,태백시,193,20138,838,21169,"2017-09-01",2017
"17-Sep",강원,평창군,276,24301,410,24987,"2017-09-01",2017
"17-Sep",강원,홍천군,343,35750,1107,37200,"2017-09-01",2017
"17-Sep",강원,화천군,185,11929,136,12250,"2017-09-01",2017
"17-Sep",강원,횡성군,226,23508,837,24571,"2017-09-01",2017
"17-Sep",충북,계,3647,745932,32767,782346,"2017-09-01",2017
"17-Sep",충북,괴산군,189,20619,351,21159,"2017-09-01",2017
"17-Sep",충북,단양군,198,14864,831,15893,"2017-09-01",2017
"17-Sep",충북,보은군,194,16737,987,17918,"2017-09-01",2017
"17-Sep",충북,영동군,224,24014,382,24620,"2017-09-01",2017
"17-Sep",충북,옥천군,187,24787,1073,26047,"2017-09-01",2017
"17-Sep",충북,음성군,221,54481,1715,56417,"2017-09-01",2017
"17-Sep",충북,제천시,304,62924,3423,66651,"2017-09-01",2017
"17-Sep",충북,증평군,85,17689,753,18527,"2017-09-01",2017
"17-Sep",충북,진천군,198,39870,1190,41258,"2017-09-01",2017
"17-Sep",충북,청원군,1,32,1,34,"2017-09-01",2017
"17-Sep",충북,청주시 상당구,416,73851,2604,76871,"2017-09-01",2017
"17-Sep",충북,청주시 서원구,225,91197,5857,97279,"2017-09-01",2017
"17-Sep",충북,청주시 청원구,329,93866,3791,97986,"2017-09-01",2017
"17-Sep",충북,청주시 흥덕구,360,112199,6017,118576,"2017-09-01",2017
"17-Sep",충북,충주시,516,98802,3792,103110,"2017-09-01",2017
"17-Sep",충남,계,5064,1006372,38831,1050267,"2017-09-01",2017
"17-Sep",충남,계룡시,135,20445,528,21108,"2017-09-01",2017
"17-Sep",충남,공주시,504,50848,2021,53373,"2017-09-01",2017
"17-Sep",충남,금산군,184,26954,2279,29417,"2017-09-01",2017
"17-Sep",충남,논산시,334,57787,2185,60306,"2017-09-01",2017
"17-Sep",충남,당진시,362,86680,3733,90775,"2017-09-01",2017
"17-Sep",충남,보령시,351,48924,1292,50567,"2017-09-01",2017
"17-Sep",충남,부여군,247,32677,1370,34294,"2017-09-01",2017
"17-Sep",충남,서산시,381,84007,3455,87843,"2017-09-01",2017
"17-Sep",충남,서천군,214,26178,966,27358,"2017-09-01",2017
"17-Sep",충남,아산시,419,148761,6199,155379,"2017-09-01",2017
"17-Sep",충남,예산군,336,40080,1390,41806,"2017-09-01",2017
"17-Sep",충남,천안시 동남구,252,118365,4786,123403,"2017-09-01",2017
"17-Sep",충남,천안시 서북구,499,168533,5799,174831,"2017-09-01",2017
"17-Sep",충남,청양군,225,15706,973,16904,"2017-09-01",2017
"17-Sep",충남,태안군,231,31636,481,32348,"2017-09-01",2017
"17-Sep",충남,홍성군,390,48734,1373,50497,"2017-09-01",2017
"17-Sep",전북,계,4539,844320,38897,887756,"2017-09-01",2017
"17-Sep",전북,고창군,236,28628,552,29416,"2017-09-01",2017
"17-Sep",전북,군산시,445,122874,6787,130106,"2017-09-01",2017
"17-Sep",전북,김제시,261,42798,1752,44811,"2017-09-01",2017
"17-Sep",전북,남원시,384,38085,3703,42172,"2017-09-01",2017
"17-Sep",전북,무주군,159,11886,362,12407,"2017-09-01",2017
"17-Sep",전북,부안군,248,26344,598,27190,"2017-09-01",2017
"17-Sep",전북,순창군,185,13601,224,14010,"2017-09-01",2017
"17-Sep",전북,완주군,309,48953,3401,52663,"2017-09-01",2017
"17-Sep",전북,익산시,445,132027,6175,138647,"2017-09-01",2017
"17-Sep",전북,임실군,188,13543,409,14140,"2017-09-01",2017
"17-Sep",전북,장수군,211,11294,177,11682,"2017-09-01",2017
"17-Sep",전북,전주시 덕진구,359,142315,7354,150028,"2017-09-01",2017
"17-Sep",전북,전주시 완산구,585,148018,4044,152647,"2017-09-01",2017
"17-Sep",전북,정읍시,309,50918,3167,54394,"2017-09-01",2017
"17-Sep",전북,진안군,215,13036,192,13443,"2017-09-01",2017
"17-Sep",전남,계,5549,864685,113882,984116,"2017-09-01",2017
"17-Sep",전남,강진군,197,17424,1083,18704,"2017-09-01",2017
"17-Sep",전남,고흥군,263,28936,648,29847,"2017-09-01",2017
"17-Sep",전남,곡성군,140,13889,909,14938,"2017-09-01",2017
"17-Sep",전남,광양시,230,74450,5862,80542,"2017-09-01",2017
"17-Sep",전남,구례군,116,12435,596,13147,"2017-09-01",2017
"17-Sep",전남,나주시,383,54960,3195,58538,"2017-09-01",2017
"17-Sep",전남,담양군,188,24569,1526,26283,"2017-09-01",2017
"17-Sep",전남,목포시,433,91413,6053,97899,"2017-09-01",2017
"17-Sep",전남,무안군,483,39564,1016,41063,"2017-09-01",2017
"17-Sep",전남,보성군,187,20362,62161,82710,"2017-09-01",2017
"17-Sep",전남,순천시,456,125110,4916,130482,"2017-09-01",2017
"17-Sep",전남,신안군,204,19425,635,20264,"2017-09-01",2017
"17-Sep",전남,여수시,506,120623,6678,127807,"2017-09-01",2017
"17-Sep",전남,영광군,207,25628,712,26547,"2017-09-01",2017
"17-Sep",전남,영암군,226,30561,12564,43351,"2017-09-01",2017
"17-Sep",전남,완도군,208,23246,477,23931,"2017-09-01",2017
"17-Sep",전남,장성군,139,23993,1053,25185,"2017-09-01",2017
"17-Sep",전남,장흥군,173,18885,439,19497,"2017-09-01",2017
"17-Sep",전남,진도군,145,15456,300,15901,"2017-09-01",2017
"17-Sep",전남,함평군,159,16859,377,17395,"2017-09-01",2017
"17-Sep",전남,해남군,306,36635,566,37507,"2017-09-01",2017
"17-Sep",전남,화순군,200,30262,2116,32578,"2017-09-01",2017
"17-Sep",경북,계,6695,1329813,48594,1385102,"2017-09-01",2017
"17-Sep",경북,경산시,420,127403,4225,132048,"2017-09-01",2017
"17-Sep",경북,경주시,531,131985,5103,137619,"2017-09-01",2017
"17-Sep",경북,고령군,150,19959,480,20589,"2017-09-01",2017
"17-Sep",경북,구미시,470,198252,7308,206030,"2017-09-01",2017
"17-Sep",경북,군위군,107,13792,272,14171,"2017-09-01",2017
"17-Sep",경북,김천시,327,68729,1781,70837,"2017-09-01",2017
"17-Sep",경북,문경시,268,34120,761,35149,"2017-09-01",2017
"17-Sep",경북,봉화군,192,16554,196,16942,"2017-09-01",2017
"17-Sep",경북,상주시,362,49614,1797,51773,"2017-09-01",2017
"17-Sep",경북,성주군,175,28528,1447,30150,"2017-09-01",2017
"17-Sep",경북,안동시,546,78255,2549,81350,"2017-09-01",2017
"17-Sep",경북,영덕군,233,18053,307,18593,"2017-09-01",2017
"17-Sep",경북,영양군,132,8889,94,9115,"2017-09-01",2017
"17-Sep",경북,영주시,312,53320,1517,55149,"2017-09-01",2017
"17-Sep",경북,영천시,246,54592,2668,57506,"2017-09-01",2017
"17-Sep",경북,예천군,180,23368,434,23982,"2017-09-01",2017
"17-Sep",경북,울릉군,137,4938,405,5480,"2017-09-01",2017
"17-Sep",경북,울진군,257,24660,355,25272,"2017-09-01",2017
"17-Sep",경북,의성군,290,28186,971,29447,"2017-09-01",2017
"17-Sep",경북,청도군,161,23206,658,24025,"2017-09-01",2017
"17-Sep",경북,청송군,191,14315,199,14705,"2017-09-01",2017
"17-Sep",경북,칠곡군,313,66197,2227,68737,"2017-09-01",2017
"17-Sep",경북,포항시 남구,365,116755,8942,126062,"2017-09-01",2017
"17-Sep",경북,포항시 북구,330,126143,3898,130371,"2017-09-01",2017
"17-Sep",경남,계,6592,1568731,82953,1658276,"2017-09-01",2017
"17-Sep",경남,거제시,330,102770,2394,105494,"2017-09-01",2017
"17-Sep",경남,거창군,236,29558,783,30577,"2017-09-01",2017
"17-Sep",경남,고성군,204,25393,694,26291,"2017-09-01",2017
"17-Sep",경남,김해시,604,248746,6563,255913,"2017-09-01",2017
"17-Sep",경남,남해군,220,18222,507,18949,"2017-09-01",2017
"17-Sep",경남,밀양시,297,52554,4174,57025,"2017-09-01",2017
"17-Sep",경남,사천시,303,52520,1493,54316,"2017-09-01",2017
"17-Sep",경남,산청군,209,18445,763,19417,"2017-09-01",2017
"17-Sep",경남,양산시,362,145820,9280,155462,"2017-09-01",2017
"17-Sep",경남,의령군,179,13176,792,14147,"2017-09-01",2017
"17-Sep",경남,진주시,568,152251,6641,159460,"2017-09-01",2017
"17-Sep",경남,창녕군,221,33463,953,34637,"2017-09-01",2017
"17-Sep",경남,창원시 마산합포구,328,97879,3025,101232,"2017-09-01",2017
"17-Sep",경남,창원시 마산회원구,167,96332,5387,101886,"2017-09-01",2017
"17-Sep",경남,창원시 성산구,142,121691,19110,140943,"2017-09-01",2017
"17-Sep",경남,창원시 의창구,869,123464,5687,130020,"2017-09-01",2017
"17-Sep",경남,창원시 진해구,194,81409,1584,83187,"2017-09-01",2017
"17-Sep",경남,통영시,318,51181,1402,52901,"2017-09-01",2017
"17-Sep",경남,하동군,213,23376,459,24048,"2017-09-01",2017
"17-Sep",경남,함안군,182,40300,10224,50706,"2017-09-01",2017
"17-Sep",경남,함양군,200,18359,402,18961,"2017-09-01",2017
"17-Sep",경남,합천군,246,21822,636,22704,"2017-09-01",2017
"17-Sep",제주,계,2137,360586,130532,493255,"2017-09-01",2017
"17-Sep",제주,서귀포시,696,95335,2250,98281,"2017-09-01",2017
"17-Sep",제주,제주시,1441,265251,128282,394974,"2017-09-01",2017
"17-Oct",서울,계,11815,2904973,199278,3116066,"2017-10-01",2017
"17-Oct",서울,강남구,378,220443,21555,242376,"2017-10-01",2017
"17-Oct",서울,강동구,261,129045,8478,137784,"2017-10-01",2017
"17-Oct",서울,강북구,290,72928,4766,77984,"2017-10-01",2017
"17-Oct",서울,강서구,327,184730,15858,200915,"2017-10-01",2017
"17-Oct",서울,관악구,304,116481,5563,122348,"2017-10-01",2017
"17-Oct",서울,광진구,267,92592,5542,98401,"2017-10-01",2017
"17-Oct",서울,구로구,265,130450,13623,144338,"2017-10-01",2017
"17-Oct",서울,금천구,105,79584,6593,86282,"2017-10-01",2017
"17-Oct",서울,노원구,267,145651,9418,155336,"2017-10-01",2017
"17-Oct",서울,도봉구,241,89771,7523,97535,"2017-10-01",2017
"17-Oct",서울,동대문구,301,91939,5463,97703,"2017-10-01",2017
"17-Oct",서울,동작구,300,101855,2788,104943,"2017-10-01",2017
"17-Oct",서울,마포구,329,109606,6668,116603,"2017-10-01",2017
"17-Oct",서울,서대문구,419,80226,5403,86048,"2017-10-01",2017
"17-Oct",서울,서초구,585,168731,10185,179501,"2017-10-01",2017
"17-Oct",서울,성동구,316,93143,9146,102605,"2017-10-01",2017
"17-Oct",서울,성북구,266,111703,5452,117421,"2017-10-01",2017
"17-Oct",서울,송파구,339,218237,12543,231119,"2017-10-01",2017
"17-Oct",서울,양천구,321,141761,8763,150845,"2017-10-01",2017
"17-Oct",서울,영등포구,352,135398,9721,145471,"2017-10-01",2017
"17-Oct",서울,용산구,361,72934,2292,75587,"2017-10-01",2017
"17-Oct",서울,은평구,240,121632,6868,128740,"2017-10-01",2017
"17-Oct",서울,종로구,3771,45409,1594,50774,"2017-10-01",2017
"17-Oct",서울,중구,1008,46499,3775,51282,"2017-10-01",2017
"17-Oct",서울,중랑구,202,104225,9698,114125,"2017-10-01",2017
"17-Oct",부산,계,4502,1235169,87981,1327652,"2017-10-01",2017
"17-Oct",부산,강서구,313,64329,3727,68369,"2017-10-01",2017
"17-Oct",부산,금정구,268,80237,7421,87926,"2017-10-01",2017
"17-Oct",부산,기장군,226,68012,2096,70334,"2017-10-01",2017
"17-Oct",부산,남구,205,87067,8744,96016,"2017-10-01",2017
"17-Oct",부산,동구,231,41782,4994,47007,"2017-10-01",2017
"17-Oct",부산,동래구,178,87963,4319,92460,"2017-10-01",2017
"17-Oct",부산,부산진구,359,121776,8340,130475,"2017-10-01",2017
"17-Oct",부산,북구,232,100934,3260,104426,"2017-10-01",2017
"17-Oct",부산,사상구,268,85245,6176,91689,"2017-10-01",2017
"17-Oct",부산,사하구,257,108436,7022,115715,"2017-10-01",2017
"17-Oct",부산,서구,141,27489,1340,28970,"2017-10-01",2017
"17-Oct",부산,수영구,151,65577,9598,75326,"2017-10-01",2017
"17-Oct",부산,연제구,852,86065,6531,93448,"2017-10-01",2017
"17-Oct",부산,영도구,226,31869,2626,34721,"2017-10-01",2017
"17-Oct",부산,중구,310,19577,6487,26374,"2017-10-01",2017
"17-Oct",부산,해운대구,285,158811,5300,164396,"2017-10-01",2017
"17-Oct",대구,계,3034,1101773,48029,1152836,"2017-10-01",2017
"17-Oct",대구,남구,361,56267,2003,58631,"2017-10-01",2017
"17-Oct",대구,달서구,437,256115,12088,268640,"2017-10-01",2017
"17-Oct",대구,달성군,447,115310,4256,120013,"2017-10-01",2017
"17-Oct",대구,동구,303,146547,10139,156989,"2017-10-01",2017
"17-Oct",대구,북구,445,189413,8194,198052,"2017-10-01",2017
"17-Oct",대구,서구,214,75071,4469,79754,"2017-10-01",2017
"17-Oct",대구,수성구,553,207572,5163,213288,"2017-10-01",2017
"17-Oct",대구,중구,274,55478,1717,57469,"2017-10-01",2017
"17-Oct",인천,계,3635,1205206,288418,1497259,"2017-10-01",2017
"17-Oct",인천,강화군,296,31300,2551,34147,"2017-10-01",2017
"17-Oct",인천,계양구,254,122566,147365,270185,"2017-10-01",2017
"17-Oct",인천,남구,392,146292,54671,201355,"2017-10-01",2017
"17-Oct",인천,남동구,861,234693,38665,274219,"2017-10-01",2017
"17-Oct",인천,동구,83,26130,2631,28844,"2017-10-01",2017
"17-Oct",인천,부평구,336,213395,7381,221112,"2017-10-01",2017
"17-Oct",인천,서구,365,210551,10624,221540,"2017-10-01",2017
"17-Oct",인천,연수구,297,156042,7420,163759,"2017-10-01",2017
"17-Oct",인천,옹진군,179,11379,159,11717,"2017-10-01",2017
"17-Oct",인천,중구,572,52858,16951,70381,"2017-10-01",2017
"17-Oct",인천,미추홀구,0,0,0,0,"2017-10-01",2017
"17-Oct",광주,계,2001,612556,33173,647730,"2017-10-01",2017
"17-Oct",광주,광산구,473,176400,10399,187272,"2017-10-01",2017
"17-Oct",광주,남구,178,84108,2844,87130,"2017-10-01",2017
"17-Oct",광주,동구,217,35790,1063,37070,"2017-10-01",2017
"17-Oct",광주,북구,461,177197,8912,186570,"2017-10-01",2017
"17-Oct",광주,서구,672,139061,9955,149688,"2017-10-01",2017
"17-Oct",대전,계,1832,628438,28264,658534,"2017-10-01",2017
"17-Oct",대전,대덕구,214,84682,6611,91507,"2017-10-01",2017
"17-Oct",대전,동구,233,87138,4160,91531,"2017-10-01",2017
"17-Oct",대전,서구,778,198113,7219,206110,"2017-10-01",2017
"17-Oct",대전,유성구,377,162186,4511,167074,"2017-10-01",2017
"17-Oct",대전,중구,230,96319,5763,102312,"2017-10-01",2017
"17-Oct",울산,계,1615,525505,21172,548292,"2017-10-01",2017
"17-Oct",울산,남구,663,151617,7217,159497,"2017-10-01",2017
"17-Oct",울산,동구,197,62957,964,64118,"2017-10-01",2017
"17-Oct",울산,북구,122,95400,4128,99650,"2017-10-01",2017
"17-Oct",울산,울주군,316,112484,6121,118921,"2017-10-01",2017
"17-Oct",울산,중구,317,103047,2742,106106,"2017-10-01",2017
"17-Oct",세종,계,665,123693,2303,126661,"2017-10-01",2017
"17-Oct",세종,세종특별자치시,665,123693,2303,126661,"2017-10-01",2017
"17-Oct",경기,계,15697,5104752,223495,5343944,"2017-10-01",2017
"17-Oct",경기,가평군,353,28300,698,29351,"2017-10-01",2017
"17-Oct",경기,고양시 덕양구,610,155999,3882,160491,"2017-10-01",2017
"17-Oct",경기,고양시 일산동구,254,115237,7443,122934,"2017-10-01",2017
"17-Oct",경기,고양시 일산서구,120,107579,3162,110861,"2017-10-01",2017
"17-Oct",경기,과천시,690,19931,542,21163,"2017-10-01",2017
"17-Oct",경기,광명시,291,103007,4242,107540,"2017-10-01",2017
"17-Oct",경기,광주시,360,162334,7730,170424,"2017-10-01",2017
"17-Oct",경기,구리시,216,65984,2376,68576,"2017-10-01",2017
"17-Oct",경기,군포시,261,94631,4895,99787,"2017-10-01",2017
"17-Oct",경기,김포시,423,172208,6444,179075,"2017-10-01",2017
"17-Oct",경기,남양주시,602,257047,6727,264376,"2017-10-01",2017
"17-Oct",경기,동두천시,202,36144,1277,37623,"2017-10-01",2017
"17-Oct",경기,부천시,703,286796,11969,299468,"2017-10-01",2017
"17-Oct",경기,성남시 분당구,321,183404,6547,190272,"2017-10-01",2017
"17-Oct",경기,성남시 수정구,313,69158,2507,71978,"2017-10-01",2017
"17-Oct",경기,성남시 중원구,287,71795,4114,76196,"2017-10-01",2017
"17-Oct",경기,수원시 권선구,315,160180,7261,167756,"2017-10-01",2017
"17-Oct",경기,수원시 영통구,199,130308,2962,133469,"2017-10-01",2017
"17-Oct",경기,수원시 장안구,570,104503,3995,109068,"2017-10-01",2017
"17-Oct",경기,수원시 팔달구,475,72069,3464,76008,"2017-10-01",2017
"17-Oct",경기,시흥시,442,191290,7458,199190,"2017-10-01",2017
"17-Oct",경기,안산시 단원구,518,144565,8277,153360,"2017-10-01",2017
"17-Oct",경기,안산시 상록구,162,138778,4664,143604,"2017-10-01",2017
"17-Oct",경기,안성시,332,92244,5024,97600,"2017-10-01",2017
"17-Oct",경기,안양시 동안구,367,116835,6586,123788,"2017-10-01",2017
"17-Oct",경기,안양시 만안구,146,83389,3837,87372,"2017-10-01",2017
"17-Oct",경기,양주시,325,90938,2997,94260,"2017-10-01",2017
"17-Oct",경기,양평군,469,54243,1696,56408,"2017-10-01",2017
"17-Oct",경기,여주시,403,58099,7316,65818,"2017-10-01",2017
"17-Oct",경기,연천군,273,22352,5655,28280,"2017-10-01",2017
"17-Oct",경기,오산시,224,89127,3175,92526,"2017-10-01",2017
"17-Oct",경기,용인시 기흥구,108,168855,8691,177654,"2017-10-01",2017
"17-Oct",경기,용인시 수지구,47,129108,2072,131227,"2017-10-01",2017
"17-Oct",경기,용인시 처인구,633,108834,6649,116116,"2017-10-01",2017
"17-Oct",경기,의왕시,282,56868,2803,59953,"2017-10-01",2017
"17-Oct",경기,의정부시,551,142661,4650,147862,"2017-10-01",2017
"17-Oct",경기,이천시,371,100933,5760,107064,"2017-10-01",2017
"17-Oct",경기,파주시,463,184882,9951,195296,"2017-10-01",2017
"17-Oct",경기,평택시,644,229510,10880,241034,"2017-10-01",2017
"17-Oct",경기,포천시,327,79987,10063,90377,"2017-10-01",2017
"17-Oct",경기,하남시,342,89754,2214,92310,"2017-10-01",2017
"17-Oct",경기,화성시,703,334886,10840,346429,"2017-10-01",2017
"17-Oct",강원,계,5382,712910,24420,742712,"2017-10-01",2017
"17-Oct",강원,강릉시,496,99550,4202,104248,"2017-10-01",2017
"17-Oct",강원,고성군,175,13202,238,13615,"2017-10-01",2017
"17-Oct",강원,동해시,293,41794,1395,43482,"2017-10-01",2017
"17-Oct",강원,삼척시,349,29825,726,30900,"2017-10-01",2017
"17-Oct",강원,속초시,285,34761,1313,36359,"2017-10-01",2017
"17-Oct",강원,양구군,137,11315,121,11573,"2017-10-01",2017
"17-Oct",강원,양양군,166,13916,191,14273,"2017-10-01",2017
"17-Oct",강원,영월군,303,19654,399,20356,"2017-10-01",2017
"17-Oct",강원,원주시,529,153423,5817,159769,"2017-10-01",2017
"17-Oct",강원,인제군,193,16905,222,17320,"2017-10-01",2017
"17-Oct",강원,정선군,302,19399,470,20171,"2017-10-01",2017
"17-Oct",강원,철원군,199,22671,298,23168,"2017-10-01",2017
"17-Oct",강원,춘천시,732,120678,5725,127135,"2017-10-01",2017
"17-Oct",강원,태백시,192,20108,827,21127,"2017-10-01",2017
"17-Oct",강원,평창군,274,24351,407,25032,"2017-10-01",2017
"17-Oct",강원,홍천군,344,35829,1106,37279,"2017-10-01",2017
"17-Oct",강원,화천군,185,11939,132,12256,"2017-10-01",2017
"17-Oct",강원,횡성군,228,23590,831,24649,"2017-10-01",2017
"17-Oct",충북,계,3631,747599,32794,784024,"2017-10-01",2017
"17-Oct",충북,괴산군,187,20686,351,21224,"2017-10-01",2017
"17-Oct",충북,단양군,200,14900,832,15932,"2017-10-01",2017
"17-Oct",충북,보은군,192,16781,988,17961,"2017-10-01",2017
"17-Oct",충북,영동군,223,24075,382,24680,"2017-10-01",2017
"17-Oct",충북,옥천군,186,24867,1078,26131,"2017-10-01",2017
"17-Oct",충북,음성군,219,54614,1714,56547,"2017-10-01",2017
"17-Oct",충북,제천시,303,63065,3433,66801,"2017-10-01",2017
"17-Oct",충북,증평군,85,17756,750,18591,"2017-10-01",2017
"17-Oct",충북,진천군,196,40062,1195,41453,"2017-10-01",2017
"17-Oct",충북,청원군,1,30,1,32,"2017-10-01",2017
"17-Oct",충북,청주시 상당구,416,73918,2595,76929,"2017-10-01",2017
"17-Oct",충북,청주시 서원구,224,91231,5863,97318,"2017-10-01",2017
"17-Oct",충북,청주시 청원구,327,94121,3784,98232,"2017-10-01",2017
"17-Oct",충북,청주시 흥덕구,356,112545,6038,118939,"2017-10-01",2017
"17-Oct",충북,충주시,516,98948,3790,103254,"2017-10-01",2017
"17-Oct",충남,계,5077,1008739,38787,1052603,"2017-10-01",2017
"17-Oct",충남,계룡시,137,20502,532,21171,"2017-10-01",2017
"17-Oct",충남,공주시,499,50870,2021,53390,"2017-10-01",2017
"17-Oct",충남,금산군,184,26935,2236,29355,"2017-10-01",2017
"17-Oct",충남,논산시,334,57863,2209,60406,"2017-10-01",2017
"17-Oct",충남,당진시,363,86894,3744,91001,"2017-10-01",2017
"17-Oct",충남,보령시,353,48972,1281,50606,"2017-10-01",2017
"17-Oct",충남,부여군,252,32676,1367,34295,"2017-10-01",2017
"17-Oct",충남,서산시,383,84230,3453,88066,"2017-10-01",2017
"17-Oct",충남,서천군,213,26201,970,27384,"2017-10-01",2017
"17-Oct",충남,아산시,424,149233,6192,155849,"2017-10-01",2017
"17-Oct",충남,예산군,338,40143,1385,41866,"2017-10-01",2017
"17-Oct",충남,천안시 동남구,248,118879,4784,123911,"2017-10-01",2017
"17-Oct",충남,천안시 서북구,498,169016,5782,175296,"2017-10-01",2017
"17-Oct",충남,청양군,225,15735,977,16937,"2017-10-01",2017
"17-Oct",충남,태안군,232,31729,486,32447,"2017-10-01",2017
"17-Oct",충남,홍성군,394,48861,1368,50623,"2017-10-01",2017
"17-Oct",전북,계,4548,845284,38968,888800,"2017-10-01",2017
"17-Oct",전북,고창군,236,28639,551,29426,"2017-10-01",2017
"17-Oct",전북,군산시,445,123032,6759,130236,"2017-10-01",2017
"17-Oct",전북,김제시,269,42844,1746,44859,"2017-10-01",2017
"17-Oct",전북,남원시,384,38124,3679,42187,"2017-10-01",2017
"17-Oct",전북,무주군,159,11921,360,12440,"2017-10-01",2017
"17-Oct",전북,부안군,249,26356,593,27198,"2017-10-01",2017
"17-Oct",전북,순창군,187,13647,209,14043,"2017-10-01",2017
"17-Oct",전북,완주군,309,49079,3413,52801,"2017-10-01",2017
"17-Oct",전북,익산시,444,132155,6147,138746,"2017-10-01",2017
"17-Oct",전북,임실군,186,13588,406,14180,"2017-10-01",2017
"17-Oct",전북,장수군,212,11335,177,11724,"2017-10-01",2017
"17-Oct",전북,전주시 덕진구,356,142319,7390,150065,"2017-10-01",2017
"17-Oct",전북,전주시 완산구,588,148184,4029,152801,"2017-10-01",2017
"17-Oct",전북,정읍시,308,50995,3310,54613,"2017-10-01",2017
"17-Oct",전북,진안군,216,13066,199,13481,"2017-10-01",2017
"17-Oct",전남,계,5566,866218,114272,986056,"2017-10-01",2017
"17-Oct",전남,강진군,196,17454,1071,18721,"2017-10-01",2017
"17-Oct",전남,고흥군,260,28982,650,29892,"2017-10-01",2017
"17-Oct",전남,곡성군,140,13894,904,14938,"2017-10-01",2017
"17-Oct",전남,광양시,229,74548,5867,80644,"2017-10-01",2017
"17-Oct",전남,구례군,117,12475,597,13189,"2017-10-01",2017
"17-Oct",전남,나주시,388,55150,3181,58719,"2017-10-01",2017
"17-Oct",전남,담양군,189,24628,1515,26332,"2017-10-01",2017
"17-Oct",전남,목포시,432,91446,6049,97927,"2017-10-01",2017
"17-Oct",전남,무안군,483,39674,1019,41176,"2017-10-01",2017
"17-Oct",전남,보성군,191,20373,63219,83783,"2017-10-01",2017
"17-Oct",전남,순천시,456,125338,4922,130716,"2017-10-01",2017
"17-Oct",전남,신안군,204,19445,635,20284,"2017-10-01",2017
"17-Oct",전남,여수시,514,120824,6716,128054,"2017-10-01",2017
"17-Oct",전남,영광군,206,25659,709,26574,"2017-10-01",2017
"17-Oct",전남,영암군,226,30585,11911,42722,"2017-10-01",2017
"17-Oct",전남,완도군,210,23277,473,23960,"2017-10-01",2017
"17-Oct",전남,장성군,139,24099,1053,25291,"2017-10-01",2017
"17-Oct",전남,장흥군,173,18936,440,19549,"2017-10-01",2017
"17-Oct",전남,진도군,149,15496,297,15942,"2017-10-01",2017
"17-Oct",전남,함평군,159,16935,376,17470,"2017-10-01",2017
"17-Oct",전남,해남군,306,36707,565,37578,"2017-10-01",2017
"17-Oct",전남,화순군,199,30293,2103,32595,"2017-10-01",2017
"17-Oct",경북,계,6736,1332439,48665,1387840,"2017-10-01",2017
"17-Oct",경북,경산시,417,127771,4231,132419,"2017-10-01",2017
"17-Oct",경북,경주시,533,132231,5091,137855,"2017-10-01",2017
"17-Oct",경북,고령군,151,19986,471,20608,"2017-10-01",2017
"17-Oct",경북,구미시,466,198872,7283,206621,"2017-10-01",2017
"17-Oct",경북,군위군,107,13828,272,14207,"2017-10-01",2017
"17-Oct",경북,김천시,333,68854,1790,70977,"2017-10-01",2017
"17-Oct",경북,문경시,270,34174,754,35198,"2017-10-01",2017
"17-Oct",경북,봉화군,193,16587,197,16977,"2017-10-01",2017
"17-Oct",경북,상주시,368,49684,1795,51847,"2017-10-01",2017
"17-Oct",경북,성주군,178,28564,1452,30194,"2017-10-01",2017
"17-Oct",경북,안동시,550,78294,2557,81401,"2017-10-01",2017
"17-Oct",경북,영덕군,234,18075,308,18617,"2017-10-01",2017
"17-Oct",경북,영양군,132,8892,95,9119,"2017-10-01",2017
"17-Oct",경북,영주시,315,53386,1522,55223,"2017-10-01",2017
"17-Oct",경북,영천시,256,54703,2663,57622,"2017-10-01",2017
"17-Oct",경북,예천군,188,23591,435,24214,"2017-10-01",2017
"17-Oct",경북,울릉군,138,4950,405,5493,"2017-10-01",2017
"17-Oct",경북,울진군,259,24686,358,25303,"2017-10-01",2017
"17-Oct",경북,의성군,283,28225,970,29478,"2017-10-01",2017
"17-Oct",경북,청도군,160,23269,662,24091,"2017-10-01",2017
"17-Oct",경북,청송군,193,14367,200,14760,"2017-10-01",2017
"17-Oct",경북,칠곡군,315,66280,2230,68825,"2017-10-01",2017
"17-Oct",경북,포항시 남구,364,116942,8944,126250,"2017-10-01",2017
"17-Oct",경북,포항시 북구,333,126228,3980,130541,"2017-10-01",2017
"17-Oct",경남,계,6614,1571669,82753,1661036,"2017-10-01",2017
"17-Oct",경남,거제시,329,102764,2349,105442,"2017-10-01",2017
"17-Oct",경남,거창군,236,29629,786,30651,"2017-10-01",2017
"17-Oct",경남,고성군,206,25443,690,26339,"2017-10-01",2017
"17-Oct",경남,김해시,606,249291,6553,256450,"2017-10-01",2017
"17-Oct",경남,남해군,219,18278,506,19003,"2017-10-01",2017
"17-Oct",경남,밀양시,298,52598,4181,57077,"2017-10-01",2017
"17-Oct",경남,사천시,302,52588,1490,54380,"2017-10-01",2017
"17-Oct",경남,산청군,209,18494,760,19463,"2017-10-01",2017
"17-Oct",경남,양산시,363,146801,9276,156440,"2017-10-01",2017
"17-Oct",경남,의령군,181,13184,791,14156,"2017-10-01",2017
"17-Oct",경남,진주시,569,152405,6648,159622,"2017-10-01",2017
"17-Oct",경남,창녕군,225,33565,954,34744,"2017-10-01",2017
"17-Oct",경남,창원시 마산합포구,327,98130,3000,101457,"2017-10-01",2017
"17-Oct",경남,창원시 마산회원구,169,96226,5376,101771,"2017-10-01",2017
"17-Oct",경남,창원시 성산구,142,121618,18989,140749,"2017-10-01",2017
"17-Oct",경남,창원시 의창구,874,123576,5509,129959,"2017-10-01",2017
"17-Oct",경남,창원시 진해구,194,81860,1595,83649,"2017-10-01",2017
"17-Oct",경남,통영시,320,51288,1427,53035,"2017-10-01",2017
"17-Oct",경남,하동군,211,23423,457,24091,"2017-10-01",2017
"17-Oct",경남,함안군,182,40250,10378,50810,"2017-10-01",2017
"17-Oct",경남,함양군,199,18359,400,18958,"2017-10-01",2017
"17-Oct",경남,합천군,253,21899,638,22790,"2017-10-01",2017
"17-Oct",제주,계,2144,361452,131666,495262,"2017-10-01",2017
"17-Oct",제주,서귀포시,702,95783,2247,98732,"2017-10-01",2017
"17-Oct",제주,제주시,1442,265669,129419,396530,"2017-10-01",2017
"17-Nov",서울,계,11946,2906338,199429,3117713,"2017-11-01",2017
"17-Nov",서울,강남구,377,218511,20148,239036,"2017-11-01",2017
"17-Nov",서울,강동구,252,128310,8454,137016,"2017-11-01",2017
"17-Nov",서울,강북구,287,72897,4761,77945,"2017-11-01",2017
"17-Nov",서울,강서구,319,185430,15841,201590,"2017-11-01",2017
"17-Nov",서울,관악구,300,116489,5498,122287,"2017-11-01",2017
"17-Nov",서울,광진구,269,92740,5575,98584,"2017-11-01",2017
"17-Nov",서울,구로구,272,130399,13514,144185,"2017-11-01",2017
"17-Nov",서울,금천구,119,79820,6505,86444,"2017-11-01",2017
"17-Nov",서울,노원구,265,145358,9440,155063,"2017-11-01",2017
"17-Nov",서울,도봉구,245,89762,7506,97513,"2017-11-01",2017
"17-Nov",서울,동대문구,304,91939,5451,97694,"2017-11-01",2017
"17-Nov",서울,동작구,307,101949,2793,105049,"2017-11-01",2017
"17-Nov",서울,마포구,328,109618,6677,116623,"2017-11-01",2017
"17-Nov",서울,서대문구,420,80301,5420,86141,"2017-11-01",2017
"17-Nov",서울,서초구,579,168559,11737,180875,"2017-11-01",2017
"17-Nov",서울,성동구,316,93675,9072,103063,"2017-11-01",2017
"17-Nov",서울,성북구,274,111776,5449,117499,"2017-11-01",2017
"17-Nov",서울,송파구,340,218603,12553,231496,"2017-11-01",2017
"17-Nov",서울,양천구,327,141870,8733,150930,"2017-11-01",2017
"17-Nov",서울,영등포구,353,135887,9758,145998,"2017-11-01",2017
"17-Nov",서울,용산구,359,74700,2318,77377,"2017-11-01",2017
"17-Nov",서울,은평구,244,121778,6971,128993,"2017-11-01",2017
"17-Nov",서울,종로구,3885,45368,1587,50840,"2017-11-01",2017
"17-Nov",서울,중구,999,46567,3914,51480,"2017-11-01",2017
"17-Nov",서울,중랑구,206,104032,9754,113992,"2017-11-01",2017
"17-Nov",부산,계,4531,1237188,89239,1330958,"2017-11-01",2017
"17-Nov",부산,강서구,317,64551,3703,68571,"2017-11-01",2017
"17-Nov",부산,금정구,265,80604,7422,88291,"2017-11-01",2017
"17-Nov",부산,기장군,231,68301,2113,70645,"2017-11-01",2017
"17-Nov",부산,남구,221,87223,8778,96222,"2017-11-01",2017
"17-Nov",부산,동구,233,42073,4941,47247,"2017-11-01",2017
"17-Nov",부산,동래구,177,87733,4230,92140,"2017-11-01",2017
"17-Nov",부산,부산진구,359,121840,8566,130765,"2017-11-01",2017
"17-Nov",부산,북구,234,100873,3263,104370,"2017-11-01",2017
"17-Nov",부산,사상구,280,85332,6151,91763,"2017-11-01",2017
"17-Nov",부산,사하구,255,108502,7006,115763,"2017-11-01",2017
"17-Nov",부산,서구,137,27485,1335,28957,"2017-11-01",2017
"17-Nov",부산,수영구,159,65610,10412,76181,"2017-11-01",2017
"17-Nov",부산,연제구,843,86236,6941,94020,"2017-11-01",2017
"17-Nov",부산,영도구,225,31920,2632,34777,"2017-11-01",2017
"17-Nov",부산,중구,308,19856,6466,26630,"2017-11-01",2017
"17-Nov",부산,해운대구,287,159049,5280,164616,"2017-11-01",2017
"17-Nov",대구,계,3106,1104786,47897,1155789,"2017-11-01",2017
"17-Nov",대구,남구,365,56143,2023,58531,"2017-11-01",2017
"17-Nov",대구,달서구,463,256174,12026,268663,"2017-11-01",2017
"17-Nov",대구,달성군,457,116766,4281,121504,"2017-11-01",2017
"17-Nov",대구,동구,316,146819,10099,157234,"2017-11-01",2017
"17-Nov",대구,북구,470,190229,8198,198897,"2017-11-01",2017
"17-Nov",대구,서구,224,75073,4397,79694,"2017-11-01",2017
"17-Nov",대구,수성구,538,207897,5146,213581,"2017-11-01",2017
"17-Nov",대구,중구,273,55685,1727,57685,"2017-11-01",2017
"17-Nov",인천,계,3695,1209197,291924,1504816,"2017-11-01",2017
"17-Nov",인천,강화군,293,31452,2554,34299,"2017-11-01",2017
"17-Nov",인천,계양구,265,122570,149210,272045,"2017-11-01",2017
"17-Nov",인천,남구,400,145993,55112,201505,"2017-11-01",2017
"17-Nov",인천,남동구,872,235093,39714,275679,"2017-11-01",2017
"17-Nov",인천,동구,86,26174,2625,28885,"2017-11-01",2017
"17-Nov",인천,부평구,343,214207,7415,221965,"2017-11-01",2017
"17-Nov",인천,서구,370,212319,10652,223341,"2017-11-01",2017
"17-Nov",인천,연수구,300,156870,7519,164689,"2017-11-01",2017
"17-Nov",인천,옹진군,179,11444,159,11782,"2017-11-01",2017
"17-Nov",인천,중구,587,53075,16964,70626,"2017-11-01",2017
"17-Nov",인천,미추홀구,0,0,0,0,"2017-11-01",2017
"17-Nov",광주,계,2034,614209,33098,649341,"2017-11-01",2017
"17-Nov",광주,광산구,479,176827,10481,187787,"2017-11-01",2017
"17-Nov",광주,남구,180,84430,2808,87418,"2017-11-01",2017
"17-Nov",광주,동구,225,35796,1047,37068,"2017-11-01",2017
"17-Nov",광주,북구,468,177687,11227,189382,"2017-11-01",2017
"17-Nov",광주,서구,682,139469,7535,147686,"2017-11-01",2017
"17-Nov",대전,계,1854,629273,28369,659496,"2017-11-01",2017
"17-Nov",대전,대덕구,219,84799,6598,91616,"2017-11-01",2017
"17-Nov",대전,동구,236,87038,4122,91396,"2017-11-01",2017
"17-Nov",대전,서구,786,198445,7208,206439,"2017-11-01",2017
"17-Nov",대전,유성구,379,162583,4691,167653,"2017-11-01",2017
"17-Nov",대전,중구,234,96408,5750,102392,"2017-11-01",2017
"17-Nov",울산,계,1664,526293,21148,549105,"2017-11-01",2017
"17-Nov",울산,남구,684,151609,7199,159492,"2017-11-01",2017
"17-Nov",울산,동구,204,62816,909,63929,"2017-11-01",2017
"17-Nov",울산,북구,126,95817,4114,100057,"2017-11-01",2017
"17-Nov",울산,울주군,319,112907,6160,119386,"2017-11-01",2017
"17-Nov",울산,중구,331,103144,2766,106241,"2017-11-01",2017
"17-Nov",세종,계,676,125246,2309,128231,"2017-11-01",2017
"17-Nov",세종,세종특별자치시,676,125246,2309,128231,"2017-11-01",2017
"17-Nov",경기,계,15834,5128379,223187,5367400,"2017-11-01",2017
"17-Nov",경기,가평군,349,28354,692,29395,"2017-11-01",2017
"17-Nov",경기,고양시 덕양구,612,156605,3871,161088,"2017-11-01",2017
"17-Nov",경기,고양시 일산동구,259,115426,7395,123080,"2017-11-01",2017
"17-Nov",경기,고양시 일산서구,119,107857,3190,111166,"2017-11-01",2017
"17-Nov",경기,과천시,696,19873,539,21108,"2017-11-01",2017
"17-Nov",경기,광명시,292,103287,4217,107796,"2017-11-01",2017
"17-Nov",경기,광주시,366,164022,7780,172168,"2017-11-01",2017
"17-Nov",경기,구리시,215,66759,2393,69367,"2017-11-01",2017
"17-Nov",경기,군포시,267,94735,4891,99893,"2017-11-01",2017
"17-Nov",경기,김포시,434,173510,6478,180422,"2017-11-01",2017
"17-Nov",경기,남양주시,616,257693,6731,265040,"2017-11-01",2017
"17-Nov",경기,동두천시,201,36198,1279,37678,"2017-11-01",2017
"17-Nov",경기,부천시,704,288113,11923,300740,"2017-11-01",2017
"17-Nov",경기,성남시 분당구,328,183360,6586,190274,"2017-11-01",2017
"17-Nov",경기,성남시 수정구,318,69338,2530,72186,"2017-11-01",2017
"17-Nov",경기,성남시 중원구,278,71730,4054,76062,"2017-11-01",2017
"17-Nov",경기,수원시 권선구,319,161985,7294,169598,"2017-11-01",2017
"17-Nov",경기,수원시 영통구,201,130876,2974,134051,"2017-11-01",2017
"17-Nov",경기,수원시 장안구,588,104849,3984,109421,"2017-11-01",2017
"17-Nov",경기,수원시 팔달구,478,71939,3444,75861,"2017-11-01",2017
"17-Nov",경기,시흥시,445,193013,7470,200928,"2017-11-01",2017
"17-Nov",경기,안산시 단원구,501,145132,8286,153919,"2017-11-01",2017
"17-Nov",경기,안산시 상록구,173,138842,4628,143643,"2017-11-01",2017
"17-Nov",경기,안성시,340,92355,5029,97724,"2017-11-01",2017
"17-Nov",경기,안양시 동안구,365,116662,6566,123593,"2017-11-01",2017
"17-Nov",경기,안양시 만안구,148,83688,3825,87661,"2017-11-01",2017
"17-Nov",경기,양주시,329,91474,2995,94798,"2017-11-01",2017
"17-Nov",경기,양평군,480,54408,1698,56586,"2017-11-01",2017
"17-Nov",경기,여주시,389,58245,7289,65923,"2017-11-01",2017
"17-Nov",경기,연천군,275,22441,5660,28376,"2017-11-01",2017
"17-Nov",경기,오산시,228,89782,3196,93206,"2017-11-01",2017
"17-Nov",경기,용인시 기흥구,110,169957,8537,178604,"2017-11-01",2017
"17-Nov",경기,용인시 수지구,47,129478,2096,131621,"2017-11-01",2017
"17-Nov",경기,용인시 처인구,645,109442,6598,116685,"2017-11-01",2017
"17-Nov",경기,의왕시,284,56997,2775,60056,"2017-11-01",2017
"17-Nov",경기,의정부시,559,143326,4655,148540,"2017-11-01",2017
"17-Nov",경기,이천시,373,101274,5736,107383,"2017-11-01",2017
"17-Nov",경기,파주시,459,186026,9878,196363,"2017-11-01",2017
"17-Nov",경기,평택시,652,230659,10919,242230,"2017-11-01",2017
"17-Nov",경기,포천시,328,80217,9877,90422,"2017-11-01",2017
"17-Nov",경기,하남시,348,90857,2285,93490,"2017-11-01",2017
"17-Nov",경기,화성시,716,337595,10944,349255,"2017-11-01",2017
"17-Nov",강원,계,5426,715093,24336,744855,"2017-11-01",2017
"17-Nov",강원,강릉시,497,99854,4233,104584,"2017-11-01",2017
"17-Nov",강원,고성군,177,13090,235,13502,"2017-11-01",2017
"17-Nov",강원,동해시,292,41959,1365,43616,"2017-11-01",2017
"17-Nov",강원,삼척시,350,29848,681,30879,"2017-11-01",2017
"17-Nov",강원,속초시,290,35247,1314,36851,"2017-11-01",2017
"17-Nov",강원,양구군,137,11370,120,11627,"2017-11-01",2017
"17-Nov",강원,양양군,166,13930,193,14289,"2017-11-01",2017
"17-Nov",강원,영월군,310,19731,392,20433,"2017-11-01",2017
"17-Nov",강원,원주시,527,153778,5803,160108,"2017-11-01",2017
"17-Nov",강원,인제군,196,16969,220,17385,"2017-11-01",2017
"17-Nov",강원,정선군,312,19463,457,20232,"2017-11-01",2017
"17-Nov",강원,철원군,204,22716,299,23219,"2017-11-01",2017
"17-Nov",강원,춘천시,731,120989,5727,127447,"2017-11-01",2017
"17-Nov",강원,태백시,190,20083,813,21086,"2017-11-01",2017
"17-Nov",강원,평창군,277,24411,407,25095,"2017-11-01",2017
"17-Nov",강원,홍천군,353,35989,1100,37442,"2017-11-01",2017
"17-Nov",강원,화천군,185,11965,132,12282,"2017-11-01",2017
"17-Nov",강원,횡성군,232,23701,845,24778,"2017-11-01",2017
"17-Nov",충북,계,3682,749523,32678,785883,"2017-11-01",2017
"17-Nov",충북,괴산군,185,20799,354,21338,"2017-11-01",2017
"17-Nov",충북,단양군,200,14874,832,15906,"2017-11-01",2017
"17-Nov",충북,보은군,191,16835,984,18010,"2017-11-01",2017
"17-Nov",충북,영동군,221,24122,383,24726,"2017-11-01",2017
"17-Nov",충북,옥천군,185,24913,1086,26184,"2017-11-01",2017
"17-Nov",충북,음성군,222,54798,1720,56740,"2017-11-01",2017
"17-Nov",충북,제천시,303,63187,3434,66924,"2017-11-01",2017
"17-Nov",충북,증평군,85,17832,747,18664,"2017-11-01",2017
"17-Nov",충북,진천군,194,40254,1209,41657,"2017-11-01",2017
"17-Nov",충북,청원군,1,29,1,31,"2017-11-01",2017
"17-Nov",충북,청주시 상당구,454,74143,2463,77060,"2017-11-01",2017
"17-Nov",충북,청주시 서원구,222,91431,5706,97359,"2017-11-01",2017
"17-Nov",충북,청주시 청원구,335,94415,3807,98557,"2017-11-01",2017
"17-Nov",충북,청주시 흥덕구,360,112681,6169,119210,"2017-11-01",2017
"17-Nov",충북,충주시,524,99210,3783,103517,"2017-11-01",2017
"17-Nov",충남,계,5127,1012018,38578,1055723,"2017-11-01",2017
"17-Nov",충남,계룡시,136,20521,533,21190,"2017-11-01",2017
"17-Nov",충남,공주시,507,50897,1996,53400,"2017-11-01",2017
"17-Nov",충남,금산군,185,26971,2263,29419,"2017-11-01",2017
"17-Nov",충남,논산시,337,57913,2218,60468,"2017-11-01",2017
"17-Nov",충남,당진시,365,87166,3745,91276,"2017-11-01",2017
"17-Nov",충남,보령시,369,49038,1278,50685,"2017-11-01",2017
"17-Nov",충남,부여군,253,32702,1366,34321,"2017-11-01",2017
"17-Nov",충남,서산시,387,84502,3445,88334,"2017-11-01",2017
"17-Nov",충남,서천군,212,26207,965,27384,"2017-11-01",2017
"17-Nov",충남,아산시,424,149996,5989,156409,"2017-11-01",2017
"17-Nov",충남,예산군,341,40191,1377,41909,"2017-11-01",2017
"17-Nov",충남,천안시 동남구,255,119286,4714,124255,"2017-11-01",2017
"17-Nov",충남,천안시 서북구,501,169927,5867,176295,"2017-11-01",2017
"17-Nov",충남,청양군,227,15814,979,17020,"2017-11-01",2017
"17-Nov",충남,태안군,234,31840,481,32555,"2017-11-01",2017
"17-Nov",충남,홍성군,394,49047,1362,50803,"2017-11-01",2017
"17-Nov",전북,계,4636,847303,39139,891078,"2017-11-01",2017
"17-Nov",전북,고창군,238,28789,553,29580,"2017-11-01",2017
"17-Nov",전북,군산시,460,123246,6748,130454,"2017-11-01",2017
"17-Nov",전북,김제시,283,42960,1748,44991,"2017-11-01",2017
"17-Nov",전북,남원시,394,38235,3658,42287,"2017-11-01",2017
"17-Nov",전북,무주군,160,11959,362,12481,"2017-11-01",2017
"17-Nov",전북,부안군,256,26446,590,27292,"2017-11-01",2017
"17-Nov",전북,순창군,191,13691,208,14090,"2017-11-01",2017
"17-Nov",전북,완주군,310,49227,3419,52956,"2017-11-01",2017
"17-Nov",전북,익산시,477,132276,6154,138907,"2017-11-01",2017
"17-Nov",전북,임실군,189,13672,407,14268,"2017-11-01",2017
"17-Nov",전북,장수군,211,11304,179,11694,"2017-11-01",2017
"17-Nov",전북,전주시 덕진구,357,142987,7333,150677,"2017-11-01",2017
"17-Nov",전북,전주시 완산구,586,148394,4103,153083,"2017-11-01",2017
"17-Nov",전북,정읍시,305,51035,3477,54817,"2017-11-01",2017
"17-Nov",전북,진안군,219,13082,200,13501,"2017-11-01",2017
"17-Nov",전남,계,5675,868560,116290,990525,"2017-11-01",2017
"17-Nov",전남,강진군,202,17501,1077,18780,"2017-11-01",2017
"17-Nov",전남,고흥군,268,29055,657,29980,"2017-11-01",2017
"17-Nov",전남,곡성군,142,13933,820,14895,"2017-11-01",2017
"17-Nov",전남,광양시,232,74906,5918,81056,"2017-11-01",2017
"17-Nov",전남,구례군,119,12479,597,13195,"2017-11-01",2017
"17-Nov",전남,나주시,394,55476,3183,59053,"2017-11-01",2017
"17-Nov",전남,담양군,195,24743,1536,26474,"2017-11-01",2017
"17-Nov",전남,목포시,432,91628,5986,98046,"2017-11-01",2017
"17-Nov",전남,무안군,494,39871,1012,41377,"2017-11-01",2017
"17-Nov",전남,보성군,195,20423,65960,86578,"2017-11-01",2017
"17-Nov",전남,순천시,467,125606,4886,130959,"2017-11-01",2017
"17-Nov",전남,신안군,205,19511,714,20430,"2017-11-01",2017
"17-Nov",전남,여수시,521,121067,6808,128396,"2017-11-01",2017
"17-Nov",전남,영광군,213,25640,714,26567,"2017-11-01",2017
"17-Nov",전남,영암군,234,30537,11131,41902,"2017-11-01",2017
"17-Nov",전남,완도군,210,23368,475,24053,"2017-11-01",2017
"17-Nov",전남,장성군,145,24105,1050,25300,"2017-11-01",2017
"17-Nov",전남,장흥군,173,19014,442,19629,"2017-11-01",2017
"17-Nov",전남,진도군,150,15552,301,16003,"2017-11-01",2017
"17-Nov",전남,함평군,164,17014,370,17548,"2017-11-01",2017
"17-Nov",전남,해남군,314,36780,564,37658,"2017-11-01",2017
"17-Nov",전남,화순군,206,30351,2089,32646,"2017-11-01",2017
"17-Nov",경북,계,6774,1335415,48493,1390682,"2017-11-01",2017
"17-Nov",경북,경산시,397,128050,4227,132674,"2017-11-01",2017
"17-Nov",경북,경주시,532,132472,5016,138020,"2017-11-01",2017
"17-Nov",경북,고령군,152,20008,468,20628,"2017-11-01",2017
"17-Nov",경북,구미시,460,199439,7302,207201,"2017-11-01",2017
"17-Nov",경북,군위군,111,13894,273,14278,"2017-11-01",2017
"17-Nov",경북,김천시,339,68992,1775,71106,"2017-11-01",2017
"17-Nov",경북,문경시,277,34200,752,35229,"2017-11-01",2017
"17-Nov",경북,봉화군,194,16625,197,17016,"2017-11-01",2017
"17-Nov",경북,상주시,360,49742,1801,51903,"2017-11-01",2017
"17-Nov",경북,성주군,188,28625,1470,30283,"2017-11-01",2017
"17-Nov",경북,안동시,549,78672,2545,81766,"2017-11-01",2017
"17-Nov",경북,영덕군,239,18064,302,18605,"2017-11-01",2017
"17-Nov",경북,영양군,131,8922,95,9148,"2017-11-01",2017
"17-Nov",경북,영주시,325,53481,1522,55328,"2017-11-01",2017
"17-Nov",경북,영천시,256,54890,2661,57807,"2017-11-01",2017
"17-Nov",경북,예천군,186,23772,436,24394,"2017-11-01",2017
"17-Nov",경북,울릉군,137,4929,398,5464,"2017-11-01",2017
"17-Nov",경북,울진군,259,24735,355,25349,"2017-11-01",2017
"17-Nov",경북,의성군,283,28248,978,29509,"2017-11-01",2017
"17-Nov",경북,청도군,190,23296,627,24113,"2017-11-01",2017
"17-Nov",경북,청송군,192,14372,199,14763,"2017-11-01",2017
"17-Nov",경북,칠곡군,317,66384,2236,68937,"2017-11-01",2017
"17-Nov",경북,포항시 남구,371,117180,8919,126470,"2017-11-01",2017
"17-Nov",경북,포항시 북구,329,126423,3939,130691,"2017-11-01",2017
"17-Nov",경남,계,6645,1576428,82705,1665778,"2017-11-01",2017
"17-Nov",경남,거제시,332,102785,2300,105417,"2017-11-01",2017
"17-Nov",경남,거창군,237,29706,784,30727,"2017-11-01",2017
"17-Nov",경남,고성군,204,25435,683,26322,"2017-11-01",2017
"17-Nov",경남,김해시,610,249961,6587,257158,"2017-11-01",2017
"17-Nov",경남,남해군,225,18301,501,19027,"2017-11-01",2017
"17-Nov",경남,밀양시,299,52706,4176,57181,"2017-11-01",2017
"17-Nov",경남,사천시,298,52769,1491,54558,"2017-11-01",2017
"17-Nov",경남,산청군,213,18632,761,19606,"2017-11-01",2017
"17-Nov",경남,양산시,375,147988,9270,157633,"2017-11-01",2017
"17-Nov",경남,의령군,183,13219,784,14186,"2017-11-01",2017
"17-Nov",경남,진주시,571,152770,6644,159985,"2017-11-01",2017
"17-Nov",경남,창녕군,227,33614,977,34818,"2017-11-01",2017
"17-Nov",경남,창원시 마산합포구,327,98397,2996,101720,"2017-11-01",2017
"17-Nov",경남,창원시 마산회원구,171,95920,5343,101434,"2017-11-01",2017
"17-Nov",경남,창원시 성산구,138,122635,18783,141556,"2017-11-01",2017
"17-Nov",경남,창원시 의창구,868,123936,5619,130423,"2017-11-01",2017
"17-Nov",경남,창원시 진해구,195,82194,1598,83987,"2017-11-01",2017
"17-Nov",경남,통영시,317,51340,1424,53081,"2017-11-01",2017
"17-Nov",경남,하동군,215,23513,457,24185,"2017-11-01",2017
"17-Nov",경남,함안군,187,40324,10490,51001,"2017-11-01",2017
"17-Nov",경남,함양군,201,18356,397,18954,"2017-11-01",2017
"17-Nov",경남,합천군,252,21927,640,22819,"2017-11-01",2017
"17-Nov",제주,계,2147,362524,133318,497989,"2017-11-01",2017
"17-Nov",제주,서귀포시,707,96309,2195,99211,"2017-11-01",2017
"17-Nov",제주,제주시,1440,266215,131123,398778,"2017-11-01",2017
"17-Dec",서울,계,12010,2904867,199379,3116256,"2017-12-01",2017
"17-Dec",서울,강남구,373,218041,19897,238311,"2017-12-01",2017
"17-Dec",서울,강동구,255,127852,8451,136558,"2017-12-01",2017
"17-Dec",서울,강북구,286,72787,4747,77820,"2017-12-01",2017
"17-Dec",서울,강서구,318,185823,15922,202063,"2017-12-01",2017
"17-Dec",서울,관악구,292,116324,5487,122103,"2017-12-01",2017
"17-Dec",서울,광진구,272,92789,5570,98631,"2017-12-01",2017
"17-Dec",서울,구로구,272,130153,13535,143960,"2017-12-01",2017
"17-Dec",서울,금천구,122,79833,6472,86427,"2017-12-01",2017
"17-Dec",서울,노원구,268,145048,9392,154708,"2017-12-01",2017
"17-Dec",서울,도봉구,244,89581,7498,97323,"2017-12-01",2017
"17-Dec",서울,동대문구,315,91753,5439,97507,"2017-12-01",2017
"17-Dec",서울,동작구,299,101735,2803,104837,"2017-12-01",2017
"17-Dec",서울,마포구,333,109521,6677,116531,"2017-12-01",2017
"17-Dec",서울,서대문구,419,80236,5413,86068,"2017-12-01",2017
"17-Dec",서울,서초구,576,168835,12135,181546,"2017-12-01",2017
"17-Dec",서울,성동구,314,93911,8891,103116,"2017-12-01",2017
"17-Dec",서울,성북구,280,111476,5453,117209,"2017-12-01",2017
"17-Dec",서울,송파구,343,218914,12562,231819,"2017-12-01",2017
"17-Dec",서울,양천구,326,141772,8725,150823,"2017-12-01",2017
"17-Dec",서울,영등포구,354,136061,9735,146150,"2017-12-01",2017
"17-Dec",서울,용산구,361,74806,2291,77458,"2017-12-01",2017
"17-Dec",서울,은평구,244,121791,6969,129004,"2017-12-01",2017
"17-Dec",서울,종로구,3895,45351,1582,50828,"2017-12-01",2017
"17-Dec",서울,중구,1048,46526,3966,51540,"2017-12-01",2017
"17-Dec",서울,중랑구,201,103948,9767,113916,"2017-12-01",2017
"17-Dec",부산,계,4515,1238132,90577,1333224,"2017-12-01",2017
"17-Dec",부산,강서구,317,64671,3659,68647,"2017-12-01",2017
"17-Dec",부산,금정구,264,80752,7417,88433,"2017-12-01",2017
"17-Dec",부산,기장군,233,68483,2126,70842,"2017-12-01",2017
"17-Dec",부산,남구,219,87165,8709,96093,"2017-12-01",2017
"17-Dec",부산,동구,232,42453,4881,47566,"2017-12-01",2017
"17-Dec",부산,동래구,177,87531,4225,91933,"2017-12-01",2017
"17-Dec",부산,부산진구,356,121664,8900,130920,"2017-12-01",2017
"17-Dec",부산,북구,235,100680,3258,104173,"2017-12-01",2017
"17-Dec",부산,사상구,275,85430,6093,91798,"2017-12-01",2017
"17-Dec",부산,사하구,255,108561,7001,115817,"2017-12-01",2017
"17-Dec",부산,서구,137,27377,1336,28850,"2017-12-01",2017
"17-Dec",부산,수영구,159,65597,11153,76909,"2017-12-01",2017
"17-Dec",부산,연제구,839,86480,7306,94625,"2017-12-01",2017
"17-Dec",부산,영도구,224,31942,2626,34792,"2017-12-01",2017
"17-Dec",부산,중구,308,20076,6538,26922,"2017-12-01",2017
"17-Dec",부산,해운대구,285,159270,5349,164904,"2017-12-01",2017
"17-Dec",대구,계,3094,1106192,47767,1157053,"2017-12-01",2017
"17-Dec",대구,남구,363,56048,2008,58419,"2017-12-01",2017
"17-Dec",대구,달서구,460,256285,12017,268762,"2017-12-01",2017
"17-Dec",대구,달성군,453,117670,4282,122405,"2017-12-01",2017
"17-Dec",대구,동구,319,147256,10101,157676,"2017-12-01",2017
"17-Dec",대구,북구,467,190443,8049,198959,"2017-12-01",2017
"17-Dec",대구,서구,223,75013,4370,79606,"2017-12-01",2017
"17-Dec",대구,수성구,537,207691,5224,213452,"2017-12-01",2017
"17-Dec",대구,중구,272,55786,1716,57774,"2017-12-01",2017
"17-Dec",인천,계,3704,1212943,293672,1510319,"2017-12-01",2017
"17-Dec",인천,강화군,295,31591,2543,34429,"2017-12-01",2017
"17-Dec",인천,계양구,266,122471,150420,273157,"2017-12-01",2017
"17-Dec",인천,남구,389,146241,54475,201105,"2017-12-01",2017
"17-Dec",인천,남동구,858,235560,40598,277016,"2017-12-01",2017
"17-Dec",인천,동구,86,26338,2685,29109,"2017-12-01",2017
"17-Dec",인천,부평구,340,214650,7693,222683,"2017-12-01",2017
"17-Dec",인천,서구,373,213343,10679,224395,"2017-12-01",2017
"17-Dec",인천,연수구,319,158118,7558,165995,"2017-12-01",2017
"17-Dec",인천,옹진군,178,11456,159,11793,"2017-12-01",2017
"17-Dec",인천,중구,600,53175,16862,70637,"2017-12-01",2017
"17-Dec",인천,미추홀구,0,0,0,0,"2017-12-01",2017
"17-Dec",광주,계,2078,614264,32951,649293,"2017-12-01",2017
"17-Dec",광주,광산구,499,176736,10521,187756,"2017-12-01",2017
"17-Dec",광주,남구,180,84471,2655,87306,"2017-12-01",2017
"17-Dec",광주,동구,227,35709,1092,37028,"2017-12-01",2017
"17-Dec",광주,북구,479,177552,10996,189027,"2017-12-01",2017
"17-Dec",광주,서구,693,139796,7687,148176,"2017-12-01",2017
"17-Dec",대전,계,1839,629354,28426,659619,"2017-12-01",2017
"17-Dec",대전,대덕구,212,84932,6545,91689,"2017-12-01",2017
"17-Dec",대전,동구,231,86856,4145,91232,"2017-12-01",2017
"17-Dec",대전,서구,789,198697,7215,206701,"2017-12-01",2017
"17-Dec",대전,유성구,375,162679,4779,167833,"2017-12-01",2017
"17-Dec",대전,중구,232,96190,5742,102164,"2017-12-01",2017
"17-Dec",울산,계,1646,526743,21100,549489,"2017-12-01",2017
"17-Dec",울산,남구,683,151562,7130,159375,"2017-12-01",2017
"17-Dec",울산,동구,205,62649,889,63743,"2017-12-01",2017
"17-Dec",울산,북구,122,96433,4111,100666,"2017-12-01",2017
"17-Dec",울산,울주군,312,113188,6183,119683,"2017-12-01",2017
"17-Dec",울산,중구,324,102911,2787,106022,"2017-12-01",2017
"17-Dec",세종,계,676,126779,2310,129765,"2017-12-01",2017
"17-Dec",세종,세종특별자치시,676,126779,2310,129765,"2017-12-01",2017
"17-Dec",경기,계,15980,5146721,223321,5386022,"2017-12-01",2017
"17-Dec",경기,가평군,351,28384,691,29426,"2017-12-01",2017
"17-Dec",경기,고양시 덕양구,619,156909,3868,161396,"2017-12-01",2017
"17-Dec",경기,고양시 일산동구,263,115546,7640,123449,"2017-12-01",2017
"17-Dec",경기,고양시 일산서구,119,107996,3141,111256,"2017-12-01",2017
"17-Dec",경기,과천시,697,19830,538,21065,"2017-12-01",2017
"17-Dec",경기,광명시,296,103294,4215,107805,"2017-12-01",2017
"17-Dec",경기,광주시,368,165184,7769,173321,"2017-12-01",2017
"17-Dec",경기,구리시,221,67291,2373,69885,"2017-12-01",2017
"17-Dec",경기,군포시,272,94605,4916,99793,"2017-12-01",2017
"17-Dec",경기,김포시,444,174664,6547,181655,"2017-12-01",2017
"17-Dec",경기,남양주시,621,258055,6744,265420,"2017-12-01",2017
"17-Dec",경기,동두천시,201,36198,1275,37674,"2017-12-01",2017
"17-Dec",경기,부천시,702,289126,11917,301745,"2017-12-01",2017
"17-Dec",경기,성남시 분당구,328,183326,6648,190302,"2017-12-01",2017
"17-Dec",경기,성남시 수정구,318,69507,2536,72361,"2017-12-01",2017
"17-Dec",경기,성남시 중원구,276,71677,4053,76006,"2017-12-01",2017
"17-Dec",경기,수원시 권선구,325,163839,7254,171418,"2017-12-01",2017
"17-Dec",경기,수원시 영통구,209,131202,3012,134423,"2017-12-01",2017
"17-Dec",경기,수원시 장안구,601,105111,3972,109684,"2017-12-01",2017
"17-Dec",경기,수원시 팔달구,480,71629,3488,75597,"2017-12-01",2017
"17-Dec",경기,시흥시,449,194574,7521,202544,"2017-12-01",2017
"17-Dec",경기,안산시 단원구,515,145353,8224,154092,"2017-12-01",2017
"17-Dec",경기,안산시 상록구,173,138728,4621,143522,"2017-12-01",2017
"17-Dec",경기,안성시,338,92736,5043,98117,"2017-12-01",2017
"17-Dec",경기,안양시 동안구,376,116430,6561,123367,"2017-12-01",2017
"17-Dec",경기,안양시 만안구,149,83845,3831,87825,"2017-12-01",2017
"17-Dec",경기,양주시,344,91773,2996,95113,"2017-12-01",2017
"17-Dec",경기,양평군,480,54587,1692,56759,"2017-12-01",2017
"17-Dec",경기,여주시,394,58403,7236,66033,"2017-12-01",2017
"17-Dec",경기,연천군,274,22437,5651,28362,"2017-12-01",2017
"17-Dec",경기,오산시,231,90495,3157,93883,"2017-12-01",2017
"17-Dec",경기,용인시 기흥구,114,170885,8791,179790,"2017-12-01",2017
"17-Dec",경기,용인시 수지구,47,129726,2087,131860,"2017-12-01",2017
"17-Dec",경기,용인시 처인구,653,110259,6600,117512,"2017-12-01",2017
"17-Dec",경기,의왕시,289,57056,2784,60129,"2017-12-01",2017
"17-Dec",경기,의정부시,560,143996,4631,149187,"2017-12-01",2017
"17-Dec",경기,이천시,383,101418,5789,107590,"2017-12-01",2017
"17-Dec",경기,파주시,461,186900,9735,197096,"2017-12-01",2017
"17-Dec",경기,평택시,656,231553,10962,243171,"2017-12-01",2017
"17-Dec",경기,포천시,329,80353,9668,90350,"2017-12-01",2017
"17-Dec",경기,하남시,341,91662,2175,94178,"2017-12-01",2017
"17-Dec",경기,화성시,713,340179,10969,351861,"2017-12-01",2017
"17-Dec",강원,계,5447,716119,24393,745959,"2017-12-01",2017
"17-Dec",강원,강릉시,496,99916,4281,104693,"2017-12-01",2017
"17-Dec",강원,고성군,177,13661,238,14076,"2017-12-01",2017
"17-Dec",강원,동해시,291,41993,1363,43647,"2017-12-01",2017
"17-Dec",강원,삼척시,350,29857,682,30889,"2017-12-01",2017
"17-Dec",강원,속초시,288,34986,1327,36601,"2017-12-01",2017
"17-Dec",강원,양구군,138,11365,118,11621,"2017-12-01",2017
"17-Dec",강원,양양군,168,13940,194,14302,"2017-12-01",2017
"17-Dec",강원,영월군,312,19766,388,20466,"2017-12-01",2017
"17-Dec",강원,원주시,528,154097,5777,160402,"2017-12-01",2017
"17-Dec",강원,인제군,196,16901,219,17316,"2017-12-01",2017
"17-Dec",강원,정선군,304,19468,458,20230,"2017-12-01",2017
"17-Dec",강원,철원군,207,22708,294,23209,"2017-12-01",2017
"17-Dec",강원,춘천시,731,121300,5719,127750,"2017-12-01",2017
"17-Dec",강원,태백시,202,20021,813,21036,"2017-12-01",2017
"17-Dec",강원,평창군,277,24404,407,25088,"2017-12-01",2017
"17-Dec",강원,홍천군,368,36041,1096,37505,"2017-12-01",2017
"17-Dec",강원,화천군,184,11951,174,12309,"2017-12-01",2017
"17-Dec",강원,횡성군,230,23744,845,24819,"2017-12-01",2017
"17-Dec",충북,계,3689,750881,32618,787188,"2017-12-01",2017
"17-Dec",충북,괴산군,187,21013,358,21558,"2017-12-01",2017
"17-Dec",충북,단양군,195,14822,829,15846,"2017-12-01",2017
"17-Dec",충북,보은군,197,16849,983,18029,"2017-12-01",2017
"17-Dec",충북,영동군,217,24089,381,24687,"2017-12-01",2017
"17-Dec",충북,옥천군,188,24989,1094,26271,"2017-12-01",2017
"17-Dec",충북,음성군,223,54733,1723,56679,"2017-12-01",2017
"17-Dec",충북,제천시,306,63271,3390,66967,"2017-12-01",2017
"17-Dec",충북,증평군,86,17833,749,18668,"2017-12-01",2017
"17-Dec",충북,진천군,193,40394,1209,41796,"2017-12-01",2017
"17-Dec",충북,청원군,1,22,0,23,"2017-12-01",2017
"17-Dec",충북,청주시 상당구,456,74312,2450,77218,"2017-12-01",2017
"17-Dec",충북,청주시 서원구,218,91479,5693,97390,"2017-12-01",2017
"17-Dec",충북,청주시 청원구,332,94707,3825,98864,"2017-12-01",2017
"17-Dec",충북,청주시 흥덕구,360,112832,6158,119350,"2017-12-01",2017
"17-Dec",충북,충주시,530,99536,3776,103842,"2017-12-01",2017
"17-Dec",충남,계,5133,1014082,38300,1057515,"2017-12-01",2017
"17-Dec",충남,계룡시,136,20552,539,21227,"2017-12-01",2017
"17-Dec",충남,공주시,517,50937,1994,53448,"2017-12-01",2017
"17-Dec",충남,금산군,181,26930,2260,29371,"2017-12-01",2017
"17-Dec",충남,논산시,336,57981,2220,60537,"2017-12-01",2017
"17-Dec",충남,당진시,366,87180,3742,91288,"2017-12-01",2017
"17-Dec",충남,보령시,371,49063,1286,50720,"2017-12-01",2017
"17-Dec",충남,부여군,255,32705,1361,34321,"2017-12-01",2017
"17-Dec",충남,서산시,369,84633,3422,88424,"2017-12-01",2017
"17-Dec",충남,서천군,214,26209,958,27381,"2017-12-01",2017
"17-Dec",충남,아산시,420,150472,5751,156643,"2017-12-01",2017
"17-Dec",충남,예산군,338,40248,1383,41969,"2017-12-01",2017
"17-Dec",충남,천안시 동남구,255,119587,4699,124541,"2017-12-01",2017
"17-Dec",충남,천안시 서북구,501,170528,5857,176886,"2017-12-01",2017
"17-Dec",충남,청양군,225,16054,979,17258,"2017-12-01",2017
"17-Dec",충남,태안군,259,31894,477,32630,"2017-12-01",2017
"17-Dec",충남,홍성군,390,49109,1372,50871,"2017-12-01",2017
"17-Dec",전북,계,4650,848402,39066,892118,"2017-12-01",2017
"17-Dec",전북,고창군,236,29569,551,30356,"2017-12-01",2017
"17-Dec",전북,군산시,463,123134,6748,130345,"2017-12-01",2017
"17-Dec",전북,김제시,284,42957,1745,44986,"2017-12-01",2017
"17-Dec",전북,남원시,390,38227,3628,42245,"2017-12-01",2017
"17-Dec",전북,무주군,163,11944,362,12469,"2017-12-01",2017
"17-Dec",전북,부안군,255,26496,590,27341,"2017-12-01",2017
"17-Dec",전북,순창군,189,13800,208,14197,"2017-12-01",2017
"17-Dec",전북,완주군,310,49143,3427,52880,"2017-12-01",2017
"17-Dec",전북,익산시,477,132542,6184,139203,"2017-12-01",2017
"17-Dec",전북,임실군,190,14033,408,14631,"2017-12-01",2017
"17-Dec",전북,장수군,214,11311,179,11704,"2017-12-01",2017
"17-Dec",전북,전주시 덕진구,368,143327,7287,150982,"2017-12-01",2017
"17-Dec",전북,전주시 완산구,589,147910,4099,152598,"2017-12-01",2017
"17-Dec",전북,정읍시,301,50947,3449,54697,"2017-12-01",2017
"17-Dec",전북,진안군,221,13062,201,13484,"2017-12-01",2017
"17-Dec",전남,계,5658,870557,118103,994318,"2017-12-01",2017
"17-Dec",전남,강진군,203,17519,1077,18799,"2017-12-01",2017
"17-Dec",전남,고흥군,266,29078,654,29998,"2017-12-01",2017
"17-Dec",전남,곡성군,139,13985,815,14939,"2017-12-01",2017
"17-Dec",전남,광양시,235,76052,5915,82202,"2017-12-01",2017
"17-Dec",전남,구례군,117,12659,599,13375,"2017-12-01",2017
"17-Dec",전남,나주시,391,55604,3177,59172,"2017-12-01",2017
"17-Dec",전남,담양군,194,24788,1519,26501,"2017-12-01",2017
"17-Dec",전남,목포시,431,91627,5943,98001,"2017-12-01",2017
"17-Dec",전남,무안군,493,39996,1015,41504,"2017-12-01",2017
"17-Dec",전남,보성군,195,20396,67261,87852,"2017-12-01",2017
"17-Dec",전남,순천시,463,125786,4900,131149,"2017-12-01",2017
"17-Dec",전남,신안군,207,19534,750,20491,"2017-12-01",2017
"17-Dec",전남,여수시,519,120971,6858,128348,"2017-12-01",2017
"17-Dec",전남,영광군,213,25694,712,26619,"2017-12-01",2017
"17-Dec",전남,영암군,233,30500,11651,42384,"2017-12-01",2017
"17-Dec",전남,완도군,211,23361,469,24041,"2017-12-01",2017
"17-Dec",전남,장성군,144,24257,1039,25440,"2017-12-01",2017
"17-Dec",전남,장흥군,178,18998,439,19615,"2017-12-01",2017
"17-Dec",전남,진도군,148,15565,299,16012,"2017-12-01",2017
"17-Dec",전남,함평군,165,17062,367,17594,"2017-12-01",2017
"17-Dec",전남,해남군,307,36792,559,37658,"2017-12-01",2017
"17-Dec",전남,화순군,206,30333,2085,32624,"2017-12-01",2017
"17-Dec",경북,계,6821,1336954,48376,1392151,"2017-12-01",2017
"17-Dec",경북,경산시,396,128004,4214,132614,"2017-12-01",2017
"17-Dec",경북,경주시,529,132469,4986,137984,"2017-12-01",2017
"17-Dec",경북,고령군,154,20020,506,20680,"2017-12-01",2017
"17-Dec",경북,구미시,475,199867,7291,207633,"2017-12-01",2017
"17-Dec",경북,군위군,111,13923,272,14306,"2017-12-01",2017
"17-Dec",경북,김천시,341,69028,1778,71147,"2017-12-01",2017
"17-Dec",경북,문경시,280,34136,750,35166,"2017-12-01",2017
"17-Dec",경북,봉화군,196,16644,203,17043,"2017-12-01",2017
"17-Dec",경북,상주시,362,49813,1811,51986,"2017-12-01",2017
"17-Dec",경북,성주군,189,28839,1462,30490,"2017-12-01",2017
"17-Dec",경북,안동시,556,78725,2544,81825,"2017-12-01",2017
"17-Dec",경북,영덕군,239,18094,301,18634,"2017-12-01",2017
"17-Dec",경북,영양군,132,8930,95,9157,"2017-12-01",2017
"17-Dec",경북,영주시,331,53464,1523,55318,"2017-12-01",2017
"17-Dec",경북,영천시,257,54895,2654,57806,"2017-12-01",2017
"17-Dec",경북,예천군,188,24133,427,24748,"2017-12-01",2017
"17-Dec",경북,울릉군,141,4938,383,5462,"2017-12-01",2017
"17-Dec",경북,울진군,270,24782,354,25406,"2017-12-01",2017
"17-Dec",경북,의성군,284,28299,1012,29595,"2017-12-01",2017
"17-Dec",경북,청도군,191,23314,618,24123,"2017-12-01",2017
"17-Dec",경북,청송군,191,14358,197,14746,"2017-12-01",2017
"17-Dec",경북,칠곡군,315,66429,2203,68947,"2017-12-01",2017
"17-Dec",경북,포항시 남구,370,117308,8852,126530,"2017-12-01",2017
"17-Dec",경북,포항시 북구,323,126542,3940,130805,"2017-12-01",2017
"17-Dec",경남,계,6685,1578482,82642,1667809,"2017-12-01",2017
"17-Dec",경남,거제시,333,102635,2290,105258,"2017-12-01",2017
"17-Dec",경남,거창군,244,29713,782,30739,"2017-12-01",2017
"17-Dec",경남,고성군,203,25437,676,26316,"2017-12-01",2017
"17-Dec",경남,김해시,619,250488,6545,257652,"2017-12-01",2017
"17-Dec",경남,남해군,229,18354,501,19084,"2017-12-01",2017
"17-Dec",경남,밀양시,300,52735,4166,57201,"2017-12-01",2017
"17-Dec",경남,사천시,299,52914,1482,54695,"2017-12-01",2017
"17-Dec",경남,산청군,214,18701,781,19696,"2017-12-01",2017
"17-Dec",경남,양산시,374,148690,9233,158297,"2017-12-01",2017
"17-Dec",경남,의령군,184,13299,785,14268,"2017-12-01",2017
"17-Dec",경남,진주시,573,152876,6626,160075,"2017-12-01",2017
"17-Dec",경남,창녕군,225,33618,960,34803,"2017-12-01",2017
"17-Dec",경남,창원시 마산합포구,341,98598,2988,101927,"2017-12-01",2017
"17-Dec",경남,창원시 마산회원구,171,95760,5322,101253,"2017-12-01",2017
"17-Dec",경남,창원시 성산구,141,122219,18540,140900,"2017-12-01",2017
"17-Dec",경남,창원시 의창구,871,124540,5805,131216,"2017-12-01",2017
"17-Dec",경남,창원시 진해구,195,82427,1598,84220,"2017-12-01",2017
"17-Dec",경남,통영시,315,51335,1440,53090,"2017-12-01",2017
"17-Dec",경남,하동군,219,23641,455,24315,"2017-12-01",2017
"17-Dec",경남,함안군,185,40166,10635,50986,"2017-12-01",2017
"17-Dec",경남,함양군,202,18363,396,18961,"2017-12-01",2017
"17-Dec",경남,합천군,248,21973,636,22857,"2017-12-01",2017
"17-Dec",제주,계,2136,362786,135275,500197,"2017-12-01",2017
"17-Dec",제주,서귀포시,707,96704,2149,99560,"2017-12-01",2017
"17-Dec",제주,제주시,1429,266082,133126,400637,"2017-12-01",2017
"18-Jan",서울,계,11930,2906869,199670,3118469,"2018-01-01",2018
"18-Jan",서울,강남구,367,217901,19943,238211,"2018-01-01",2018
"18-Jan",서울,강동구,264,127884,8428,136576,"2018-01-01",2018
"18-Jan",서울,강북구,286,72892,4736,77914,"2018-01-01",2018
"18-Jan",서울,강서구,316,185942,16056,202314,"2018-01-01",2018
"18-Jan",서울,관악구,290,116427,5475,122192,"2018-01-01",2018
"18-Jan",서울,광진구,260,92883,5535,98678,"2018-01-01",2018
"18-Jan",서울,구로구,271,130104,13696,144071,"2018-01-01",2018
"18-Jan",서울,금천구,123,79938,6407,86468,"2018-01-01",2018
"18-Jan",서울,노원구,280,145037,9375,154692,"2018-01-01",2018
"18-Jan",서울,도봉구,241,89678,7462,97381,"2018-01-01",2018
"18-Jan",서울,동대문구,315,91809,5406,97530,"2018-01-01",2018
"18-Jan",서울,동작구,298,101738,2803,104839,"2018-01-01",2018
"18-Jan",서울,마포구,330,109724,6645,116699,"2018-01-01",2018
"18-Jan",서울,서대문구,423,80409,5494,86326,"2018-01-01",2018
"18-Jan",서울,서초구,578,168883,12222,181683,"2018-01-01",2018
"18-Jan",서울,성동구,311,94098,8873,103282,"2018-01-01",2018
"18-Jan",서울,성북구,279,111339,5461,117079,"2018-01-01",2018
"18-Jan",서울,송파구,348,219357,12567,232272,"2018-01-01",2018
"18-Jan",서울,양천구,327,141925,8715,150967,"2018-01-01",2018
"18-Jan",서울,영등포구,345,136106,9691,146142,"2018-01-01",2018
"18-Jan",서울,용산구,355,74963,2317,77635,"2018-01-01",2018
"18-Jan",서울,은평구,244,121943,6976,129163,"2018-01-01",2018
"18-Jan",서울,종로구,3831,45327,1587,50745,"2018-01-01",2018
"18-Jan",서울,중구,1047,46474,4027,51548,"2018-01-01",2018
"18-Jan",서울,중랑구,201,104088,9773,114062,"2018-01-01",2018
"18-Jan",부산,계,4515,1240276,92307,1337098,"2018-01-01",2018
"18-Jan",부산,강서구,315,64955,3642,68912,"2018-01-01",2018
"18-Jan",부산,금정구,263,81013,7401,88677,"2018-01-01",2018
"18-Jan",부산,기장군,236,68857,2130,71223,"2018-01-01",2018
"18-Jan",부산,남구,220,87196,8693,96109,"2018-01-01",2018
"18-Jan",부산,동구,231,42651,4812,47694,"2018-01-01",2018
"18-Jan",부산,동래구,177,87544,4270,91991,"2018-01-01",2018
"18-Jan",부산,부산진구,358,121447,9203,131008,"2018-01-01",2018
"18-Jan",부산,북구,230,100813,3259,104302,"2018-01-01",2018
"18-Jan",부산,사상구,274,85503,6102,91879,"2018-01-01",2018
"18-Jan",부산,사하구,257,108699,6974,115930,"2018-01-01",2018
"18-Jan",부산,서구,138,27398,1337,28873,"2018-01-01",2018
"18-Jan",부산,수영구,160,65547,12077,77784,"2018-01-01",2018
"18-Jan",부산,연제구,838,86709,7846,95393,"2018-01-01",2018
"18-Jan",부산,영도구,223,32021,2636,34880,"2018-01-01",2018
"18-Jan",부산,중구,308,20254,6567,27129,"2018-01-01",2018
"18-Jan",부산,해운대구,287,159669,5358,165314,"2018-01-01",2018
"18-Jan",대구,계,3064,1108980,47735,1159779,"2018-01-01",2018
"18-Jan",대구,남구,362,56087,2021,58470,"2018-01-01",2018
"18-Jan",대구,달서구,455,256879,12020,269354,"2018-01-01",2018
"18-Jan",대구,달성군,448,118670,4348,123466,"2018-01-01",2018
"18-Jan",대구,동구,315,147712,10029,158056,"2018-01-01",2018
"18-Jan",대구,북구,461,190961,8083,199505,"2018-01-01",2018
"18-Jan",대구,서구,221,74716,4368,79305,"2018-01-01",2018
"18-Jan",대구,수성구,531,208225,5152,213908,"2018-01-01",2018
"18-Jan",대구,중구,271,55730,1714,57715,"2018-01-01",2018
"18-Jan",인천,계,3693,1219419,295147,1518259,"2018-01-01",2018
"18-Jan",인천,강화군,299,31682,2546,34527,"2018-01-01",2018
"18-Jan",인천,계양구,266,122370,151754,274390,"2018-01-01",2018
"18-Jan",인천,남구,387,146600,53965,200952,"2018-01-01",2018
"18-Jan",인천,남동구,855,236304,41043,278202,"2018-01-01",2018
"18-Jan",인천,동구,87,26189,2668,28944,"2018-01-01",2018
"18-Jan",인천,부평구,337,216498,7874,224709,"2018-01-01",2018
"18-Jan",인천,서구,367,215395,10748,226510,"2018-01-01",2018
"18-Jan",인천,연수구,327,159538,7351,167216,"2018-01-01",2018
"18-Jan",인천,옹진군,174,11460,157,11791,"2018-01-01",2018
"18-Jan",인천,중구,594,53383,17041,71018,"2018-01-01",2018
"18-Jan",인천,미추홀구,0,0,0,0,"2018-01-01",2018
"18-Jan",광주,계,2076,616072,32840,650988,"2018-01-01",2018
"18-Jan",광주,광산구,497,177107,10558,188162,"2018-01-01",2018
"18-Jan",광주,남구,180,84690,2768,87638,"2018-01-01",2018
"18-Jan",광주,동구,226,35740,1088,37054,"2018-01-01",2018
"18-Jan",광주,북구,479,178461,10957,189897,"2018-01-01",2018
"18-Jan",광주,서구,694,140074,7469,148237,"2018-01-01",2018
"18-Jan",대전,계,1834,630954,28348,661136,"2018-01-01",2018
"18-Jan",대전,대덕구,212,85169,6534,91915,"2018-01-01",2018
"18-Jan",대전,동구,229,86808,4135,91172,"2018-01-01",2018
"18-Jan",대전,서구,792,199429,7187,207408,"2018-01-01",2018
"18-Jan",대전,유성구,370,163366,4768,168504,"2018-01-01",2018
"18-Jan",대전,중구,231,96182,5724,102137,"2018-01-01",2018
"18-Jan",울산,계,1647,528090,21057,550794,"2018-01-01",2018
"18-Jan",울산,남구,672,151824,7082,159578,"2018-01-01",2018
"18-Jan",울산,동구,206,62540,876,63622,"2018-01-01",2018
"18-Jan",울산,북구,122,97229,4118,101469,"2018-01-01",2018
"18-Jan",울산,울주군,324,113587,6199,120110,"2018-01-01",2018
"18-Jan",울산,중구,323,102910,2782,106015,"2018-01-01",2018
"18-Jan",세종,계,679,128376,2368,131423,"2018-01-01",2018
"18-Jan",세종,세종특별자치시,679,128376,2368,131423,"2018-01-01",2018
"18-Jan",경기,계,15974,5170856,223841,5410671,"2018-01-01",2018
"18-Jan",경기,가평군,347,28457,673,29477,"2018-01-01",2018
"18-Jan",경기,고양시 덕양구,619,157346,3692,161657,"2018-01-01",2018
"18-Jan",경기,고양시 일산동구,263,115904,7599,123766,"2018-01-01",2018
"18-Jan",경기,고양시 일산서구,119,108054,3268,111441,"2018-01-01",2018
"18-Jan",경기,과천시,696,19868,581,21145,"2018-01-01",2018
"18-Jan",경기,광명시,296,103243,4200,107739,"2018-01-01",2018
"18-Jan",경기,광주시,367,166548,7757,174672,"2018-01-01",2018
"18-Jan",경기,구리시,221,67536,2374,70131,"2018-01-01",2018
"18-Jan",경기,군포시,272,94699,4983,99954,"2018-01-01",2018
"18-Jan",경기,김포시,447,175840,6647,182934,"2018-01-01",2018
"18-Jan",경기,남양주시,621,259621,6827,267069,"2018-01-01",2018
"18-Jan",경기,동두천시,204,36373,1279,37856,"2018-01-01",2018
"18-Jan",경기,부천시,696,290564,12046,303306,"2018-01-01",2018
"18-Jan",경기,성남시 분당구,326,183595,6684,190605,"2018-01-01",2018
"18-Jan",경기,성남시 수정구,316,69866,2735,72917,"2018-01-01",2018
"18-Jan",경기,성남시 중원구,275,71829,3846,75950,"2018-01-01",2018
"18-Jan",경기,수원시 권선구,326,165507,7298,173131,"2018-01-01",2018
"18-Jan",경기,수원시 영통구,210,131655,3225,135090,"2018-01-01",2018
"18-Jan",경기,수원시 장안구,604,105138,3973,109715,"2018-01-01",2018
"18-Jan",경기,수원시 팔달구,480,71420,3270,75170,"2018-01-01",2018
"18-Jan",경기,시흥시,449,196585,7530,204564,"2018-01-01",2018
"18-Jan",경기,안산시 단원구,516,145415,8291,154222,"2018-01-01",2018
"18-Jan",경기,안산시 상록구,166,138785,4635,143586,"2018-01-01",2018
"18-Jan",경기,안성시,342,92769,5037,98148,"2018-01-01",2018
"18-Jan",경기,안양시 동안구,374,116487,6530,123391,"2018-01-01",2018
"18-Jan",경기,안양시 만안구,146,84002,3705,87853,"2018-01-01",2018
"18-Jan",경기,양주시,345,91958,3005,95308,"2018-01-01",2018
"18-Jan",경기,양평군,483,54747,1688,56918,"2018-01-01",2018
"18-Jan",경기,여주시,392,58691,7321,66404,"2018-01-01",2018
"18-Jan",경기,연천군,276,22500,5585,28361,"2018-01-01",2018
"18-Jan",경기,오산시,230,90679,3160,94069,"2018-01-01",2018
"18-Jan",경기,용인시 기흥구,114,171683,8784,180581,"2018-01-01",2018
"18-Jan",경기,용인시 수지구,46,130104,2023,132173,"2018-01-01",2018
"18-Jan",경기,용인시 처인구,657,111205,6647,118509,"2018-01-01",2018
"18-Jan",경기,의왕시,288,57144,2791,60223,"2018-01-01",2018
"18-Jan",경기,의정부시,557,144909,4614,150080,"2018-01-01",2018
"18-Jan",경기,이천시,385,101862,5774,108021,"2018-01-01",2018
"18-Jan",경기,파주시,463,188198,9692,198353,"2018-01-01",2018
"18-Jan",경기,평택시,653,233265,10982,244900,"2018-01-01",2018
"18-Jan",경기,포천시,330,80661,9473,90464,"2018-01-01",2018
"18-Jan",경기,하남시,346,92543,2201,95090,"2018-01-01",2018
"18-Jan",경기,화성시,711,343601,11416,355728,"2018-01-01",2018
"18-Jan",강원,계,5460,718098,24384,747942,"2018-01-01",2018
"18-Jan",강원,강릉시,499,100050,4319,104868,"2018-01-01",2018
"18-Jan",강원,고성군,178,13416,237,13831,"2018-01-01",2018
"18-Jan",강원,동해시,291,42039,1334,43664,"2018-01-01",2018
"18-Jan",강원,삼척시,351,30101,681,31133,"2018-01-01",2018
"18-Jan",강원,속초시,288,34987,1318,36593,"2018-01-01",2018
"18-Jan",강원,양구군,138,11385,118,11641,"2018-01-01",2018
"18-Jan",강원,양양군,168,14037,202,14407,"2018-01-01",2018
"18-Jan",강원,영월군,314,19796,387,20497,"2018-01-01",2018
"18-Jan",강원,원주시,535,154885,5754,161174,"2018-01-01",2018
"18-Jan",강원,인제군,192,16924,220,17336,"2018-01-01",2018
"18-Jan",강원,정선군,300,19493,458,20251,"2018-01-01",2018
"18-Jan",강원,철원군,205,22751,291,23247,"2018-01-01",2018
"18-Jan",강원,춘천시,736,121840,5727,128303,"2018-01-01",2018
"18-Jan",강원,태백시,203,19988,823,21014,"2018-01-01",2018
"18-Jan",강원,평창군,277,24450,409,25136,"2018-01-01",2018
"18-Jan",강원,홍천군,370,36162,1091,37623,"2018-01-01",2018
"18-Jan",강원,화천군,185,11950,172,12307,"2018-01-01",2018
"18-Jan",강원,횡성군,230,23844,843,24917,"2018-01-01",2018
"18-Jan",충북,계,3682,753598,32684,789964,"2018-01-01",2018
"18-Jan",충북,괴산군,187,20944,359,21490,"2018-01-01",2018
"18-Jan",충북,단양군,194,14871,829,15894,"2018-01-01",2018
"18-Jan",충북,보은군,199,16925,984,18108,"2018-01-01",2018
"18-Jan",충북,영동군,217,24066,380,24663,"2018-01-01",2018
"18-Jan",충북,옥천군,187,25081,1108,26376,"2018-01-01",2018
"18-Jan",충북,음성군,221,54960,1720,56901,"2018-01-01",2018
"18-Jan",충북,제천시,304,63490,3392,67186,"2018-01-01",2018
"18-Jan",충북,증평군,86,17878,750,18714,"2018-01-01",2018
"18-Jan",충북,진천군,195,40601,1219,42015,"2018-01-01",2018
"18-Jan",충북,청원군,1,21,0,22,"2018-01-01",2018
"18-Jan",충북,청주시 상당구,455,74662,2473,77590,"2018-01-01",2018
"18-Jan",충북,청주시 서원구,221,91588,5695,97504,"2018-01-01",2018
"18-Jan",충북,청주시 청원구,328,95088,3832,99248,"2018-01-01",2018
"18-Jan",충북,청주시 흥덕구,359,113278,6169,119806,"2018-01-01",2018
"18-Jan",충북,충주시,528,100145,3774,104447,"2018-01-01",2018
"18-Jan",충남,계,5131,1017971,38415,1061517,"2018-01-01",2018
"18-Jan",충남,계룡시,138,20644,539,21321,"2018-01-01",2018
"18-Jan",충남,공주시,515,51088,1980,53583,"2018-01-01",2018
"18-Jan",충남,금산군,181,27034,2257,29472,"2018-01-01",2018
"18-Jan",충남,논산시,333,58111,2209,60653,"2018-01-01",2018
"18-Jan",충남,당진시,365,87392,3744,91501,"2018-01-01",2018
"18-Jan",충남,보령시,368,49177,1284,50829,"2018-01-01",2018
"18-Jan",충남,부여군,255,32771,1357,34383,"2018-01-01",2018
"18-Jan",충남,서산시,372,85024,3435,88831,"2018-01-01",2018
"18-Jan",충남,서천군,213,26280,957,27450,"2018-01-01",2018
"18-Jan",충남,아산시,422,151180,5918,157520,"2018-01-01",2018
"18-Jan",충남,예산군,336,40390,1387,42113,"2018-01-01",2018
"18-Jan",충남,천안시 동남구,241,119931,4680,124852,"2018-01-01",2018
"18-Jan",충남,천안시 서북구,518,171701,5843,178062,"2018-01-01",2018
"18-Jan",충남,청양군,226,15977,975,17178,"2018-01-01",2018
"18-Jan",충남,태안군,260,31966,477,32703,"2018-01-01",2018
"18-Jan",충남,홍성군,388,49305,1373,51066,"2018-01-01",2018
"18-Jan",전북,계,4618,850837,38899,894354,"2018-01-01",2018
"18-Jan",전북,고창군,237,29234,554,30025,"2018-01-01",2018
"18-Jan",전북,군산시,461,123351,6723,130535,"2018-01-01",2018
"18-Jan",전북,김제시,267,43072,1755,45094,"2018-01-01",2018
"18-Jan",전북,남원시,390,38479,3550,42419,"2018-01-01",2018
"18-Jan",전북,무주군,164,11946,364,12474,"2018-01-01",2018
"18-Jan",전북,부안군,251,26534,586,27371,"2018-01-01",2018
"18-Jan",전북,순창군,190,13780,204,14174,"2018-01-01",2018
"18-Jan",전북,완주군,309,49304,3394,53007,"2018-01-01",2018
"18-Jan",전북,익산시,478,132800,6184,139462,"2018-01-01",2018
"18-Jan",전북,임실군,193,13956,409,14558,"2018-01-01",2018
"18-Jan",전북,장수군,211,11348,180,11739,"2018-01-01",2018
"18-Jan",전북,전주시 덕진구,357,144157,7254,151768,"2018-01-01",2018
"18-Jan",전북,전주시 완산구,588,148562,4113,153263,"2018-01-01",2018
"18-Jan",전북,정읍시,304,51172,3429,54905,"2018-01-01",2018
"18-Jan",전북,진안군,218,13142,200,13560,"2018-01-01",2018
"18-Jan",전남,계,5633,873419,118867,997919,"2018-01-01",2018
"18-Jan",전남,강진군,200,17611,1080,18891,"2018-01-01",2018
"18-Jan",전남,고흥군,267,29231,655,30153,"2018-01-01",2018
"18-Jan",전남,곡성군,137,14011,806,14954,"2018-01-01",2018
"18-Jan",전남,광양시,234,75772,5916,81922,"2018-01-01",2018
"18-Jan",전남,구례군,116,12607,598,13321,"2018-01-01",2018
"18-Jan",전남,나주시,389,55856,3156,59401,"2018-01-01",2018
"18-Jan",전남,담양군,195,24868,1529,26592,"2018-01-01",2018
"18-Jan",전남,목포시,436,91836,5940,98212,"2018-01-01",2018
"18-Jan",전남,무안군,491,40098,1014,41603,"2018-01-01",2018
"18-Jan",전남,보성군,195,20484,68663,89342,"2018-01-01",2018
"18-Jan",전남,순천시,454,126618,4907,131979,"2018-01-01",2018
"18-Jan",전남,신안군,205,19636,749,20590,"2018-01-01",2018
"18-Jan",전남,여수시,520,121460,6867,128847,"2018-01-01",2018
"18-Jan",전남,영광군,212,25816,716,26744,"2018-01-01",2018
"18-Jan",전남,영암군,230,30578,10998,41806,"2018-01-01",2018
"18-Jan",전남,완도군,209,23475,475,24159,"2018-01-01",2018
"18-Jan",전남,장성군,140,24350,1035,25525,"2018-01-01",2018
"18-Jan",전남,장흥군,176,19055,438,19669,"2018-01-01",2018
"18-Jan",전남,진도군,148,15591,298,16037,"2018-01-01",2018
"18-Jan",전남,함평군,166,17084,381,17631,"2018-01-01",2018
"18-Jan",전남,해남군,308,36902,564,37774,"2018-01-01",2018
"18-Jan",전남,화순군,205,30480,2082,32767,"2018-01-01",2018
"18-Jan",경북,계,6795,1340672,48377,1395844,"2018-01-01",2018
"18-Jan",경북,경산시,390,128284,4239,132913,"2018-01-01",2018
"18-Jan",경북,경주시,526,132967,4972,138465,"2018-01-01",2018
"18-Jan",경북,고령군,154,20053,509,20716,"2018-01-01",2018
"18-Jan",경북,구미시,472,200623,7283,208378,"2018-01-01",2018
"18-Jan",경북,군위군,114,13948,274,14336,"2018-01-01",2018
"18-Jan",경북,김천시,340,69207,1787,71334,"2018-01-01",2018
"18-Jan",경북,문경시,272,34196,744,35212,"2018-01-01",2018
"18-Jan",경북,봉화군,195,16665,204,17064,"2018-01-01",2018
"18-Jan",경북,상주시,360,49988,1820,52168,"2018-01-01",2018
"18-Jan",경북,성주군,189,28899,1491,30579,"2018-01-01",2018
"18-Jan",경북,안동시,558,78575,2552,81685,"2018-01-01",2018
"18-Jan",경북,영덕군,235,18120,303,18658,"2018-01-01",2018
"18-Jan",경북,영양군,136,8972,95,9203,"2018-01-01",2018
"18-Jan",경북,영주시,331,53544,1516,55391,"2018-01-01",2018
"18-Jan",경북,영천시,254,55078,2625,57957,"2018-01-01",2018
"18-Jan",경북,예천군,189,24653,427,25269,"2018-01-01",2018
"18-Jan",경북,울릉군,140,4925,382,5447,"2018-01-01",2018
"18-Jan",경북,울진군,272,24844,357,25473,"2018-01-01",2018
"18-Jan",경북,의성군,287,28396,1016,29699,"2018-01-01",2018
"18-Jan",경북,청도군,183,23328,616,24127,"2018-01-01",2018
"18-Jan",경북,청송군,190,14402,197,14789,"2018-01-01",2018
"18-Jan",경북,칠곡군,315,66513,2201,69029,"2018-01-01",2018
"18-Jan",경북,포항시 남구,376,117498,8827,126701,"2018-01-01",2018
"18-Jan",경북,포항시 북구,317,126994,3940,131251,"2018-01-01",2018
"18-Jan",경남,계,6623,1581962,82756,1671341,"2018-01-01",2018
"18-Jan",경남,거제시,333,102630,2327,105290,"2018-01-01",2018
"18-Jan",경남,거창군,241,29845,788,30874,"2018-01-01",2018
"18-Jan",경남,고성군,201,25491,671,26363,"2018-01-01",2018
"18-Jan",경남,김해시,612,251147,6584,258343,"2018-01-01",2018
"18-Jan",경남,남해군,229,18390,498,19117,"2018-01-01",2018
"18-Jan",경남,밀양시,298,52798,4147,57243,"2018-01-01",2018
"18-Jan",경남,사천시,297,53014,1498,54809,"2018-01-01",2018
"18-Jan",경남,산청군,211,18721,787,19719,"2018-01-01",2018
"18-Jan",경남,양산시,373,149470,9242,159085,"2018-01-01",2018
"18-Jan",경남,의령군,185,13317,784,14286,"2018-01-01",2018
"18-Jan",경남,진주시,570,153327,6606,160503,"2018-01-01",2018
"18-Jan",경남,창녕군,223,33661,970,34854,"2018-01-01",2018
"18-Jan",경남,창원시 마산합포구,324,98780,2987,102091,"2018-01-01",2018
"18-Jan",경남,창원시 마산회원구,166,95669,5315,101150,"2018-01-01",2018
"18-Jan",경남,창원시 성산구,142,122020,18335,140497,"2018-01-01",2018
"18-Jan",경남,창원시 의창구,863,125048,5925,131836,"2018-01-01",2018
"18-Jan",경남,창원시 진해구,193,82943,1595,84731,"2018-01-01",2018
"18-Jan",경남,통영시,312,51426,1472,53210,"2018-01-01",2018
"18-Jan",경남,하동군,219,23644,458,24321,"2018-01-01",2018
"18-Jan",경남,함안군,185,40266,10737,51188,"2018-01-01",2018
"18-Jan",경남,함양군,200,18361,394,18955,"2018-01-01",2018
"18-Jan",경남,합천군,246,21994,636,22876,"2018-01-01",2018
"18-Jan",제주,계,2124,363943,138317,504384,"2018-01-01",2018
"18-Jan",제주,서귀포시,705,97182,2131,100018,"2018-01-01",2018
"18-Jan",제주,제주시,1419,266761,136186,404366,"2018-01-01",2018
"18-Feb",서울,계,11979,2906444,199702,3118125,"2018-02-01",2018
"18-Feb",서울,강남구,367,217903,19982,238252,"2018-02-01",2018
"18-Feb",서울,강동구,264,127813,8403,136480,"2018-02-01",2018
"18-Feb",서울,강북구,284,72849,4710,77843,"2018-02-01",2018
"18-Feb",서울,강서구,314,185981,16108,202403,"2018-02-01",2018
"18-Feb",서울,관악구,299,116302,5474,122075,"2018-02-01",2018
"18-Feb",서울,광진구,256,92744,5528,98528,"2018-02-01",2018
"18-Feb",서울,구로구,273,129715,13661,143649,"2018-02-01",2018
"18-Feb",서울,금천구,124,80044,6331,86499,"2018-02-01",2018
"18-Feb",서울,노원구,285,144887,9339,154511,"2018-02-01",2018
"18-Feb",서울,도봉구,246,89621,7435,97302,"2018-02-01",2018
"18-Feb",서울,동대문구,316,91750,5383,97449,"2018-02-01",2018
"18-Feb",서울,동작구,298,101575,2790,104663,"2018-02-01",2018
"18-Feb",서울,마포구,331,109813,6625,116769,"2018-02-01",2018
"18-Feb",서울,서대문구,424,80482,5515,86421,"2018-02-01",2018
"18-Feb",서울,서초구,571,169549,12260,182380,"2018-02-01",2018
"18-Feb",서울,성동구,318,94052,8974,103344,"2018-02-01",2018
"18-Feb",서울,성북구,284,111236,5457,116977,"2018-02-01",2018
"18-Feb",서울,송파구,352,219704,12619,232675,"2018-02-01",2018
"18-Feb",서울,양천구,327,141925,8717,150969,"2018-02-01",2018
"18-Feb",서울,영등포구,347,135804,9786,145937,"2018-02-01",2018
"18-Feb",서울,용산구,373,74911,2235,77519,"2018-02-01",2018
"18-Feb",서울,은평구,246,121900,6968,129114,"2018-02-01",2018
"18-Feb",서울,종로구,3825,45376,1573,50774,"2018-02-01",2018
"18-Feb",서울,중구,1054,46454,4097,51605,"2018-02-01",2018
"18-Feb",서울,중랑구,201,104054,9732,113987,"2018-02-01",2018
"18-Feb",부산,계,4524,1241487,93673,1339684,"2018-02-01",2018
"18-Feb",부산,강서구,315,65131,3643,69089,"2018-02-01",2018
"18-Feb",부산,금정구,263,81176,7399,88838,"2018-02-01",2018
"18-Feb",부산,기장군,238,68977,2132,71347,"2018-02-01",2018
"18-Feb",부산,남구,219,87154,8675,96048,"2018-02-01",2018
"18-Feb",부산,동구,230,42919,4797,47946,"2018-02-01",2018
"18-Feb",부산,동래구,180,87727,4261,92168,"2018-02-01",2018
"18-Feb",부산,부산진구,359,121203,9340,130902,"2018-02-01",2018
"18-Feb",부산,북구,233,100828,3252,104313,"2018-02-01",2018
"18-Feb",부산,사상구,273,85318,6095,91686,"2018-02-01",2018
"18-Feb",부산,사하구,256,108761,6971,115988,"2018-02-01",2018
"18-Feb",부산,서구,138,27568,1344,29050,"2018-02-01",2018
"18-Feb",부산,수영구,163,65412,12726,78301,"2018-02-01",2018
"18-Feb",부산,연제구,834,86812,8454,96100,"2018-02-01",2018
"18-Feb",부산,영도구,226,31977,2641,34844,"2018-02-01",2018
"18-Feb",부산,중구,306,20390,6575,27271,"2018-02-01",2018
"18-Feb",부산,해운대구,291,160134,5368,165793,"2018-02-01",2018
"18-Feb",대구,계,3072,1110270,47744,1161086,"2018-02-01",2018
"18-Feb",대구,남구,362,56133,2024,58519,"2018-02-01",2018
"18-Feb",대구,달서구,455,256838,11973,269266,"2018-02-01",2018
"18-Feb",대구,달성군,449,119268,4415,124132,"2018-02-01",2018
"18-Feb",대구,동구,318,147949,10036,158303,"2018-02-01",2018
"18-Feb",대구,북구,463,191276,8102,199841,"2018-02-01",2018
"18-Feb",대구,서구,221,74686,4343,79250,"2018-02-01",2018
"18-Feb",대구,수성구,534,208524,5144,214202,"2018-02-01",2018
"18-Feb",대구,중구,270,55596,1707,57573,"2018-02-01",2018
"18-Feb",인천,계,3695,1222092,297252,1523039,"2018-02-01",2018
"18-Feb",인천,강화군,297,31718,2539,34554,"2018-02-01",2018
"18-Feb",인천,계양구,268,121902,153462,275632,"2018-02-01",2018
"18-Feb",인천,남구,388,147081,53882,201351,"2018-02-01",2018
"18-Feb",인천,남동구,853,236835,41199,278887,"2018-02-01",2018
"18-Feb",인천,동구,90,26221,2731,29042,"2018-02-01",2018
"18-Feb",인천,부평구,336,216462,8205,225003,"2018-02-01",2018
"18-Feb",인천,서구,370,216640,10715,227725,"2018-02-01",2018
"18-Feb",인천,연수구,328,160281,7369,167978,"2018-02-01",2018
"18-Feb",인천,옹진군,174,11420,161,11755,"2018-02-01",2018
"18-Feb",인천,중구,591,53532,16989,71112,"2018-02-01",2018
"18-Feb",인천,미추홀구,0,0,0,0,"2018-02-01",2018
"18-Feb",광주,계,2059,616912,32826,651797,"2018-02-01",2018
"18-Feb",광주,광산구,490,177371,10579,188440,"2018-02-01",2018
"18-Feb",광주,남구,178,84749,2771,87698,"2018-02-01",2018
"18-Feb",광주,동구,223,35776,1085,37084,"2018-02-01",2018
"18-Feb",광주,북구,476,178981,10931,190388,"2018-02-01",2018
"18-Feb",광주,서구,692,140035,7460,148187,"2018-02-01",2018
"18-Feb",대전,계,1833,630919,28472,661224,"2018-02-01",2018
"18-Feb",대전,대덕구,212,85129,6556,91897,"2018-02-01",2018
"18-Feb",대전,동구,230,86633,4132,90995,"2018-02-01",2018
"18-Feb",대전,서구,793,199577,7204,207574,"2018-02-01",2018
"18-Feb",대전,유성구,368,163448,4879,168695,"2018-02-01",2018
"18-Feb",대전,중구,230,96132,5701,102063,"2018-02-01",2018
"18-Feb",울산,계,1651,528754,21125,551530,"2018-02-01",2018
"18-Feb",울산,남구,671,151711,7150,159532,"2018-02-01",2018
"18-Feb",울산,동구,205,62407,890,63502,"2018-02-01",2018
"18-Feb",울산,북구,125,97878,4133,102136,"2018-02-01",2018
"18-Feb",울산,울주군,324,113988,6209,120521,"2018-02-01",2018
"18-Feb",울산,중구,326,102770,2743,105839,"2018-02-01",2018
"18-Feb",세종,계,679,130389,2361,133429,"2018-02-01",2018
"18-Feb",세종,세종특별자치시,679,130389,2361,133429,"2018-02-01",2018
"18-Feb",경기,계,15982,5180342,223639,5419963,"2018-02-01",2018
"18-Feb",경기,가평군,349,28492,674,29515,"2018-02-01",2018
"18-Feb",경기,고양시 덕양구,622,157552,3685,161859,"2018-02-01",2018
"18-Feb",경기,고양시 일산동구,267,116005,7547,123819,"2018-02-01",2018
"18-Feb",경기,고양시 일산서구,121,107999,3268,111388,"2018-02-01",2018
"18-Feb",경기,과천시,686,19878,584,21148,"2018-02-01",2018
"18-Feb",경기,광명시,303,102917,4181,107401,"2018-02-01",2018
"18-Feb",경기,광주시,362,166782,7746,174890,"2018-02-01",2018
"18-Feb",경기,구리시,236,67616,2373,70225,"2018-02-01",2018
"18-Feb",경기,군포시,270,94594,4974,99838,"2018-02-01",2018
"18-Feb",경기,김포시,447,176639,6696,183782,"2018-02-01",2018
"18-Feb",경기,남양주시,622,260275,6804,267701,"2018-02-01",2018
"18-Feb",경기,동두천시,202,36244,1290,37736,"2018-02-01",2018
"18-Feb",경기,부천시,693,290415,12035,303143,"2018-02-01",2018
"18-Feb",경기,성남시 분당구,329,183578,6665,190572,"2018-02-01",2018
"18-Feb",경기,성남시 수정구,315,69850,2741,72906,"2018-02-01",2018
"18-Feb",경기,성남시 중원구,290,71633,3894,75817,"2018-02-01",2018
"18-Feb",경기,수원시 권선구,324,166451,7298,174073,"2018-02-01",2018
"18-Feb",경기,수원시 영통구,204,131777,3246,135227,"2018-02-01",2018
"18-Feb",경기,수원시 장안구,582,105115,3970,109667,"2018-02-01",2018
"18-Feb",경기,수원시 팔달구,480,71162,3269,74911,"2018-02-01",2018
"18-Feb",경기,시흥시,449,198201,7423,206073,"2018-02-01",2018
"18-Feb",경기,안산시 단원구,524,144655,8427,153606,"2018-02-01",2018
"18-Feb",경기,안산시 상록구,161,137821,4627,142609,"2018-02-01",2018
"18-Feb",경기,안성시,343,92835,5018,98196,"2018-02-01",2018
"18-Feb",경기,안양시 동안구,373,116237,6529,123139,"2018-02-01",2018
"18-Feb",경기,안양시 만안구,149,83917,3693,87759,"2018-02-01",2018
"18-Feb",경기,양주시,351,92090,3039,95480,"2018-02-01",2018
"18-Feb",경기,양평군,487,54903,1677,57067,"2018-02-01",2018
"18-Feb",경기,여주시,391,58543,7274,66208,"2018-02-01",2018
"18-Feb",경기,연천군,277,22568,5525,28370,"2018-02-01",2018
"18-Feb",경기,오산시,226,91356,3160,94742,"2018-02-01",2018
"18-Feb",경기,용인시 기흥구,113,171726,8767,180606,"2018-02-01",2018
"18-Feb",경기,용인시 수지구,46,130277,2025,132348,"2018-02-01",2018
"18-Feb",경기,용인시 처인구,657,111514,6619,118790,"2018-02-01",2018
"18-Feb",경기,의왕시,280,57010,2822,60112,"2018-02-01",2018
"18-Feb",경기,의정부시,557,145015,4649,150221,"2018-02-01",2018
"18-Feb",경기,이천시,384,101929,5790,108103,"2018-02-01",2018
"18-Feb",경기,파주시,462,188474,9646,198582,"2018-02-01",2018
"18-Feb",경기,평택시,654,233859,11047,245560,"2018-02-01",2018
"18-Feb",경기,포천시,331,80506,9318,90155,"2018-02-01",2018
"18-Feb",경기,하남시,345,93382,2194,95921,"2018-02-01",2018
"18-Feb",경기,화성시,718,348550,11430,360698,"2018-02-01",2018
"18-Feb",강원,계,5490,719044,24539,749073,"2018-02-01",2018
"18-Feb",강원,강릉시,502,100105,4370,104977,"2018-02-01",2018
"18-Feb",강원,고성군,177,13396,236,13809,"2018-02-01",2018
"18-Feb",강원,동해시,289,42027,1338,43654,"2018-02-01",2018
"18-Feb",강원,삼척시,357,30207,679,31243,"2018-02-01",2018
"18-Feb",강원,속초시,288,35006,1326,36620,"2018-02-01",2018
"18-Feb",강원,양구군,139,11350,117,11606,"2018-02-01",2018
"18-Feb",강원,양양군,168,14091,201,14460,"2018-02-01",2018
"18-Feb",강원,영월군,316,19821,385,20522,"2018-02-01",2018
"18-Feb",강원,원주시,546,155166,5805,161517,"2018-02-01",2018
"18-Feb",강원,인제군,191,16909,224,17324,"2018-02-01",2018
"18-Feb",강원,정선군,300,19529,460,20289,"2018-02-01",2018
"18-Feb",강원,철원군,206,22826,292,23324,"2018-02-01",2018
"18-Feb",강원,춘천시,737,122108,5770,128615,"2018-02-01",2018
"18-Feb",강원,태백시,202,19946,820,20968,"2018-02-01",2018
"18-Feb",강원,평창군,282,24485,409,25176,"2018-02-01",2018
"18-Feb",강원,홍천군,373,36214,1096,37683,"2018-02-01",2018
"18-Feb",강원,화천군,185,11937,172,12294,"2018-02-01",2018
"18-Feb",강원,횡성군,232,23921,839,24992,"2018-02-01",2018
"18-Feb",충북,계,3695,754961,32726,791382,"2018-02-01",2018
"18-Feb",충북,괴산군,185,20954,359,21498,"2018-02-01",2018
"18-Feb",충북,단양군,196,14896,822,15914,"2018-02-01",2018
"18-Feb",충북,보은군,198,16998,984,18180,"2018-02-01",2018
"18-Feb",충북,영동군,218,24157,382,24757,"2018-02-01",2018
"18-Feb",충북,옥천군,187,25121,1116,26424,"2018-02-01",2018
"18-Feb",충북,음성군,218,55081,1717,57016,"2018-02-01",2018
"18-Feb",충북,제천시,304,63402,3402,67108,"2018-02-01",2018
"18-Feb",충북,증평군,85,17893,750,18728,"2018-02-01",2018
"18-Feb",충북,진천군,202,40876,1214,42292,"2018-02-01",2018
"18-Feb",충북,청원군,1,21,0,22,"2018-02-01",2018
"18-Feb",충북,청주시 상당구,460,74804,2462,77726,"2018-02-01",2018
"18-Feb",충북,청주시 서원구,224,91648,5730,97602,"2018-02-01",2018
"18-Feb",충북,청주시 청원구,330,95127,3846,99303,"2018-02-01",2018
"18-Feb",충북,청주시 흥덕구,362,113588,6177,120127,"2018-02-01",2018
"18-Feb",충북,충주시,525,100395,3765,104685,"2018-02-01",2018
"18-Feb",충남,계,5151,1021205,38424,1064780,"2018-02-01",2018
"18-Feb",충남,계룡시,138,20696,542,21376,"2018-02-01",2018
"18-Feb",충남,공주시,517,51115,2017,53649,"2018-02-01",2018
"18-Feb",충남,금산군,182,27172,2197,29551,"2018-02-01",2018
"18-Feb",충남,논산시,334,58177,2214,60725,"2018-02-01",2018
"18-Feb",충남,당진시,366,87740,3753,91859,"2018-02-01",2018
"18-Feb",충남,보령시,372,49273,1298,50943,"2018-02-01",2018
"18-Feb",충남,부여군,252,32834,1352,34438,"2018-02-01",2018
"18-Feb",충남,서산시,374,85260,3437,89071,"2018-02-01",2018
"18-Feb",충남,서천군,217,26324,919,27460,"2018-02-01",2018
"18-Feb",충남,아산시,426,151551,5897,157874,"2018-02-01",2018
"18-Feb",충남,예산군,340,40580,1394,42314,"2018-02-01",2018
"18-Feb",충남,천안시 동남구,242,119907,4716,124865,"2018-02-01",2018
"18-Feb",충남,천안시 서북구,517,173169,5853,179539,"2018-02-01",2018
"18-Feb",충남,청양군,226,15999,975,17200,"2018-02-01",2018
"18-Feb",충남,태안군,262,32025,483,32770,"2018-02-01",2018
"18-Feb",충남,홍성군,386,49383,1377,51146,"2018-02-01",2018
"18-Feb",전북,계,4630,852130,38917,895677,"2018-02-01",2018
"18-Feb",전북,고창군,239,29085,559,29883,"2018-02-01",2018
"18-Feb",전북,군산시,463,123419,6724,130606,"2018-02-01",2018
"18-Feb",전북,김제시,266,43063,1749,45078,"2018-02-01",2018
"18-Feb",전북,남원시,392,38551,3491,42434,"2018-02-01",2018
"18-Feb",전북,무주군,165,11982,367,12514,"2018-02-01",2018
"18-Feb",전북,부안군,251,26537,586,27374,"2018-02-01",2018
"18-Feb",전북,순창군,191,13807,202,14200,"2018-02-01",2018
"18-Feb",전북,완주군,308,49221,3395,52924,"2018-02-01",2018
"18-Feb",전북,익산시,482,132807,6208,139497,"2018-02-01",2018
"18-Feb",전북,임실군,193,13896,408,14497,"2018-02-01",2018
"18-Feb",전북,장수군,212,11409,180,11801,"2018-02-01",2018
"18-Feb",전북,전주시 덕진구,359,145446,7296,153101,"2018-02-01",2018
"18-Feb",전북,전주시 완산구,587,148596,4136,153319,"2018-02-01",2018
"18-Feb",전북,정읍시,304,51139,3418,54861,"2018-02-01",2018
"18-Feb",전북,진안군,218,13172,198,13588,"2018-02-01",2018
"18-Feb",전남,계,5624,874433,119454,999511,"2018-02-01",2018
"18-Feb",전남,강진군,196,17659,1076,18931,"2018-02-01",2018
"18-Feb",전남,고흥군,267,29281,654,30202,"2018-02-01",2018
"18-Feb",전남,곡성군,136,14033,822,14991,"2018-02-01",2018
"18-Feb",전남,광양시,233,75665,5892,81790,"2018-02-01",2018
"18-Feb",전남,구례군,117,12570,598,13285,"2018-02-01",2018
"18-Feb",전남,나주시,393,56137,3164,59694,"2018-02-01",2018
"18-Feb",전남,담양군,197,24939,1516,26652,"2018-02-01",2018
"18-Feb",전남,목포시,433,91830,5942,98205,"2018-02-01",2018
"18-Feb",전남,무안군,484,40066,1003,41553,"2018-02-01",2018
"18-Feb",전남,보성군,191,20542,69927,90660,"2018-02-01",2018
"18-Feb",전남,순천시,448,126990,4914,132352,"2018-02-01",2018
"18-Feb",전남,신안군,203,19641,746,20590,"2018-02-01",2018
"18-Feb",전남,여수시,520,121538,6925,128983,"2018-02-01",2018
"18-Feb",전남,영광군,219,25738,716,26673,"2018-02-01",2018
"18-Feb",전남,영암군,233,30640,10288,41161,"2018-02-01",2018
"18-Feb",전남,완도군,207,23527,477,24211,"2018-02-01",2018
"18-Feb",전남,장성군,142,24510,1035,25687,"2018-02-01",2018
"18-Feb",전남,장흥군,176,19026,437,19639,"2018-02-01",2018
"18-Feb",전남,진도군,151,15583,303,16037,"2018-02-01",2018
"18-Feb",전남,함평군,164,17124,378,17666,"2018-02-01",2018
"18-Feb",전남,해남군,310,36865,564,37739,"2018-02-01",2018
"18-Feb",전남,화순군,204,30529,2077,32810,"2018-02-01",2018
"18-Feb",경북,계,6780,1342157,48276,1397213,"2018-02-01",2018
"18-Feb",경북,경산시,391,128139,4229,132759,"2018-02-01",2018
"18-Feb",경북,경주시,525,133074,4917,138516,"2018-02-01",2018
"18-Feb",경북,고령군,154,20043,509,20706,"2018-02-01",2018
"18-Feb",경북,구미시,472,201207,7282,208961,"2018-02-01",2018
"18-Feb",경북,군위군,114,13963,273,14350,"2018-02-01",2018
"18-Feb",경북,김천시,339,69290,1783,71412,"2018-02-01",2018
"18-Feb",경북,문경시,271,34198,747,35216,"2018-02-01",2018
"18-Feb",경북,봉화군,191,16668,203,17062,"2018-02-01",2018
"18-Feb",경북,상주시,356,50034,1824,52214,"2018-02-01",2018
"18-Feb",경북,성주군,189,28825,1492,30506,"2018-02-01",2018
"18-Feb",경북,안동시,554,78444,2549,81547,"2018-02-01",2018
"18-Feb",경북,영덕군,236,18187,301,18724,"2018-02-01",2018
"18-Feb",경북,영양군,137,8964,95,9196,"2018-02-01",2018
"18-Feb",경북,영주시,330,53598,1514,55442,"2018-02-01",2018
"18-Feb",경북,영천시,251,55181,2605,58037,"2018-02-01",2018
"18-Feb",경북,예천군,189,25111,430,25730,"2018-02-01",2018
"18-Feb",경북,울릉군,141,4965,384,5490,"2018-02-01",2018
"18-Feb",경북,울진군,274,24872,356,25502,"2018-02-01",2018
"18-Feb",경북,의성군,288,28369,1012,29669,"2018-02-01",2018
"18-Feb",경북,청도군,184,23460,620,24264,"2018-02-01",2018
"18-Feb",경북,청송군,190,14472,197,14859,"2018-02-01",2018
"18-Feb",경북,칠곡군,316,66490,2199,69005,"2018-02-01",2018
"18-Feb",경북,포항시 남구,374,117451,8806,126631,"2018-02-01",2018
"18-Feb",경북,포항시 북구,314,127152,3949,131415,"2018-02-01",2018
"18-Feb",경남,계,6624,1584249,82509,1673382,"2018-02-01",2018
"18-Feb",경남,거제시,328,102497,2286,105111,"2018-02-01",2018
"18-Feb",경남,거창군,243,29956,788,30987,"2018-02-01",2018
"18-Feb",경남,고성군,206,25516,664,26386,"2018-02-01",2018
"18-Feb",경남,김해시,616,251559,6654,258829,"2018-02-01",2018
"18-Feb",경남,남해군,232,18449,494,19175,"2018-02-01",2018
"18-Feb",경남,밀양시,298,52819,4123,57240,"2018-02-01",2018
"18-Feb",경남,사천시,299,53033,1482,54814,"2018-02-01",2018
"18-Feb",경남,산청군,211,18760,767,19738,"2018-02-01",2018
"18-Feb",경남,양산시,369,150028,9248,159645,"2018-02-01",2018
"18-Feb",경남,의령군,185,13365,787,14337,"2018-02-01",2018
"18-Feb",경남,진주시,568,153646,6623,160837,"2018-02-01",2018
"18-Feb",경남,창녕군,222,33804,993,35019,"2018-02-01",2018
"18-Feb",경남,창원시 마산합포구,322,99020,2955,102297,"2018-02-01",2018
"18-Feb",경남,창원시 마산회원구,165,95459,5268,100892,"2018-02-01",2018
"18-Feb",경남,창원시 성산구,139,122116,18167,140422,"2018-02-01",2018
"18-Feb",경남,창원시 의창구,857,125233,5984,132074,"2018-02-01",2018
"18-Feb",경남,창원시 진해구,193,83206,1591,84990,"2018-02-01",2018
"18-Feb",경남,통영시,316,51498,1492,53306,"2018-02-01",2018
"18-Feb",경남,하동군,219,23652,457,24328,"2018-02-01",2018
"18-Feb",경남,함안군,190,40191,10662,51043,"2018-02-01",2018
"18-Feb",경남,함양군,200,18408,390,18998,"2018-02-01",2018
"18-Feb",경남,합천군,246,22034,634,22914,"2018-02-01",2018
"18-Feb",제주,계,2136,364605,140981,507722,"2018-02-01",2018
"18-Feb",제주,서귀포시,708,97628,2125,100461,"2018-02-01",2018
"18-Feb",제주,제주시,1428,266977,138856,407261,"2018-02-01",2018
"18-Mar",서울,계,11913,2905510,199268,3116691,"2018-03-01",2018
"18-Mar",서울,강남구,370,217687,19801,237858,"2018-03-01",2018
"18-Mar",서울,강동구,265,127754,8450,136469,"2018-03-01",2018
"18-Mar",서울,강북구,296,72793,4662,77751,"2018-03-01",2018
"18-Mar",서울,강서구,317,186223,16272,202812,"2018-03-01",2018
"18-Mar",서울,관악구,296,116213,5446,121955,"2018-03-01",2018
"18-Mar",서울,광진구,270,92490,5477,98237,"2018-03-01",2018
"18-Mar",서울,구로구,274,129666,13575,143515,"2018-03-01",2018
"18-Mar",서울,금천구,124,80050,6252,86426,"2018-03-01",2018
"18-Mar",서울,노원구,288,144776,9287,154351,"2018-03-01",2018
"18-Mar",서울,도봉구,249,89543,7440,97232,"2018-03-01",2018
"18-Mar",서울,동대문구,318,91706,5321,97345,"2018-03-01",2018
"18-Mar",서울,동작구,302,101370,2776,104448,"2018-03-01",2018
"18-Mar",서울,마포구,328,109783,6547,116658,"2018-03-01",2018
"18-Mar",서울,서대문구,425,80439,5524,86388,"2018-03-01",2018
"18-Mar",서울,서초구,570,169249,12359,182178,"2018-03-01",2018
"18-Mar",서울,성동구,318,94557,9049,103924,"2018-03-01",2018
"18-Mar",서울,성북구,286,111225,5472,116983,"2018-03-01",2018
"18-Mar",서울,송파구,359,220000,12617,232976,"2018-03-01",2018
"18-Mar",서울,양천구,328,141881,8642,150851,"2018-03-01",2018
"18-Mar",서울,영등포구,348,135474,9737,145559,"2018-03-01",2018
"18-Mar",서울,용산구,372,74995,2212,77579,"2018-03-01",2018
"18-Mar",서울,은평구,249,121950,6960,129159,"2018-03-01",2018
"18-Mar",서울,종로구,3706,45277,1590,50573,"2018-03-01",2018
"18-Mar",서울,중구,1054,46365,4103,51522,"2018-03-01",2018
"18-Mar",서울,중랑구,201,104044,9697,113942,"2018-03-01",2018
"18-Mar",부산,계,4542,1242485,95340,1342367,"2018-03-01",2018
"18-Mar",부산,강서구,315,65416,3661,69392,"2018-03-01",2018
"18-Mar",부산,금정구,264,81257,7349,88870,"2018-03-01",2018
"18-Mar",부산,기장군,239,69075,2132,71446,"2018-03-01",2018
"18-Mar",부산,남구,221,87951,8680,96852,"2018-03-01",2018
"18-Mar",부산,동구,231,43086,4737,48054,"2018-03-01",2018
"18-Mar",부산,동래구,182,87688,4260,92130,"2018-03-01",2018
"18-Mar",부산,부산진구,368,120909,9673,130950,"2018-03-01",2018
"18-Mar",부산,북구,231,100687,3236,104154,"2018-03-01",2018
"18-Mar",부산,사상구,273,85235,6072,91580,"2018-03-01",2018
"18-Mar",부산,사하구,257,108746,6963,115966,"2018-03-01",2018
"18-Mar",부산,서구,138,27617,1349,29104,"2018-03-01",2018
"18-Mar",부산,수영구,163,65200,13541,78904,"2018-03-01",2018
"18-Mar",부산,연제구,835,86752,9093,96680,"2018-03-01",2018
"18-Mar",부산,영도구,225,31927,2649,34801,"2018-03-01",2018
"18-Mar",부산,중구,308,20652,6549,27509,"2018-03-01",2018
"18-Mar",부산,해운대구,292,160287,5396,165975,"2018-03-01",2018
"18-Mar",대구,계,3076,1112376,47701,1163153,"2018-03-01",2018
"18-Mar",대구,남구,364,56232,2009,58605,"2018-03-01",2018
"18-Mar",대구,달서구,455,257135,11985,269575,"2018-03-01",2018
"18-Mar",대구,달성군,452,119974,4464,124890,"2018-03-01",2018
"18-Mar",대구,동구,319,148756,9968,159043,"2018-03-01",2018
"18-Mar",대구,북구,472,191586,8118,200176,"2018-03-01",2018
"18-Mar",대구,서구,222,74466,4345,79033,"2018-03-01",2018
"18-Mar",대구,수성구,524,208876,5127,214527,"2018-03-01",2018
"18-Mar",대구,중구,268,55351,1685,57304,"2018-03-01",2018
"18-Mar",인천,계,3705,1225889,298063,1527657,"2018-03-01",2018
"18-Mar",인천,강화군,297,31793,2539,34629,"2018-03-01",2018
"18-Mar",인천,계양구,272,121401,153888,275561,"2018-03-01",2018
"18-Mar",인천,남구,388,148247,54087,202722,"2018-03-01",2018
"18-Mar",인천,남동구,850,237550,41040,279440,"2018-03-01",2018
"18-Mar",인천,동구,85,26064,2722,28871,"2018-03-01",2018
"18-Mar",인천,부평구,335,216433,8318,225086,"2018-03-01",2018
"18-Mar",인천,서구,371,218389,10664,229424,"2018-03-01",2018
"18-Mar",인천,연수구,334,160763,7570,168667,"2018-03-01",2018
"18-Mar",인천,옹진군,180,11456,168,11804,"2018-03-01",2018
"18-Mar",인천,중구,593,53793,17067,71453,"2018-03-01",2018
"18-Mar",인천,미추홀구,0,0,0,0,"2018-03-01",2018
"18-Mar",광주,계,2074,617966,32683,652723,"2018-03-01",2018
"18-Mar",광주,광산구,492,177675,10654,188821,"2018-03-01",2018
"18-Mar",광주,남구,178,84723,2771,87672,"2018-03-01",2018
"18-Mar",광주,동구,225,35754,1032,37011,"2018-03-01",2018
"18-Mar",광주,북구,481,179566,10831,190878,"2018-03-01",2018
"18-Mar",광주,서구,698,140248,7395,148341,"2018-03-01",2018
"18-Mar",대전,계,1817,631521,28495,661833,"2018-03-01",2018
"18-Mar",대전,대덕구,208,85250,6543,92001,"2018-03-01",2018
"18-Mar",대전,동구,228,86755,4107,91090,"2018-03-01",2018
"18-Mar",대전,서구,785,199811,7213,207809,"2018-03-01",2018
"18-Mar",대전,유성구,367,163556,4945,168868,"2018-03-01",2018
"18-Mar",대전,중구,229,96149,5687,102065,"2018-03-01",2018
"18-Mar",울산,계,1659,529918,21042,552619,"2018-03-01",2018
"18-Mar",울산,남구,670,151779,7109,159558,"2018-03-01",2018
"18-Mar",울산,동구,204,62459,894,63557,"2018-03-01",2018
"18-Mar",울산,북구,127,98774,4099,103000,"2018-03-01",2018
"18-Mar",울산,울주군,332,114193,6201,120726,"2018-03-01",2018
"18-Mar",울산,중구,326,102713,2739,105778,"2018-03-01",2018
"18-Mar",세종,계,686,132279,2355,135320,"2018-03-01",2018
"18-Mar",세종,세종특별자치시,686,132279,2355,135320,"2018-03-01",2018
"18-Mar",경기,계,16041,5199046,223768,5438855,"2018-03-01",2018
"18-Mar",경기,가평군,347,28603,678,29628,"2018-03-01",2018
"18-Mar",경기,고양시 덕양구,622,158043,3680,162345,"2018-03-01",2018
"18-Mar",경기,고양시 일산동구,272,116088,7093,123453,"2018-03-01",2018
"18-Mar",경기,고양시 일산서구,123,108228,3669,112020,"2018-03-01",2018
"18-Mar",경기,과천시,692,19851,585,21128,"2018-03-01",2018
"18-Mar",경기,광명시,296,103241,4193,107730,"2018-03-01",2018
"18-Mar",경기,광주시,362,167445,7775,175582,"2018-03-01",2018
"18-Mar",경기,구리시,237,67625,2379,70241,"2018-03-01",2018
"18-Mar",경기,군포시,269,94577,4983,99829,"2018-03-01",2018
"18-Mar",경기,김포시,446,178727,6705,185878,"2018-03-01",2018
"18-Mar",경기,남양주시,625,261726,6878,269229,"2018-03-01",2018
"18-Mar",경기,동두천시,204,36293,1290,37787,"2018-03-01",2018
"18-Mar",경기,부천시,699,290749,12016,303464,"2018-03-01",2018
"18-Mar",경기,성남시 분당구,330,183731,6708,190769,"2018-03-01",2018
"18-Mar",경기,성남시 수정구,317,69968,2709,72994,"2018-03-01",2018
"18-Mar",경기,성남시 중원구,297,71578,3880,75755,"2018-03-01",2018
"18-Mar",경기,수원시 권선구,330,167655,7316,175301,"2018-03-01",2018
"18-Mar",경기,수원시 영통구,206,131940,3265,135411,"2018-03-01",2018
"18-Mar",경기,수원시 장안구,581,104647,3967,109195,"2018-03-01",2018
"18-Mar",경기,수원시 팔달구,476,70520,3288,74284,"2018-03-01",2018
"18-Mar",경기,시흥시,444,200164,7391,207999,"2018-03-01",2018
"18-Mar",경기,안산시 단원구,525,144128,8418,153071,"2018-03-01",2018
"18-Mar",경기,안산시 상록구,161,137306,4652,142119,"2018-03-01",2018
"18-Mar",경기,안성시,344,93326,4998,98668,"2018-03-01",2018
"18-Mar",경기,안양시 동안구,376,116126,6531,123033,"2018-03-01",2018
"18-Mar",경기,안양시 만안구,149,83963,3689,87801,"2018-03-01",2018
"18-Mar",경기,양주시,359,92490,3035,95884,"2018-03-01",2018
"18-Mar",경기,양평군,497,55180,1709,57386,"2018-03-01",2018
"18-Mar",경기,여주시,393,58727,7299,66419,"2018-03-01",2018
"18-Mar",경기,연천군,278,22657,5469,28404,"2018-03-01",2018
"18-Mar",경기,오산시,224,91969,3164,95357,"2018-03-01",2018
"18-Mar",경기,용인시 기흥구,111,172060,8745,180916,"2018-03-01",2018
"18-Mar",경기,용인시 수지구,46,130631,2030,132707,"2018-03-01",2018
"18-Mar",경기,용인시 처인구,656,111989,6633,119278,"2018-03-01",2018
"18-Mar",경기,의왕시,281,56955,2799,60035,"2018-03-01",2018
"18-Mar",경기,의정부시,557,145339,4636,150532,"2018-03-01",2018
"18-Mar",경기,이천시,385,102244,5800,108429,"2018-03-01",2018
"18-Mar",경기,파주시,466,189139,9794,199399,"2018-03-01",2018
"18-Mar",경기,평택시,654,235217,11069,246940,"2018-03-01",2018
"18-Mar",경기,포천시,335,80583,9170,90088,"2018-03-01",2018
"18-Mar",경기,하남시,345,94177,2211,96733,"2018-03-01",2018
"18-Mar",경기,화성시,724,353441,11469,365634,"2018-03-01",2018
"18-Mar",강원,계,5480,720930,24614,751024,"2018-03-01",2018
"18-Mar",강원,강릉시,500,100395,4349,105244,"2018-03-01",2018
"18-Mar",강원,고성군,177,13382,233,13792,"2018-03-01",2018
"18-Mar",강원,동해시,283,42012,1340,43635,"2018-03-01",2018
"18-Mar",강원,삼척시,362,30296,678,31336,"2018-03-01",2018
"18-Mar",강원,속초시,287,35062,1325,36674,"2018-03-01",2018
"18-Mar",강원,양구군,142,11424,116,11682,"2018-03-01",2018
"18-Mar",강원,양양군,166,14114,202,14482,"2018-03-01",2018
"18-Mar",강원,영월군,308,19819,382,20509,"2018-03-01",2018
"18-Mar",강원,원주시,547,155625,5842,162014,"2018-03-01",2018
"18-Mar",강원,인제군,191,16913,225,17329,"2018-03-01",2018
"18-Mar",강원,정선군,301,19596,458,20355,"2018-03-01",2018
"18-Mar",강원,철원군,211,22888,290,23389,"2018-03-01",2018
"18-Mar",강원,춘천시,733,122555,5775,129063,"2018-03-01",2018
"18-Mar",강원,태백시,202,20005,819,21026,"2018-03-01",2018
"18-Mar",강원,평창군,280,24462,471,25213,"2018-03-01",2018
"18-Mar",강원,홍천군,371,36374,1093,37838,"2018-03-01",2018
"18-Mar",강원,화천군,187,11971,177,12335,"2018-03-01",2018
"18-Mar",강원,횡성군,232,24037,839,25108,"2018-03-01",2018
"18-Mar",충북,계,3706,757237,32802,793745,"2018-03-01",2018
"18-Mar",충북,괴산군,187,21021,360,21568,"2018-03-01",2018
"18-Mar",충북,단양군,196,14977,819,15992,"2018-03-01",2018
"18-Mar",충북,보은군,195,17022,986,18203,"2018-03-01",2018
"18-Mar",충북,영동군,218,24182,386,24786,"2018-03-01",2018
"18-Mar",충북,옥천군,187,25190,1121,26498,"2018-03-01",2018
"18-Mar",충북,음성군,218,55103,1722,57043,"2018-03-01",2018
"18-Mar",충북,제천시,305,63519,3430,67254,"2018-03-01",2018
"18-Mar",충북,증평군,85,17949,747,18781,"2018-03-01",2018
"18-Mar",충북,진천군,204,41236,1204,42644,"2018-03-01",2018
"18-Mar",충북,청원군,1,21,0,22,"2018-03-01",2018
"18-Mar",충북,청주시 상당구,464,75168,2463,78095,"2018-03-01",2018
"18-Mar",충북,청주시 서원구,224,91636,5735,97595,"2018-03-01",2018
"18-Mar",충북,청주시 청원구,332,95609,3858,99799,"2018-03-01",2018
"18-Mar",충북,청주시 흥덕구,359,113761,6181,120301,"2018-03-01",2018
"18-Mar",충북,충주시,531,100843,3790,105164,"2018-03-01",2018
"18-Mar",충남,계,5178,1025023,38350,1068551,"2018-03-01",2018
"18-Mar",충남,계룡시,139,20716,546,21401,"2018-03-01",2018
"18-Mar",충남,공주시,518,51186,2010,53714,"2018-03-01",2018
"18-Mar",충남,금산군,182,27247,2148,29577,"2018-03-01",2018
"18-Mar",충남,논산시,332,58339,2207,60878,"2018-03-01",2018
"18-Mar",충남,당진시,372,88182,3764,92318,"2018-03-01",2018
"18-Mar",충남,보령시,373,49451,1251,51075,"2018-03-01",2018
"18-Mar",충남,부여군,260,32906,1349,34515,"2018-03-01",2018
"18-Mar",충남,서산시,376,85655,3429,89460,"2018-03-01",2018
"18-Mar",충남,서천군,219,26351,900,27470,"2018-03-01",2018
"18-Mar",충남,아산시,427,151985,5929,158341,"2018-03-01",2018
"18-Mar",충남,예산군,340,40709,1397,42446,"2018-03-01",2018
"18-Mar",충남,천안시 동남구,243,120413,4690,125346,"2018-03-01",2018
"18-Mar",충남,천안시 서북구,521,174264,5882,180667,"2018-03-01",2018
"18-Mar",충남,청양군,227,16070,945,17242,"2018-03-01",2018
"18-Mar",충남,태안군,259,32054,479,32792,"2018-03-01",2018
"18-Mar",충남,홍성군,390,49495,1424,51309,"2018-03-01",2018
"18-Mar",전북,계,4654,853581,38834,897069,"2018-03-01",2018
"18-Mar",전북,고창군,241,29079,558,29878,"2018-03-01",2018
"18-Mar",전북,군산시,464,123697,6752,130913,"2018-03-01",2018
"18-Mar",전북,김제시,267,43125,1785,45177,"2018-03-01",2018
"18-Mar",전북,남원시,394,38554,3431,42379,"2018-03-01",2018
"18-Mar",전북,무주군,166,12027,367,12560,"2018-03-01",2018
"18-Mar",전북,부안군,251,26547,588,27386,"2018-03-01",2018
"18-Mar",전북,순창군,195,13836,209,14240,"2018-03-01",2018
"18-Mar",전북,완주군,310,49149,3384,52843,"2018-03-01",2018
"18-Mar",전북,익산시,477,132957,6230,139664,"2018-03-01",2018
"18-Mar",전북,임실군,194,13878,407,14479,"2018-03-01",2018
"18-Mar",전북,장수군,212,11429,179,11820,"2018-03-01",2018
"18-Mar",전북,전주시 덕진구,364,146759,7284,154407,"2018-03-01",2018
"18-Mar",전북,전주시 완산구,590,148076,4131,152797,"2018-03-01",2018
"18-Mar",전북,정읍시,306,51250,3332,54888,"2018-03-01",2018
"18-Mar",전북,진안군,223,13218,197,13638,"2018-03-01",2018
"18-Mar",전남,계,5672,876870,120729,1003271,"2018-03-01",2018
"18-Mar",전남,강진군,196,17629,1064,18889,"2018-03-01",2018
"18-Mar",전남,고흥군,267,29400,655,30322,"2018-03-01",2018
"18-Mar",전남,곡성군,137,14081,814,15032,"2018-03-01",2018
"18-Mar",전남,광양시,235,75798,5909,81942,"2018-03-01",2018
"18-Mar",전남,구례군,116,12635,599,13350,"2018-03-01",2018
"18-Mar",전남,나주시,414,56544,3157,60115,"2018-03-01",2018
"18-Mar",전남,담양군,199,25024,1509,26732,"2018-03-01",2018
"18-Mar",전남,목포시,431,91972,5922,98325,"2018-03-01",2018
"18-Mar",전남,무안군,487,40147,1013,41647,"2018-03-01",2018
"18-Mar",전남,보성군,196,20572,69158,89926,"2018-03-01",2018
"18-Mar",전남,순천시,444,127314,4988,132746,"2018-03-01",2018
"18-Mar",전남,신안군,205,19706,753,20664,"2018-03-01",2018
"18-Mar",전남,여수시,522,121795,6938,129255,"2018-03-01",2018
"18-Mar",전남,영광군,224,25841,716,26781,"2018-03-01",2018
"18-Mar",전남,영암군,229,30756,12281,43266,"2018-03-01",2018
"18-Mar",전남,완도군,208,23599,479,24286,"2018-03-01",2018
"18-Mar",전남,장성군,143,24618,1036,25797,"2018-03-01",2018
"18-Mar",전남,장흥군,186,19092,440,19718,"2018-03-01",2018
"18-Mar",전남,진도군,151,15631,298,16080,"2018-03-01",2018
"18-Mar",전남,함평군,163,17178,364,17705,"2018-03-01",2018
"18-Mar",전남,해남군,315,36927,570,37812,"2018-03-01",2018
"18-Mar",전남,화순군,204,30611,2066,32881,"2018-03-01",2018
"18-Mar",경북,계,6807,1344581,48209,1399597,"2018-03-01",2018
"18-Mar",경북,경산시,392,128328,4164,132884,"2018-03-01",2018
"18-Mar",경북,경주시,538,133338,4903,138779,"2018-03-01",2018
"18-Mar",경북,고령군,154,20068,515,20737,"2018-03-01",2018
"18-Mar",경북,구미시,470,201811,7258,209539,"2018-03-01",2018
"18-Mar",경북,군위군,112,14058,272,14442,"2018-03-01",2018
"18-Mar",경북,김천시,336,69386,1791,71513,"2018-03-01",2018
"18-Mar",경북,문경시,270,34252,754,35276,"2018-03-01",2018
"18-Mar",경북,봉화군,192,16779,202,17173,"2018-03-01",2018
"18-Mar",경북,상주시,353,50045,1827,52225,"2018-03-01",2018
"18-Mar",경북,성주군,187,28850,1486,30523,"2018-03-01",2018
"18-Mar",경북,안동시,556,78417,2542,81515,"2018-03-01",2018
"18-Mar",경북,영덕군,237,18208,300,18745,"2018-03-01",2018
"18-Mar",경북,영양군,137,9018,93,9248,"2018-03-01",2018
"18-Mar",경북,영주시,330,53714,1511,55555,"2018-03-01",2018
"18-Mar",경북,영천시,261,55234,2607,58102,"2018-03-01",2018
"18-Mar",경북,예천군,195,25422,429,26046,"2018-03-01",2018
"18-Mar",경북,울릉군,141,4970,386,5497,"2018-03-01",2018
"18-Mar",경북,울진군,275,24854,356,25485,"2018-03-01",2018
"18-Mar",경북,의성군,288,28427,1037,29752,"2018-03-01",2018
"18-Mar",경북,청도군,184,23501,621,24306,"2018-03-01",2018
"18-Mar",경북,청송군,190,14506,197,14893,"2018-03-01",2018
"18-Mar",경북,칠곡군,317,66541,2216,69074,"2018-03-01",2018
"18-Mar",경북,포항시 남구,376,117445,8795,126616,"2018-03-01",2018
"18-Mar",경북,포항시 북구,316,127409,3947,131672,"2018-03-01",2018
"18-Mar",경남,계,6657,1587805,82675,1677137,"2018-03-01",2018
"18-Mar",경남,거제시,335,102359,2249,104943,"2018-03-01",2018
"18-Mar",경남,거창군,244,30062,788,31094,"2018-03-01",2018
"18-Mar",경남,고성군,206,25516,658,26380,"2018-03-01",2018
"18-Mar",경남,김해시,614,252131,6657,259402,"2018-03-01",2018
"18-Mar",경남,남해군,232,18468,485,19185,"2018-03-01",2018
"18-Mar",경남,밀양시,302,52907,4107,57316,"2018-03-01",2018
"18-Mar",경남,사천시,295,53175,1476,54946,"2018-03-01",2018
"18-Mar",경남,산청군,213,18816,759,19788,"2018-03-01",2018
"18-Mar",경남,양산시,374,151055,9258,160687,"2018-03-01",2018
"18-Mar",경남,의령군,185,13393,785,14363,"2018-03-01",2018
"18-Mar",경남,진주시,585,154110,6614,161309,"2018-03-01",2018
"18-Mar",경남,창녕군,223,33956,993,35172,"2018-03-01",2018
"18-Mar",경남,창원시 마산합포구,321,99279,2988,102588,"2018-03-01",2018
"18-Mar",경남,창원시 마산회원구,166,95178,5187,100531,"2018-03-01",2018
"18-Mar",경남,창원시 성산구,139,122179,17957,140275,"2018-03-01",2018
"18-Mar",경남,창원시 의창구,859,125533,6321,132713,"2018-03-01",2018
"18-Mar",경남,창원시 진해구,196,83731,1596,85523,"2018-03-01",2018
"18-Mar",경남,통영시,316,51535,1522,53373,"2018-03-01",2018
"18-Mar",경남,하동군,217,23697,454,24368,"2018-03-01",2018
"18-Mar",경남,함안군,189,40161,10795,51145,"2018-03-01",2018
"18-Mar",경남,함양군,200,18456,390,19046,"2018-03-01",2018
"18-Mar",경남,합천군,246,22108,636,22990,"2018-03-01",2018
"18-Mar",제주,계,2155,365128,144907,512190,"2018-03-01",2018
"18-Mar",제주,서귀포시,712,98116,2092,100920,"2018-03-01",2018
"18-Mar",제주,제주시,1443,267012,142815,411270,"2018-03-01",2018
"18-Apr",서울,계,11963,2907904,199596,3119463,"2018-04-01",2018
"18-Apr",서울,강남구,375,217420,19745,237540,"2018-04-01",2018
"18-Apr",서울,강동구,266,127952,8438,136656,"2018-04-01",2018
"18-Apr",서울,강북구,301,72816,4652,77769,"2018-04-01",2018
"18-Apr",서울,강서구,316,186428,16289,203033,"2018-04-01",2018
"18-Apr",서울,관악구,296,116222,5462,121980,"2018-04-01",2018
"18-Apr",서울,광진구,269,92453,5537,98259,"2018-04-01",2018
"18-Apr",서울,구로구,275,129727,13704,143706,"2018-04-01",2018
"18-Apr",서울,금천구,123,80059,6211,86393,"2018-04-01",2018
"18-Apr",서울,노원구,292,144747,9240,154279,"2018-04-01",2018
"18-Apr",서울,도봉구,249,89515,7414,97178,"2018-04-01",2018
"18-Apr",서울,동대문구,318,91732,5304,97354,"2018-04-01",2018
"18-Apr",서울,동작구,305,101389,2763,104457,"2018-04-01",2018
"18-Apr",서울,마포구,330,109848,6787,116965,"2018-04-01",2018
"18-Apr",서울,서대문구,425,80464,5467,86356,"2018-04-01",2018
"18-Apr",서울,서초구,584,169577,12509,182670,"2018-04-01",2018
"18-Apr",서울,성동구,322,95203,8873,104398,"2018-04-01",2018
"18-Apr",서울,성북구,287,111205,5462,116954,"2018-04-01",2018
"18-Apr",서울,송파구,362,220545,12833,233740,"2018-04-01",2018
"18-Apr",서울,양천구,327,141899,8617,150843,"2018-04-01",2018
"18-Apr",서울,영등포구,352,135793,9705,145850,"2018-04-01",2018
"18-Apr",서울,용산구,375,75090,2206,77671,"2018-04-01",2018
"18-Apr",서울,은평구,255,122019,6971,129245,"2018-04-01",2018
"18-Apr",서울,종로구,3701,45252,1587,50540,"2018-04-01",2018
"18-Apr",서울,중구,1051,46318,4129,51498,"2018-04-01",2018
"18-Apr",서울,중랑구,207,104231,9691,114129,"2018-04-01",2018
"18-Apr",부산,계,4558,1244599,97092,1346249,"2018-04-01",2018
"18-Apr",부산,강서구,318,65565,3675,69558,"2018-04-01",2018
"18-Apr",부산,금정구,266,81480,7346,89092,"2018-04-01",2018
"18-Apr",부산,기장군,241,69205,2136,71582,"2018-04-01",2018
"18-Apr",부산,남구,221,88547,8646,97414,"2018-04-01",2018
"18-Apr",부산,동구,231,43324,4685,48240,"2018-04-01",2018
"18-Apr",부산,동래구,185,87868,4271,92324,"2018-04-01",2018
"18-Apr",부산,부산진구,369,120898,9849,131116,"2018-04-01",2018
"18-Apr",부산,북구,231,100818,3242,104291,"2018-04-01",2018
"18-Apr",부산,사상구,275,85214,6071,91560,"2018-04-01",2018
"18-Apr",부산,사하구,260,108830,6949,116039,"2018-04-01",2018
"18-Apr",부산,서구,140,27628,1348,29116,"2018-04-01",2018
"18-Apr",부산,수영구,161,65019,14778,79958,"2018-04-01",2018
"18-Apr",부산,연제구,832,86768,9606,97206,"2018-04-01",2018
"18-Apr",부산,영도구,224,31926,2652,34802,"2018-04-01",2018
"18-Apr",부산,중구,308,20923,6504,27735,"2018-04-01",2018
"18-Apr",부산,해운대구,296,160586,5334,166216,"2018-04-01",2018
"18-Apr",대구,계,3117,1113482,47621,1164220,"2018-04-01",2018
"18-Apr",대구,남구,367,56255,2006,58628,"2018-04-01",2018
"18-Apr",대구,달서구,461,257407,11964,269832,"2018-04-01",2018
"18-Apr",대구,달성군,459,120453,4414,125326,"2018-04-01",2018
"18-Apr",대구,동구,327,149153,10163,159643,"2018-04-01",2018
"18-Apr",대구,북구,475,191777,7890,200142,"2018-04-01",2018
"18-Apr",대구,서구,225,74418,4379,79022,"2018-04-01",2018
"18-Apr",대구,수성구,535,208710,5109,214354,"2018-04-01",2018
"18-Apr",대구,중구,268,55309,1696,57273,"2018-04-01",2018
"18-Apr",인천,계,3670,1230234,299079,1532983,"2018-04-01",2018
"18-Apr",인천,강화군,295,31910,2516,34721,"2018-04-01",2018
"18-Apr",인천,계양구,270,121252,155095,276617,"2018-04-01",2018
"18-Apr",인천,남구,391,149091,53950,203432,"2018-04-01",2018
"18-Apr",인천,남동구,822,239214,41016,281052,"2018-04-01",2018
"18-Apr",인천,동구,85,26077,2623,28785,"2018-04-01",2018
"18-Apr",인천,부평구,327,216360,8196,224883,"2018-04-01",2018
"18-Apr",인천,서구,366,219693,10664,230723,"2018-04-01",2018
"18-Apr",인천,연수구,329,161272,7688,169289,"2018-04-01",2018
"18-Apr",인천,옹진군,186,11491,205,11882,"2018-04-01",2018
"18-Apr",인천,중구,599,53874,17126,71599,"2018-04-01",2018
"18-Apr",인천,미추홀구,0,0,0,0,"2018-04-01",2018
"18-Apr",광주,계,2086,619155,32668,653909,"2018-04-01",2018
"18-Apr",광주,광산구,494,178307,10800,189601,"2018-04-01",2018
"18-Apr",광주,남구,179,84887,2723,87789,"2018-04-01",2018
"18-Apr",광주,동구,228,35789,1044,37061,"2018-04-01",2018
"18-Apr",광주,북구,486,180005,10756,191247,"2018-04-01",2018
"18-Apr",광주,서구,699,140167,7345,148211,"2018-04-01",2018
"18-Apr",대전,계,1810,632543,28609,662962,"2018-04-01",2018
"18-Apr",대전,대덕구,206,85178,6687,92071,"2018-04-01",2018
"18-Apr",대전,동구,234,86950,4060,91244,"2018-04-01",2018
"18-Apr",대전,서구,777,200144,7269,208190,"2018-04-01",2018
"18-Apr",대전,유성구,366,163999,4913,169278,"2018-04-01",2018
"18-Apr",대전,중구,227,96272,5680,102179,"2018-04-01",2018
"18-Apr",울산,계,1661,531229,21003,553893,"2018-04-01",2018
"18-Apr",울산,남구,670,151891,7193,159754,"2018-04-01",2018
"18-Apr",울산,동구,200,62495,878,63573,"2018-04-01",2018
"18-Apr",울산,북구,136,99428,4060,103624,"2018-04-01",2018
"18-Apr",울산,울주군,333,114637,6129,121099,"2018-04-01",2018
"18-Apr",울산,중구,322,102778,2743,105843,"2018-04-01",2018
"18-Apr",세종,계,676,134270,2371,137317,"2018-04-01",2018
"18-Apr",세종,세종특별자치시,676,134270,2371,137317,"2018-04-01",2018
"18-Apr",경기,계,16142,5220816,223557,5460515,"2018-04-01",2018
"18-Apr",경기,가평군,353,28696,678,29727,"2018-04-01",2018
"18-Apr",경기,고양시 덕양구,626,158719,3650,162995,"2018-04-01",2018
"18-Apr",경기,고양시 일산동구,273,116303,7087,123663,"2018-04-01",2018
"18-Apr",경기,고양시 일산서구,123,108199,3837,112159,"2018-04-01",2018
"18-Apr",경기,과천시,691,19853,588,21132,"2018-04-01",2018
"18-Apr",경기,광명시,295,103617,4206,108118,"2018-04-01",2018
"18-Apr",경기,광주시,361,168554,7762,176677,"2018-04-01",2018
"18-Apr",경기,구리시,239,67884,2396,70519,"2018-04-01",2018
"18-Apr",경기,군포시,273,94751,4995,100019,"2018-04-01",2018
"18-Apr",경기,김포시,455,180168,6742,187365,"2018-04-01",2018
"18-Apr",경기,남양주시,630,263033,6929,270592,"2018-04-01",2018
"18-Apr",경기,동두천시,203,36424,1283,37910,"2018-04-01",2018
"18-Apr",경기,부천시,701,291556,12119,304376,"2018-04-01",2018
"18-Apr",경기,성남시 분당구,332,183738,6705,190775,"2018-04-01",2018
"18-Apr",경기,성남시 수정구,321,70143,2707,73171,"2018-04-01",2018
"18-Apr",경기,성남시 중원구,299,71591,3877,75767,"2018-04-01",2018
"18-Apr",경기,수원시 권선구,335,169163,7339,176837,"2018-04-01",2018
"18-Apr",경기,수원시 영통구,206,132294,3316,135816,"2018-04-01",2018
"18-Apr",경기,수원시 장안구,582,104844,3973,109399,"2018-04-01",2018
"18-Apr",경기,수원시 팔달구,481,70179,3246,73906,"2018-04-01",2018
"18-Apr",경기,시흥시,444,201664,7422,209530,"2018-04-01",2018
"18-Apr",경기,안산시 단원구,524,144196,8394,153114,"2018-04-01",2018
"18-Apr",경기,안산시 상록구,168,137442,4628,142238,"2018-04-01",2018
"18-Apr",경기,안성시,338,93832,4994,99164,"2018-04-01",2018
"18-Apr",경기,안양시 동안구,377,116245,6502,123124,"2018-04-01",2018
"18-Apr",경기,안양시 만안구,148,84133,3702,87983,"2018-04-01",2018
"18-Apr",경기,양주시,368,92775,2998,96141,"2018-04-01",2018
"18-Apr",경기,양평군,502,55386,1702,57590,"2018-04-01",2018
"18-Apr",경기,여주시,406,59015,7284,66705,"2018-04-01",2018
"18-Apr",경기,연천군,285,22726,5496,28507,"2018-04-01",2018
"18-Apr",경기,오산시,226,92747,3150,96123,"2018-04-01",2018
"18-Apr",경기,용인시 기흥구,110,172567,8675,181352,"2018-04-01",2018
"18-Apr",경기,용인시 수지구,46,131030,2015,133091,"2018-04-01",2018
"18-Apr",경기,용인시 처인구,656,112392,6622,119670,"2018-04-01",2018
"18-Apr",경기,의왕시,283,57004,2791,60078,"2018-04-01",2018
"18-Apr",경기,의정부시,560,145865,4624,151049,"2018-04-01",2018
"18-Apr",경기,이천시,382,102779,5843,109004,"2018-04-01",2018
"18-Apr",경기,파주시,470,189976,9597,200043,"2018-04-01",2018
"18-Apr",경기,평택시,653,236472,11076,248201,"2018-04-01",2018
"18-Apr",경기,포천시,334,80758,8969,90061,"2018-04-01",2018
"18-Apr",경기,하남시,357,94778,2223,97358,"2018-04-01",2018
"18-Apr",경기,화성시,726,357325,11415,369466,"2018-04-01",2018
"18-Apr",강원,계,5492,723025,24567,753084,"2018-04-01",2018
"18-Apr",강원,강릉시,501,100831,4378,105710,"2018-04-01",2018
"18-Apr",강원,고성군,180,13406,231,13817,"2018-04-01",2018
"18-Apr",강원,동해시,284,42052,1345,43681,"2018-04-01",2018
"18-Apr",강원,삼척시,362,30512,685,31559,"2018-04-01",2018
"18-Apr",강원,속초시,291,35111,1326,36728,"2018-04-01",2018
"18-Apr",강원,양구군,143,11477,117,11737,"2018-04-01",2018
"18-Apr",강원,양양군,170,14169,202,14541,"2018-04-01",2018
"18-Apr",강원,영월군,312,19872,365,20549,"2018-04-01",2018
"18-Apr",강원,원주시,547,156188,5828,162563,"2018-04-01",2018
"18-Apr",강원,인제군,191,16973,225,17389,"2018-04-01",2018
"18-Apr",강원,정선군,301,19622,451,20374,"2018-04-01",2018
"18-Apr",강원,철원군,211,22973,286,23470,"2018-04-01",2018
"18-Apr",강원,춘천시,728,122718,5743,129189,"2018-04-01",2018
"18-Apr",강원,태백시,202,20024,802,21028,"2018-04-01",2018
"18-Apr",강원,평창군,281,24545,470,25296,"2018-04-01",2018
"18-Apr",강원,홍천군,372,36343,1090,37805,"2018-04-01",2018
"18-Apr",강원,화천군,187,12035,193,12415,"2018-04-01",2018
"18-Apr",강원,횡성군,229,24174,830,25233,"2018-04-01",2018
"18-Apr",충북,계,3728,760246,32780,796754,"2018-04-01",2018
"18-Apr",충북,괴산군,190,21086,355,21631,"2018-04-01",2018
"18-Apr",충북,단양군,196,15096,818,16110,"2018-04-01",2018
"18-Apr",충북,보은군,198,17082,986,18266,"2018-04-01",2018
"18-Apr",충북,영동군,218,24241,384,24843,"2018-04-01",2018
"18-Apr",충북,옥천군,188,25295,1119,26602,"2018-04-01",2018
"18-Apr",충북,음성군,219,55197,1710,57126,"2018-04-01",2018
"18-Apr",충북,제천시,307,63721,3455,67483,"2018-04-01",2018
"18-Apr",충북,증평군,85,18016,743,18844,"2018-04-01",2018
"18-Apr",충북,진천군,205,41658,1208,43071,"2018-04-01",2018
"18-Apr",충북,청원군,1,21,0,22,"2018-04-01",2018
"18-Apr",충북,청주시 상당구,467,75419,2437,78323,"2018-04-01",2018
"18-Apr",충북,청주시 서원구,225,91720,5748,97693,"2018-04-01",2018
"18-Apr",충북,청주시 청원구,336,96203,3856,100395,"2018-04-01",2018
"18-Apr",충북,청주시 흥덕구,359,114164,6175,120698,"2018-04-01",2018
"18-Apr",충북,충주시,534,101327,3786,105647,"2018-04-01",2018
"18-Apr",충남,계,5203,1028187,38240,1071630,"2018-04-01",2018
"18-Apr",충남,계룡시,139,20710,548,21397,"2018-04-01",2018
"18-Apr",충남,공주시,515,51298,2004,53817,"2018-04-01",2018
"18-Apr",충남,금산군,181,27260,2027,29468,"2018-04-01",2018
"18-Apr",충남,논산시,334,58415,2202,60951,"2018-04-01",2018
"18-Apr",충남,당진시,378,88395,3758,92531,"2018-04-01",2018
"18-Apr",충남,보령시,378,49448,1250,51076,"2018-04-01",2018
"18-Apr",충남,부여군,263,32924,1355,34542,"2018-04-01",2018
"18-Apr",충남,서산시,375,86006,3442,89823,"2018-04-01",2018
"18-Apr",충남,서천군,223,26395,884,27502,"2018-04-01",2018
"18-Apr",충남,아산시,431,152521,5931,158883,"2018-04-01",2018
"18-Apr",충남,예산군,343,40813,1403,42559,"2018-04-01",2018
"18-Apr",충남,천안시 동남구,245,120918,4613,125776,"2018-04-01",2018
"18-Apr",충남,천안시 서북구,518,175114,5972,181604,"2018-04-01",2018
"18-Apr",충남,청양군,229,16102,945,17276,"2018-04-01",2018
"18-Apr",충남,태안군,259,32247,482,32988,"2018-04-01",2018
"18-Apr",충남,홍성군,392,49621,1424,51437,"2018-04-01",2018
"18-Apr",전북,계,4691,856115,39040,899846,"2018-04-01",2018
"18-Apr",전북,고창군,246,29187,554,29987,"2018-04-01",2018
"18-Apr",전북,군산시,467,123936,6735,131138,"2018-04-01",2018
"18-Apr",전북,김제시,277,43243,1812,45332,"2018-04-01",2018
"18-Apr",전북,남원시,393,38667,3704,42764,"2018-04-01",2018
"18-Apr",전북,무주군,169,12047,363,12579,"2018-04-01",2018
"18-Apr",전북,부안군,249,26665,591,27505,"2018-04-01",2018
"18-Apr",전북,순창군,192,13902,196,14290,"2018-04-01",2018
"18-Apr",전북,완주군,317,49239,3323,52879,"2018-04-01",2018
"18-Apr",전북,익산시,478,133155,6210,139843,"2018-04-01",2018
"18-Apr",전북,임실군,198,13910,412,14520,"2018-04-01",2018
"18-Apr",전북,장수군,214,11485,179,11878,"2018-04-01",2018
"18-Apr",전북,전주시 덕진구,366,147959,7256,155581,"2018-04-01",2018
"18-Apr",전북,전주시 완산구,595,148058,4118,152771,"2018-04-01",2018
"18-Apr",전북,정읍시,307,51410,3392,55109,"2018-04-01",2018
"18-Apr",전북,진안군,223,13252,195,13670,"2018-04-01",2018
"18-Apr",전남,계,5734,879612,121382,1006728,"2018-04-01",2018
"18-Apr",전남,강진군,200,17711,1057,18968,"2018-04-01",2018
"18-Apr",전남,고흥군,277,29510,658,30445,"2018-04-01",2018
"18-Apr",전남,곡성군,138,14147,809,15094,"2018-04-01",2018
"18-Apr",전남,광양시,240,76029,5923,82192,"2018-04-01",2018
"18-Apr",전남,구례군,119,12659,600,13378,"2018-04-01",2018
"18-Apr",전남,나주시,412,56899,3138,60449,"2018-04-01",2018
"18-Apr",전남,담양군,203,25115,1494,26812,"2018-04-01",2018
"18-Apr",전남,목포시,430,92095,6039,98564,"2018-04-01",2018
"18-Apr",전남,무안군,505,40281,958,41744,"2018-04-01",2018
"18-Apr",전남,보성군,193,20610,69950,90753,"2018-04-01",2018
"18-Apr",전남,순천시,449,127733,5002,133184,"2018-04-01",2018
"18-Apr",전남,신안군,208,19827,751,20786,"2018-04-01",2018
"18-Apr",전남,여수시,532,122056,6859,129447,"2018-04-01",2018
"18-Apr",전남,영광군,230,25876,714,26820,"2018-04-01",2018
"18-Apr",전남,영암군,228,30852,12205,43285,"2018-04-01",2018
"18-Apr",전남,완도군,213,23666,486,24365,"2018-04-01",2018
"18-Apr",전남,장성군,142,24740,1035,25917,"2018-04-01",2018
"18-Apr",전남,장흥군,186,19180,436,19802,"2018-04-01",2018
"18-Apr",전남,진도군,144,15678,290,16112,"2018-04-01",2018
"18-Apr",전남,함평군,164,17251,366,17781,"2018-04-01",2018
"18-Apr",전남,해남군,319,36997,566,37882,"2018-04-01",2018
"18-Apr",전남,화순군,202,30700,2046,32948,"2018-04-01",2018
"18-Apr",경북,계,6817,1347762,48194,1402773,"2018-04-01",2018
"18-Apr",경북,경산시,394,128614,4174,133182,"2018-04-01",2018
"18-Apr",경북,경주시,537,133558,4869,138964,"2018-04-01",2018
"18-Apr",경북,고령군,152,20092,513,20757,"2018-04-01",2018
"18-Apr",경북,구미시,471,202231,7253,209955,"2018-04-01",2018
"18-Apr",경북,군위군,111,14159,269,14539,"2018-04-01",2018
"18-Apr",경북,김천시,331,69636,1794,71761,"2018-04-01",2018
"18-Apr",경북,문경시,271,34345,754,35370,"2018-04-01",2018
"18-Apr",경북,봉화군,193,16878,202,17273,"2018-04-01",2018
"18-Apr",경북,상주시,350,50153,1820,52323,"2018-04-01",2018
"18-Apr",경북,성주군,186,28922,1480,30588,"2018-04-01",2018
"18-Apr",경북,안동시,556,78555,2560,81671,"2018-04-01",2018
"18-Apr",경북,영덕군,236,18271,297,18804,"2018-04-01",2018
"18-Apr",경북,영양군,138,9064,93,9295,"2018-04-01",2018
"18-Apr",경북,영주시,332,53760,1506,55598,"2018-04-01",2018
"18-Apr",경북,영천시,265,55417,2609,58291,"2018-04-01",2018
"18-Apr",경북,예천군,195,25635,431,26261,"2018-04-01",2018
"18-Apr",경북,울릉군,141,5039,394,5574,"2018-04-01",2018
"18-Apr",경북,울진군,277,24879,359,25515,"2018-04-01",2018
"18-Apr",경북,의성군,293,28561,1031,29885,"2018-04-01",2018
"18-Apr",경북,청도군,185,23563,623,24371,"2018-04-01",2018
"18-Apr",경북,청송군,189,14523,197,14909,"2018-04-01",2018
"18-Apr",경북,칠곡군,321,66636,2217,69174,"2018-04-01",2018
"18-Apr",경북,포항시 남구,376,117262,8815,126453,"2018-04-01",2018
"18-Apr",경북,포항시 북구,317,128009,3934,132260,"2018-04-01",2018
"18-Apr",경남,계,6734,1590165,82570,1679469,"2018-04-01",2018
"18-Apr",경남,거제시,336,102280,2257,104873,"2018-04-01",2018
"18-Apr",경남,거창군,245,30183,786,31214,"2018-04-01",2018
"18-Apr",경남,고성군,207,25589,659,26455,"2018-04-01",2018
"18-Apr",경남,김해시,624,252582,6645,259851,"2018-04-01",2018
"18-Apr",경남,남해군,237,18536,491,19264,"2018-04-01",2018
"18-Apr",경남,밀양시,303,52998,4082,57383,"2018-04-01",2018
"18-Apr",경남,사천시,294,53302,1479,55075,"2018-04-01",2018
"18-Apr",경남,산청군,213,18918,764,19895,"2018-04-01",2018
"18-Apr",경남,양산시,376,151852,9201,161429,"2018-04-01",2018
"18-Apr",경남,의령군,188,13495,782,14465,"2018-04-01",2018
"18-Apr",경남,진주시,590,154336,6614,161540,"2018-04-01",2018
"18-Apr",경남,창녕군,229,34067,1010,35306,"2018-04-01",2018
"18-Apr",경남,창원시 마산합포구,328,99289,2973,102590,"2018-04-01",2018
"18-Apr",경남,창원시 마산회원구,167,94818,5181,100166,"2018-04-01",2018
"18-Apr",경남,창원시 성산구,142,121977,17704,139823,"2018-04-01",2018
"18-Apr",경남,창원시 의창구,877,125833,6462,133172,"2018-04-01",2018
"18-Apr",경남,창원시 진해구,198,84033,1598,85829,"2018-04-01",2018
"18-Apr",경남,통영시,319,51576,1519,53414,"2018-04-01",2018
"18-Apr",경남,하동군,218,23699,442,24359,"2018-04-01",2018
"18-Apr",경남,함안군,192,40114,10903,51209,"2018-04-01",2018
"18-Apr",경남,함양군,201,18529,388,19118,"2018-04-01",2018
"18-Apr",경남,합천군,250,22159,630,23039,"2018-04-01",2018
"18-Apr",제주,계,2160,364960,149659,516779,"2018-04-01",2018
"18-Apr",제주,서귀포시,706,98336,2081,101123,"2018-04-01",2018
"18-Apr",제주,제주시,1454,266624,147578,415656,"2018-04-01",2018
"18-May",서울,계,12016,2907750,199930,3119696,"2018-05-01",2018
"18-May",서울,강남구,374,216807,19742,236923,"2018-05-01",2018
"18-May",서울,강동구,263,127866,8476,136605,"2018-05-01",2018
"18-May",서울,강북구,301,72808,4644,77753,"2018-05-01",2018
"18-May",서울,강서구,320,186413,16336,203069,"2018-05-01",2018
"18-May",서울,관악구,298,116207,5422,121927,"2018-05-01",2018
"18-May",서울,광진구,272,92401,5650,98323,"2018-05-01",2018
"18-May",서울,구로구,274,129871,13776,143921,"2018-05-01",2018
"18-May",서울,금천구,118,80072,6193,86383,"2018-05-01",2018
"18-May",서울,노원구,295,144785,9187,154267,"2018-05-01",2018
"18-May",서울,도봉구,250,89520,7448,97218,"2018-05-01",2018
"18-May",서울,동대문구,316,91702,5250,97268,"2018-05-01",2018
"18-May",서울,동작구,309,101644,2765,104718,"2018-05-01",2018
"18-May",서울,마포구,330,109926,6855,117111,"2018-05-01",2018
"18-May",서울,서대문구,431,80468,5482,86381,"2018-05-01",2018
"18-May",서울,서초구,577,169462,12575,182614,"2018-05-01",2018
"18-May",서울,성동구,326,95235,8940,104501,"2018-05-01",2018
"18-May",서울,성북구,286,111125,5454,116865,"2018-05-01",2018
"18-May",서울,송파구,362,220945,12870,234177,"2018-05-01",2018
"18-May",서울,양천구,328,141842,8562,150732,"2018-05-01",2018
"18-May",서울,영등포구,356,135723,9638,145717,"2018-05-01",2018
"18-May",서울,용산구,378,75037,2212,77627,"2018-05-01",2018
"18-May",서울,은평구,256,122093,6958,129307,"2018-05-01",2018
"18-May",서울,종로구,3735,45259,1601,50595,"2018-05-01",2018
"18-May",서울,중구,1056,46338,4184,51578,"2018-05-01",2018
"18-May",서울,중랑구,205,104201,9710,114116,"2018-05-01",2018
"18-May",부산,계,4592,1246515,98551,1349658,"2018-05-01",2018
"18-May",부산,강서구,322,65772,3637,69731,"2018-05-01",2018
"18-May",부산,금정구,273,81529,7325,89127,"2018-05-01",2018
"18-May",부산,기장군,242,69333,2133,71708,"2018-05-01",2018
"18-May",부산,남구,221,89105,8731,98057,"2018-05-01",2018
"18-May",부산,동구,232,43644,4630,48506,"2018-05-01",2018
"18-May",부산,동래구,185,88037,4231,92453,"2018-05-01",2018
"18-May",부산,부산진구,373,120899,10062,131334,"2018-05-01",2018
"18-May",부산,북구,243,100827,3265,104335,"2018-05-01",2018
"18-May",부산,사상구,278,85156,6003,91437,"2018-05-01",2018
"18-May",부산,사하구,262,108799,6933,115994,"2018-05-01",2018
"18-May",부산,서구,140,27884,1347,29371,"2018-05-01",2018
"18-May",부산,수영구,162,64848,15656,80666,"2018-05-01",2018
"18-May",부산,연제구,832,86865,10232,97929,"2018-05-01",2018
"18-May",부산,영도구,222,31834,2636,34692,"2018-05-01",2018
"18-May",부산,중구,308,21236,6373,27917,"2018-05-01",2018
"18-May",부산,해운대구,297,160747,5357,166401,"2018-05-01",2018
"18-May",대구,계,3088,1115210,47592,1165890,"2018-05-01",2018
"18-May",대구,남구,337,56218,2001,58556,"2018-05-01",2018
"18-May",대구,달서구,458,258043,11949,270450,"2018-05-01",2018
"18-May",대구,달성군,462,120973,4422,125857,"2018-05-01",2018
"18-May",대구,동구,326,149792,10050,160168,"2018-05-01",2018
"18-May",대구,북구,482,191965,7880,200327,"2018-05-01",2018
"18-May",대구,서구,223,74398,4292,78913,"2018-05-01",2018
"18-May",대구,수성구,532,208502,5301,214335,"2018-05-01",2018
"18-May",대구,중구,268,55319,1697,57284,"2018-05-01",2018
"18-May",인천,계,3721,1233925,299945,1537591,"2018-05-01",2018
"18-May",인천,강화군,307,32056,2504,34867,"2018-05-01",2018
"18-May",인천,계양구,274,121174,155427,276875,"2018-05-01",2018
"18-May",인천,남구,392,149726,54251,204369,"2018-05-01",2018
"18-May",인천,남동구,826,240336,41050,282212,"2018-05-01",2018
"18-May",인천,동구,86,26017,2626,28729,"2018-05-01",2018
"18-May",인천,부평구,329,216161,8320,224810,"2018-05-01",2018
"18-May",인천,서구,363,221249,10672,232284,"2018-05-01",2018
"18-May",인천,연수구,331,161654,7711,169696,"2018-05-01",2018
"18-May",인천,옹진군,191,11521,207,11919,"2018-05-01",2018
"18-May",인천,중구,622,54031,17177,71830,"2018-05-01",2018
"18-May",인천,미추홀구,0,0,0,0,"2018-05-01",2018
"18-May",광주,계,2103,620304,32531,654938,"2018-05-01",2018
"18-May",광주,광산구,496,178705,10801,190002,"2018-05-01",2018
"18-May",광주,남구,179,85054,2578,87811,"2018-05-01",2018
"18-May",광주,동구,234,35996,1024,37254,"2018-05-01",2018
"18-May",광주,북구,489,180136,10805,191430,"2018-05-01",2018
"18-May",광주,서구,705,140413,7323,148441,"2018-05-01",2018
"18-May",대전,계,1823,633075,28619,663517,"2018-05-01",2018
"18-May",대전,대덕구,209,85143,6763,92115,"2018-05-01",2018
"18-May",대전,동구,233,86849,4056,91138,"2018-05-01",2018
"18-May",대전,서구,778,200688,7241,208707,"2018-05-01",2018
"18-May",대전,유성구,371,164018,4878,169267,"2018-05-01",2018
"18-May",대전,중구,232,96377,5681,102290,"2018-05-01",2018
"18-May",울산,계,1698,532078,21034,554810,"2018-05-01",2018
"18-May",울산,남구,688,151859,7144,159691,"2018-05-01",2018
"18-May",울산,동구,202,62494,884,63580,"2018-05-01",2018
"18-May",울산,북구,137,99908,4024,104069,"2018-05-01",2018
"18-May",울산,울주군,344,115064,6271,121679,"2018-05-01",2018
"18-May",울산,중구,327,102753,2711,105791,"2018-05-01",2018
"18-May",세종,계,687,135746,2437,138870,"2018-05-01",2018
"18-May",세종,세종특별자치시,687,135746,2437,138870,"2018-05-01",2018
"18-May",경기,계,16265,5240594,224377,5481236,"2018-05-01",2018
"18-May",경기,가평군,359,28844,681,29884,"2018-05-01",2018
"18-May",경기,고양시 덕양구,627,159474,3637,163738,"2018-05-01",2018
"18-May",경기,고양시 일산동구,269,116411,7096,123776,"2018-05-01",2018
"18-May",경기,고양시 일산서구,124,108337,3786,112247,"2018-05-01",2018
"18-May",경기,과천시,692,19847,588,21127,"2018-05-01",2018
"18-May",경기,광명시,297,103884,4190,108371,"2018-05-01",2018
"18-May",경기,광주시,360,169629,7742,177731,"2018-05-01",2018
"18-May",경기,구리시,242,68249,2401,70892,"2018-05-01",2018
"18-May",경기,군포시,279,94788,4992,100059,"2018-05-01",2018
"18-May",경기,김포시,462,181830,6716,189008,"2018-05-01",2018
"18-May",경기,남양주시,630,264384,6957,271971,"2018-05-01",2018
"18-May",경기,동두천시,214,36607,1274,38095,"2018-05-01",2018
"18-May",경기,부천시,705,292072,12249,305026,"2018-05-01",2018
"18-May",경기,성남시 분당구,332,183854,6727,190913,"2018-05-01",2018
"18-May",경기,성남시 수정구,320,70175,2671,73166,"2018-05-01",2018
"18-May",경기,성남시 중원구,299,71616,3862,75777,"2018-05-01",2018
"18-May",경기,수원시 권선구,366,170565,7350,178281,"2018-05-01",2018
"18-May",경기,수원시 영통구,209,132699,3296,136204,"2018-05-01",2018
"18-May",경기,수원시 장안구,581,104853,3977,109411,"2018-05-01",2018
"18-May",경기,수원시 팔달구,475,69996,3251,73722,"2018-05-01",2018
"18-May",경기,시흥시,450,202889,7470,210809,"2018-05-01",2018
"18-May",경기,안산시 단원구,527,144513,8379,153419,"2018-05-01",2018
"18-May",경기,안산시 상록구,166,137286,4580,142032,"2018-05-01",2018
"18-May",경기,안성시,339,93760,4954,99053,"2018-05-01",2018
"18-May",경기,안양시 동안구,379,116533,6486,123398,"2018-05-01",2018
"18-May",경기,안양시 만안구,148,84325,3685,88158,"2018-05-01",2018
"18-May",경기,양주시,371,93005,2997,96373,"2018-05-01",2018
"18-May",경기,양평군,504,55569,1703,57776,"2018-05-01",2018
"18-May",경기,여주시,400,59083,7249,66732,"2018-05-01",2018
"18-May",경기,연천군,286,22774,5428,28488,"2018-05-01",2018
"18-May",경기,오산시,223,93667,3117,97007,"2018-05-01",2018
"18-May",경기,용인시 기흥구,113,173124,8460,181697,"2018-05-01",2018
"18-May",경기,용인시 수지구,46,131423,2021,133490,"2018-05-01",2018
"18-May",경기,용인시 처인구,658,112949,6879,120486,"2018-05-01",2018
"18-May",경기,의왕시,285,56898,2784,59967,"2018-05-01",2018
"18-May",경기,의정부시,563,146266,4591,151420,"2018-05-01",2018
"18-May",경기,이천시,382,103155,5879,109416,"2018-05-01",2018
"18-May",경기,파주시,473,190750,9548,200771,"2018-05-01",2018
"18-May",경기,평택시,659,237648,11144,249451,"2018-05-01",2018
"18-May",경기,포천시,339,81047,9866,91252,"2018-05-01",2018
"18-May",경기,하남시,364,95446,2237,98047,"2018-05-01",2018
"18-May",경기,화성시,748,360370,11477,372595,"2018-05-01",2018
"18-May",강원,계,5501,724765,24621,754887,"2018-05-01",2018
"18-May",강원,강릉시,499,101075,4402,105976,"2018-05-01",2018
"18-May",강원,고성군,181,13451,231,13863,"2018-05-01",2018
"18-May",강원,동해시,284,42166,1346,43796,"2018-05-01",2018
"18-May",강원,삼척시,365,30625,688,31678,"2018-05-01",2018
"18-May",강원,속초시,291,35184,1364,36839,"2018-05-01",2018
"18-May",강원,양구군,144,11515,117,11776,"2018-05-01",2018
"18-May",강원,양양군,168,14230,205,14603,"2018-05-01",2018
"18-May",강원,영월군,314,19908,367,20589,"2018-05-01",2018
"18-May",강원,원주시,545,156544,5835,162924,"2018-05-01",2018
"18-May",강원,인제군,193,17025,223,17441,"2018-05-01",2018
"18-May",강원,정선군,298,19665,443,20406,"2018-05-01",2018
"18-May",강원,철원군,210,23054,288,23552,"2018-05-01",2018
"18-May",강원,춘천시,731,122810,5721,129262,"2018-05-01",2018
"18-May",강원,태백시,209,20030,796,21035,"2018-05-01",2018
"18-May",강원,평창군,281,24625,474,25380,"2018-05-01",2018
"18-May",강원,홍천군,371,36536,1091,37998,"2018-05-01",2018
"18-May",강원,화천군,190,12113,191,12494,"2018-05-01",2018
"18-May",강원,횡성군,227,24209,839,25275,"2018-05-01",2018
"18-May",충북,계,3768,762822,32721,799311,"2018-05-01",2018
"18-May",충북,괴산군,189,21133,354,21676,"2018-05-01",2018
"18-May",충북,단양군,195,15204,817,16216,"2018-05-01",2018
"18-May",충북,보은군,198,17160,979,18337,"2018-05-01",2018
"18-May",충북,영동군,223,24299,388,24910,"2018-05-01",2018
"18-May",충북,옥천군,189,25361,1101,26651,"2018-05-01",2018
"18-May",충북,음성군,220,55300,1709,57229,"2018-05-01",2018
"18-May",충북,제천시,311,63933,3442,67686,"2018-05-01",2018
"18-May",충북,증평군,89,18075,749,18913,"2018-05-01",2018
"18-May",충북,진천군,205,41948,1214,43367,"2018-05-01",2018
"18-May",충북,청원군,1,21,0,22,"2018-05-01",2018
"18-May",충북,청주시 상당구,467,75637,2410,78514,"2018-05-01",2018
"18-May",충북,청주시 서원구,229,91953,5745,97927,"2018-05-01",2018
"18-May",충북,청주시 청원구,338,96611,3883,100832,"2018-05-01",2018
"18-May",충북,청주시 흥덕구,360,114559,6151,121070,"2018-05-01",2018
"18-May",충북,충주시,554,101628,3779,105961,"2018-05-01",2018
"18-May",충남,계,5213,1031167,38078,1074458,"2018-05-01",2018
"18-May",충남,계룡시,137,20783,551,21471,"2018-05-01",2018
"18-May",충남,공주시,512,51282,2030,53824,"2018-05-01",2018
"18-May",충남,금산군,181,27307,1909,29397,"2018-05-01",2018
"18-May",충남,논산시,337,58604,2204,61145,"2018-05-01",2018
"18-May",충남,당진시,378,88569,3761,92708,"2018-05-01",2018
"18-May",충남,보령시,375,49539,1254,51168,"2018-05-01",2018
"18-May",충남,부여군,264,33027,1347,34638,"2018-05-01",2018
"18-May",충남,서산시,376,86385,3447,90208,"2018-05-01",2018
"18-May",충남,서천군,223,26448,884,27555,"2018-05-01",2018
"18-May",충남,아산시,431,152817,5930,159178,"2018-05-01",2018
"18-May",충남,예산군,350,40905,1401,42656,"2018-05-01",2018
"18-May",충남,천안시 동남구,243,121222,4576,126041,"2018-05-01",2018
"18-May",충남,천안시 서북구,518,176115,5932,182565,"2018-05-01",2018
"18-May",충남,청양군,232,16191,956,17379,"2018-05-01",2018
"18-May",충남,태안군,261,32318,484,33063,"2018-05-01",2018
"18-May",충남,홍성군,395,49655,1412,51462,"2018-05-01",2018
"18-May",전북,계,4735,858329,39100,902164,"2018-05-01",2018
"18-May",전북,고창군,247,29293,543,30083,"2018-05-01",2018
"18-May",전북,군산시,487,124199,6753,131439,"2018-05-01",2018
"18-May",전북,김제시,278,43380,1830,45488,"2018-05-01",2018
"18-May",전북,남원시,396,38808,3668,42872,"2018-05-01",2018
"18-May",전북,무주군,173,12092,365,12630,"2018-05-01",2018
"18-May",전북,부안군,251,26786,590,27627,"2018-05-01",2018
"18-May",전북,순창군,191,13967,194,14352,"2018-05-01",2018
"18-May",전북,완주군,317,49445,3321,53083,"2018-05-01",2018
"18-May",전북,익산시,479,133290,6217,139986,"2018-05-01",2018
"18-May",전북,임실군,196,13998,408,14602,"2018-05-01",2018
"18-May",전북,장수군,215,11543,181,11939,"2018-05-01",2018
"18-May",전북,전주시 덕진구,368,148651,7278,156297,"2018-05-01",2018
"18-May",전북,전주시 완산구,601,148046,4108,152755,"2018-05-01",2018
"18-May",전북,정읍시,308,51546,3447,55301,"2018-05-01",2018
"18-May",전북,진안군,228,13285,197,13710,"2018-05-01",2018
"18-May",전남,계,5775,882450,122913,1011138,"2018-05-01",2018
"18-May",전남,강진군,203,17801,1046,19050,"2018-05-01",2018
"18-May",전남,고흥군,285,29613,658,30556,"2018-05-01",2018
"18-May",전남,곡성군,139,14230,808,15177,"2018-05-01",2018
"18-May",전남,광양시,233,76317,5900,82450,"2018-05-01",2018
"18-May",전남,구례군,122,12752,603,13477,"2018-05-01",2018
"18-May",전남,나주시,411,57209,3162,60782,"2018-05-01",2018
"18-May",전남,담양군,205,25180,1491,26876,"2018-05-01",2018
"18-May",전남,목포시,435,92362,6130,98927,"2018-05-01",2018
"18-May",전남,무안군,517,40377,964,41858,"2018-05-01",2018
"18-May",전남,보성군,198,20699,67328,88225,"2018-05-01",2018
"18-May",전남,순천시,449,128030,4986,133465,"2018-05-01",2018
"18-May",전남,신안군,205,19900,742,20847,"2018-05-01",2018
"18-May",전남,여수시,540,122433,6852,129825,"2018-05-01",2018
"18-May",전남,영광군,226,25887,719,26832,"2018-05-01",2018
"18-May",전남,영암군,230,30890,16311,47431,"2018-05-01",2018
"18-May",전남,완도군,213,23769,483,24465,"2018-05-01",2018
"18-May",전남,장성군,144,24903,1032,26079,"2018-05-01",2018
"18-May",전남,장흥군,187,19238,434,19859,"2018-05-01",2018
"18-May",전남,진도군,146,15735,292,16173,"2018-05-01",2018
"18-May",전남,함평군,159,17312,369,17840,"2018-05-01",2018
"18-May",전남,해남군,323,37038,562,37923,"2018-05-01",2018
"18-May",전남,화순군,205,30775,2041,33021,"2018-05-01",2018
"18-May",경북,계,6914,1350895,48108,1405917,"2018-05-01",2018
"18-May",경북,경산시,399,129010,4150,133559,"2018-05-01",2018
"18-May",경북,경주시,550,133877,4865,139292,"2018-05-01",2018
"18-May",경북,고령군,154,20155,509,20818,"2018-05-01",2018
"18-May",경북,구미시,492,202471,7253,210216,"2018-05-01",2018
"18-May",경북,군위군,111,14329,269,14709,"2018-05-01",2018
"18-May",경북,김천시,346,69713,1787,71846,"2018-05-01",2018
"18-May",경북,문경시,273,34389,750,35412,"2018-05-01",2018
"18-May",경북,봉화군,191,16983,202,17376,"2018-05-01",2018
"18-May",경북,상주시,359,50300,1817,52476,"2018-05-01",2018
"18-May",경북,성주군,187,28985,1439,30611,"2018-05-01",2018
"18-May",경북,안동시,563,78666,2561,81790,"2018-05-01",2018
"18-May",경북,영덕군,240,18310,297,18847,"2018-05-01",2018
"18-May",경북,영양군,140,9141,93,9374,"2018-05-01",2018
"18-May",경북,영주시,338,53791,1504,55633,"2018-05-01",2018
"18-May",경북,영천시,264,55508,2630,58402,"2018-05-01",2018
"18-May",경북,예천군,191,25854,435,26480,"2018-05-01",2018
"18-May",경북,울릉군,141,5035,400,5576,"2018-05-01",2018
"18-May",경북,울진군,280,24903,358,25541,"2018-05-01",2018
"18-May",경북,의성군,295,28631,1026,29952,"2018-05-01",2018
"18-May",경북,청도군,187,23603,626,24416,"2018-05-01",2018
"18-May",경북,청송군,191,14560,196,14947,"2018-05-01",2018
"18-May",경북,칠곡군,320,66797,2219,69336,"2018-05-01",2018
"18-May",경북,포항시 남구,381,117393,8798,126572,"2018-05-01",2018
"18-May",경북,포항시 북구,321,128491,3924,132736,"2018-05-01",2018
"18-May",경남,계,6784,1592332,82144,1681260,"2018-05-01",2018
"18-May",경남,거제시,340,102307,2189,104836,"2018-05-01",2018
"18-May",경남,거창군,245,30245,789,31279,"2018-05-01",2018
"18-May",경남,고성군,209,25616,663,26488,"2018-05-01",2018
"18-May",경남,김해시,629,253092,6618,260339,"2018-05-01",2018
"18-May",경남,남해군,239,18601,488,19328,"2018-05-01",2018
"18-May",경남,밀양시,300,53085,4030,57415,"2018-05-01",2018
"18-May",경남,사천시,296,53557,1478,55331,"2018-05-01",2018
"18-May",경남,산청군,214,19011,759,19984,"2018-05-01",2018
"18-May",경남,양산시,379,152464,9272,162115,"2018-05-01",2018
"18-May",경남,의령군,189,13548,784,14521,"2018-05-01",2018
"18-May",경남,진주시,600,154481,6590,161671,"2018-05-01",2018
"18-May",경남,창녕군,229,34188,918,35335,"2018-05-01",2018
"18-May",경남,창원시 마산합포구,331,99258,3033,102622,"2018-05-01",2018
"18-May",경남,창원시 마산회원구,166,94493,5146,99805,"2018-05-01",2018
"18-May",경남,창원시 성산구,141,121683,17516,139340,"2018-05-01",2018
"18-May",경남,창원시 의창구,891,126210,6385,133486,"2018-05-01",2018
"18-May",경남,창원시 진해구,197,84315,1608,86120,"2018-05-01",2018
"18-May",경남,통영시,316,51588,1497,53401,"2018-05-01",2018
"18-May",경남,하동군,218,23727,445,24390,"2018-05-01",2018
"18-May",경남,함안군,203,40097,10918,51218,"2018-05-01",2018
"18-May",경남,함양군,201,18546,386,19133,"2018-05-01",2018
"18-May",경남,합천군,251,22220,632,23103,"2018-05-01",2018
"18-May",제주,계,2171,365188,154068,521427,"2018-05-01",2018
"18-May",제주,서귀포시,709,98606,2049,101364,"2018-05-01",2018
"18-May",제주,제주시,1462,266582,152019,420063,"2018-05-01",2018
"18-Jun",서울,계,12143,2908210,200116,3120469,"2018-06-01",2018
"18-Jun",서울,강남구,373,216236,18089,234698,"2018-06-01",2018
"18-Jun",서울,강동구,257,127886,8490,136633,"2018-06-01",2018
"18-Jun",서울,강북구,301,72750,4635,77686,"2018-06-01",2018
"18-Jun",서울,강서구,325,186529,16445,203299,"2018-06-01",2018
"18-Jun",서울,관악구,301,116231,5408,121940,"2018-06-01",2018
"18-Jun",서울,광진구,275,92660,5660,98595,"2018-06-01",2018
"18-Jun",서울,구로구,276,129990,14779,145045,"2018-06-01",2018
"18-Jun",서울,금천구,117,80132,6138,86387,"2018-06-01",2018
"18-Jun",서울,노원구,292,144762,9142,154196,"2018-06-01",2018
"18-Jun",서울,도봉구,252,89582,7492,97326,"2018-06-01",2018
"18-Jun",서울,동대문구,310,91964,5217,97491,"2018-06-01",2018
"18-Jun",서울,동작구,307,101856,2785,104948,"2018-06-01",2018
"18-Jun",서울,마포구,330,110018,6898,117246,"2018-06-01",2018
"18-Jun",서울,서대문구,432,80416,5477,86325,"2018-06-01",2018
"18-Jun",서울,서초구,583,169263,12731,182577,"2018-06-01",2018
"18-Jun",서울,성동구,328,95391,9015,104734,"2018-06-01",2018
"18-Jun",서울,성북구,286,111118,5446,116850,"2018-06-01",2018
"18-Jun",서울,송파구,368,221407,12840,234615,"2018-06-01",2018
"18-Jun",서울,양천구,333,141773,8554,150660,"2018-06-01",2018
"18-Jun",서울,영등포구,361,135650,9529,145540,"2018-06-01",2018
"18-Jun",서울,용산구,377,74809,2156,77342,"2018-06-01",2018
"18-Jun",서울,은평구,256,122110,6940,129306,"2018-06-01",2018
"18-Jun",서울,종로구,3834,45248,1631,50713,"2018-06-01",2018
"18-Jun",서울,중구,1058,46277,4891,52226,"2018-06-01",2018
"18-Jun",서울,중랑구,211,104152,9728,114091,"2018-06-01",2018
"18-Jun",부산,계,4617,1248007,100441,1353065,"2018-06-01",2018
"18-Jun",부산,강서구,323,65872,3675,69870,"2018-06-01",2018
"18-Jun",부산,금정구,277,81560,7317,89154,"2018-06-01",2018
"18-Jun",부산,기장군,245,69582,2138,71965,"2018-06-01",2018
"18-Jun",부산,남구,220,89742,8705,98667,"2018-06-01",2018
"18-Jun",부산,동구,230,43925,4600,48755,"2018-06-01",2018
"18-Jun",부산,동래구,185,87988,4232,92405,"2018-06-01",2018
"18-Jun",부산,부산진구,376,120859,10215,131450,"2018-06-01",2018
"18-Jun",부산,북구,240,100793,3275,104308,"2018-06-01",2018
"18-Jun",부산,사상구,279,85108,6011,91398,"2018-06-01",2018
"18-Jun",부산,사하구,264,108883,6958,116105,"2018-06-01",2018
"18-Jun",부산,서구,141,28055,1346,29542,"2018-06-01",2018
"18-Jun",부산,수영구,162,64490,16763,81415,"2018-06-01",2018
"18-Jun",부산,연제구,841,80521,6888,88250,"2018-06-01",2018
"18-Jun",부산,영도구,226,31787,2646,34659,"2018-06-01",2018
"18-Jun",부산,중구,310,21554,6971,28835,"2018-06-01",2018
"18-Jun",부산,해운대구,298,167288,8701,176287,"2018-06-01",2018
"18-Jun",대구,계,3133,1118472,47669,1169274,"2018-06-01",2018
"18-Jun",대구,남구,322,56255,1849,58426,"2018-06-01",2018
"18-Jun",대구,달서구,472,258862,11877,271211,"2018-06-01",2018
"18-Jun",대구,달성군,477,121481,4486,126444,"2018-06-01",2018
"18-Jun",대구,동구,332,150447,10100,160879,"2018-06-01",2018
"18-Jun",대구,북구,491,192431,7868,200790,"2018-06-01",2018
"18-Jun",대구,서구,225,74391,4300,78916,"2018-06-01",2018
"18-Jun",대구,수성구,544,209224,5323,215091,"2018-06-01",2018
"18-Jun",대구,중구,270,55381,1866,57517,"2018-06-01",2018
"18-Jun",인천,계,3761,1238526,301608,1543895,"2018-06-01",2018
"18-Jun",인천,강화군,309,32135,1318,33762,"2018-06-01",2018
"18-Jun",인천,계양구,275,121370,157466,279111,"2018-06-01",2018
"18-Jun",인천,남구,400,150600,54272,205272,"2018-06-01",2018
"18-Jun",인천,남동구,844,241427,42247,284518,"2018-06-01",2018
"18-Jun",인천,동구,87,26119,2622,28828,"2018-06-01",2018
"18-Jun",인천,부평구,330,215774,8367,224471,"2018-06-01",2018
"18-Jun",인천,서구,369,223238,10637,234244,"2018-06-01",2018
"18-Jun",인천,연수구,337,162054,7269,169660,"2018-06-01",2018
"18-Jun",인천,옹진군,190,11536,206,11932,"2018-06-01",2018
"18-Jun",인천,중구,620,54273,17204,72097,"2018-06-01",2018
"18-Jun",인천,미추홀구,0,0,0,0,"2018-06-01",2018
"18-Jun",광주,계,2116,622183,32425,656724,"2018-06-01",2018
"18-Jun",광주,광산구,509,179370,10970,190849,"2018-06-01",2018
"18-Jun",광주,남구,179,85339,2572,88090,"2018-06-01",2018
"18-Jun",광주,동구,234,35972,1024,37230,"2018-06-01",2018
"18-Jun",광주,북구,494,180765,10633,191892,"2018-06-01",2018
"18-Jun",광주,서구,700,140737,7226,148663,"2018-06-01",2018
"18-Jun",대전,계,1845,634102,28692,664639,"2018-06-01",2018
"18-Jun",대전,대덕구,211,85218,6767,92196,"2018-06-01",2018
"18-Jun",대전,동구,235,86924,4060,91219,"2018-06-01",2018
"18-Jun",대전,서구,793,201132,7264,209189,"2018-06-01",2018
"18-Jun",대전,유성구,371,164387,4901,169659,"2018-06-01",2018
"18-Jun",대전,중구,235,96441,5700,102376,"2018-06-01",2018
"18-Jun",울산,계,1738,532666,20958,555362,"2018-06-01",2018
"18-Jun",울산,남구,700,151696,7133,159529,"2018-06-01",2018
"18-Jun",울산,동구,207,62495,877,63579,"2018-06-01",2018
"18-Jun",울산,북구,141,100139,3973,104253,"2018-06-01",2018
"18-Jun",울산,울주군,350,115519,6263,122132,"2018-06-01",2018
"18-Jun",울산,중구,340,102817,2712,105869,"2018-06-01",2018
"18-Jun",세종,계,691,137433,2444,140568,"2018-06-01",2018
"18-Jun",세종,세종특별자치시,691,137433,2444,140568,"2018-06-01",2018
"18-Jun",경기,계,16546,5260980,224276,5501802,"2018-06-01",2018
"18-Jun",경기,가평군,367,29024,674,30065,"2018-06-01",2018
"18-Jun",경기,고양시 덕양구,629,159984,3649,164262,"2018-06-01",2018
"18-Jun",경기,고양시 일산동구,277,117156,7075,124508,"2018-06-01",2018
"18-Jun",경기,고양시 일산서구,123,108342,3773,112238,"2018-06-01",2018
"18-Jun",경기,과천시,727,19801,590,21118,"2018-06-01",2018
"18-Jun",경기,광명시,298,104206,4193,108697,"2018-06-01",2018
"18-Jun",경기,광주시,371,170923,7728,179022,"2018-06-01",2018
"18-Jun",경기,구리시,243,68715,2460,71418,"2018-06-01",2018
"18-Jun",경기,군포시,282,94967,4990,100239,"2018-06-01",2018
"18-Jun",경기,김포시,466,183885,6694,191045,"2018-06-01",2018
"18-Jun",경기,남양주시,639,265432,6991,273062,"2018-06-01",2018
"18-Jun",경기,동두천시,217,36704,1278,38199,"2018-06-01",2018
"18-Jun",경기,부천시,707,292368,12384,305459,"2018-06-01",2018
"18-Jun",경기,성남시 분당구,337,184025,6733,191095,"2018-06-01",2018
"18-Jun",경기,성남시 수정구,324,70169,2669,73162,"2018-06-01",2018
"18-Jun",경기,성남시 중원구,305,71627,3835,75767,"2018-06-01",2018
"18-Jun",경기,수원시 권선구,384,171505,7297,179186,"2018-06-01",2018
"18-Jun",경기,수원시 영통구,211,133224,3292,136727,"2018-06-01",2018
"18-Jun",경기,수원시 장안구,585,104942,3968,109495,"2018-06-01",2018
"18-Jun",경기,수원시 팔달구,475,69823,3261,73559,"2018-06-01",2018
"18-Jun",경기,시흥시,460,204190,7427,212077,"2018-06-01",2018
"18-Jun",경기,안산시 단원구,531,145061,8365,153957,"2018-06-01",2018
"18-Jun",경기,안산시 상록구,172,137197,4593,141962,"2018-06-01",2018
"18-Jun",경기,안성시,358,93969,4931,99258,"2018-06-01",2018
"18-Jun",경기,안양시 동안구,388,116668,6417,123473,"2018-06-01",2018
"18-Jun",경기,안양시 만안구,157,84439,3711,88307,"2018-06-01",2018
"18-Jun",경기,양주시,374,93716,2994,97084,"2018-06-01",2018
"18-Jun",경기,양평군,511,55658,1706,57875,"2018-06-01",2018
"18-Jun",경기,여주시,411,59126,7257,66794,"2018-06-01",2018
"18-Jun",경기,연천군,292,22871,5428,28591,"2018-06-01",2018
"18-Jun",경기,오산시,226,94368,3154,97748,"2018-06-01",2018
"18-Jun",경기,용인시 기흥구,114,173649,8519,182282,"2018-06-01",2018
"18-Jun",경기,용인시 수지구,45,131803,2019,133867,"2018-06-01",2018
"18-Jun",경기,용인시 처인구,679,113400,6878,120957,"2018-06-01",2018
"18-Jun",경기,의왕시,281,57022,2793,60096,"2018-06-01",2018
"18-Jun",경기,의정부시,577,146597,4591,151765,"2018-06-01",2018
"18-Jun",경기,이천시,385,103604,5901,109890,"2018-06-01",2018
"18-Jun",경기,파주시,487,191613,9537,201637,"2018-06-01",2018
"18-Jun",경기,평택시,673,238935,11187,250795,"2018-06-01",2018
"18-Jun",경기,포천시,336,81283,9666,91285,"2018-06-01",2018
"18-Jun",경기,하남시,365,96119,2234,98718,"2018-06-01",2018
"18-Jun",경기,화성시,757,362870,11434,375061,"2018-06-01",2018
"18-Jun",강원,계,5505,726996,24651,757152,"2018-06-01",2018
"18-Jun",강원,강릉시,495,101266,4456,106217,"2018-06-01",2018
"18-Jun",강원,고성군,184,13466,232,13882,"2018-06-01",2018
"18-Jun",강원,동해시,286,42344,1340,43970,"2018-06-01",2018
"18-Jun",강원,삼척시,357,30706,688,31751,"2018-06-01",2018
"18-Jun",강원,속초시,293,35275,1342,36910,"2018-06-01",2018
"18-Jun",강원,양구군,142,11549,115,11806,"2018-06-01",2018
"18-Jun",강원,양양군,168,14267,208,14643,"2018-06-01",2018
"18-Jun",강원,영월군,315,19993,366,20674,"2018-06-01",2018
"18-Jun",강원,원주시,544,157039,5823,163406,"2018-06-01",2018
"18-Jun",강원,인제군,193,17111,226,17530,"2018-06-01",2018
"18-Jun",강원,정선군,299,19716,443,20458,"2018-06-01",2018
"18-Jun",강원,철원군,213,23087,289,23589,"2018-06-01",2018
"18-Jun",강원,춘천시,734,123349,5736,129819,"2018-06-01",2018
"18-Jun",강원,태백시,213,20096,800,21109,"2018-06-01",2018
"18-Jun",강원,평창군,280,24675,468,25423,"2018-06-01",2018
"18-Jun",강원,홍천군,371,36624,1089,38084,"2018-06-01",2018
"18-Jun",강원,화천군,189,12146,193,12528,"2018-06-01",2018
"18-Jun",강원,횡성군,229,24287,837,25353,"2018-06-01",2018
"18-Jun",충북,계,3807,765069,32703,801579,"2018-06-01",2018
"18-Jun",충북,괴산군,191,21165,357,21713,"2018-06-01",2018
"18-Jun",충북,단양군,197,15222,818,16237,"2018-06-01",2018
"18-Jun",충북,보은군,203,17150,977,18330,"2018-06-01",2018
"18-Jun",충북,영동군,234,24313,389,24936,"2018-06-01",2018
"18-Jun",충북,옥천군,191,25454,1094,26739,"2018-06-01",2018
"18-Jun",충북,음성군,217,55500,1715,57432,"2018-06-01",2018
"18-Jun",충북,제천시,313,64164,3440,67917,"2018-06-01",2018
"18-Jun",충북,증평군,93,18165,755,19013,"2018-06-01",2018
"18-Jun",충북,진천군,202,42173,1182,43557,"2018-06-01",2018
"18-Jun",충북,청원군,1,21,0,22,"2018-06-01",2018
"18-Jun",충북,청주시 상당구,477,75851,2401,78729,"2018-06-01",2018
"18-Jun",충북,청주시 서원구,227,92086,5755,98068,"2018-06-01",2018
"18-Jun",충북,청주시 청원구,343,97021,3906,101270,"2018-06-01",2018
"18-Jun",충북,청주시 흥덕구,363,114794,6135,121292,"2018-06-01",2018
"18-Jun",충북,충주시,555,101990,3779,106324,"2018-06-01",2018
"18-Jun",충남,계,5255,1034565,38503,1078323,"2018-06-01",2018
"18-Jun",충남,계룡시,138,20795,552,21485,"2018-06-01",2018
"18-Jun",충남,공주시,514,51380,2041,53935,"2018-06-01",2018
"18-Jun",충남,금산군,182,27382,1922,29486,"2018-06-01",2018
"18-Jun",충남,논산시,350,58654,2212,61216,"2018-06-01",2018
"18-Jun",충남,당진시,368,88830,3758,92956,"2018-06-01",2018
"18-Jun",충남,보령시,383,49646,1256,51285,"2018-06-01",2018
"18-Jun",충남,부여군,265,33089,1331,34685,"2018-06-01",2018
"18-Jun",충남,서산시,375,86749,3441,90565,"2018-06-01",2018
"18-Jun",충남,서천군,225,26487,888,27600,"2018-06-01",2018
"18-Jun",충남,아산시,436,153400,6347,160183,"2018-06-01",2018
"18-Jun",충남,예산군,353,41070,1396,42819,"2018-06-01",2018
"18-Jun",충남,천안시 동남구,247,121993,4598,126838,"2018-06-01",2018
"18-Jun",충남,천안시 서북구,520,176762,5926,183208,"2018-06-01",2018
"18-Jun",충남,청양군,233,16193,944,17370,"2018-06-01",2018
"18-Jun",충남,태안군,269,32390,490,33149,"2018-06-01",2018
"18-Jun",충남,홍성군,397,49745,1401,51543,"2018-06-01",2018
"18-Jun",전북,계,4774,860524,39967,905265,"2018-06-01",2018
"18-Jun",전북,고창군,248,29292,546,30086,"2018-06-01",2018
"18-Jun",전북,군산시,488,124538,6764,131790,"2018-06-01",2018
"18-Jun",전북,김제시,275,43477,1855,45607,"2018-06-01",2018
"18-Jun",전북,남원시,401,38890,4293,43584,"2018-06-01",2018
"18-Jun",전북,무주군,181,12123,366,12670,"2018-06-01",2018
"18-Jun",전북,부안군,250,26801,589,27640,"2018-06-01",2018
"18-Jun",전북,순창군,196,13962,191,14349,"2018-06-01",2018
"18-Jun",전북,완주군,317,49591,3328,53236,"2018-06-01",2018
"18-Jun",전북,익산시,480,133545,6233,140258,"2018-06-01",2018
"18-Jun",전북,임실군,196,13962,410,14568,"2018-06-01",2018
"18-Jun",전북,장수군,217,11508,179,11904,"2018-06-01",2018
"18-Jun",전북,전주시 덕진구,373,149537,7281,157191,"2018-06-01",2018
"18-Jun",전북,전주시 완산구,610,148245,4132,152987,"2018-06-01",2018
"18-Jun",전북,정읍시,309,51705,3603,55617,"2018-06-01",2018
"18-Jun",전북,진안군,233,13348,197,13778,"2018-06-01",2018
"18-Jun",전남,계,5889,884430,124667,1014986,"2018-06-01",2018
"18-Jun",전남,강진군,207,17797,1033,19037,"2018-06-01",2018
"18-Jun",전남,고흥군,294,29703,659,30656,"2018-06-01",2018
"18-Jun",전남,곡성군,138,14218,811,15167,"2018-06-01",2018
"18-Jun",전남,광양시,234,76504,5908,82646,"2018-06-01",2018
"18-Jun",전남,구례군,123,12736,621,13480,"2018-06-01",2018
"18-Jun",전남,나주시,429,57602,3146,61177,"2018-06-01",2018
"18-Jun",전남,담양군,216,25215,1494,26925,"2018-06-01",2018
"18-Jun",전남,목포시,442,92606,6088,99136,"2018-06-01",2018
"18-Jun",전남,무안군,525,40447,964,41936,"2018-06-01",2018
"18-Jun",전남,보성군,198,20719,69627,90544,"2018-06-01",2018
"18-Jun",전남,순천시,453,128452,5008,133913,"2018-06-01",2018
"18-Jun",전남,신안군,213,19912,754,20879,"2018-06-01",2018
"18-Jun",전남,여수시,540,122750,6846,130136,"2018-06-01",2018
"18-Jun",전남,영광군,228,25925,717,26870,"2018-06-01",2018
"18-Jun",전남,영암군,243,30947,15782,46972,"2018-06-01",2018
"18-Jun",전남,완도군,213,23838,486,24537,"2018-06-01",2018
"18-Jun",전남,장성군,144,24934,1029,26107,"2018-06-01",2018
"18-Jun",전남,장흥군,197,19241,433,19871,"2018-06-01",2018
"18-Jun",전남,진도군,148,15757,295,16200,"2018-06-01",2018
"18-Jun",전남,함평군,161,17254,370,17785,"2018-06-01",2018
"18-Jun",전남,해남군,333,37119,562,38014,"2018-06-01",2018
"18-Jun",전남,화순군,210,30754,2034,32998,"2018-06-01",2018
"18-Jun",경북,계,7003,1353370,48027,1408400,"2018-06-01",2018
"18-Jun",경북,경산시,403,129421,4161,133985,"2018-06-01",2018
"18-Jun",경북,경주시,546,134234,4866,139646,"2018-06-01",2018
"18-Jun",경북,고령군,156,20157,509,20822,"2018-06-01",2018
"18-Jun",경북,구미시,506,202869,7194,210569,"2018-06-01",2018
"18-Jun",경북,군위군,114,14263,272,14649,"2018-06-01",2018
"18-Jun",경북,김천시,351,69781,1803,71935,"2018-06-01",2018
"18-Jun",경북,문경시,288,34400,750,35438,"2018-06-01",2018
"18-Jun",경북,봉화군,191,17003,201,17395,"2018-06-01",2018
"18-Jun",경북,상주시,369,50340,1809,52518,"2018-06-01",2018
"18-Jun",경북,성주군,186,28994,1435,30615,"2018-06-01",2018
"18-Jun",경북,안동시,576,78760,2561,81897,"2018-06-01",2018
"18-Jun",경북,영덕군,240,18358,297,18895,"2018-06-01",2018
"18-Jun",경북,영양군,142,9135,93,9370,"2018-06-01",2018
"18-Jun",경북,영주시,338,53814,1506,55658,"2018-06-01",2018
"18-Jun",경북,영천시,271,55630,2627,58528,"2018-06-01",2018
"18-Jun",경북,예천군,198,25989,435,26622,"2018-06-01",2018
"18-Jun",경북,울릉군,145,5081,402,5628,"2018-06-01",2018
"18-Jun",경북,울진군,281,24931,360,25572,"2018-06-01",2018
"18-Jun",경북,의성군,296,28649,1025,29970,"2018-06-01",2018
"18-Jun",경북,청도군,191,23642,627,24460,"2018-06-01",2018
"18-Jun",경북,청송군,191,14595,193,14979,"2018-06-01",2018
"18-Jun",경북,칠곡군,316,66890,2240,69446,"2018-06-01",2018
"18-Jun",경북,포항시 남구,383,117618,8772,126773,"2018-06-01",2018
"18-Jun",경북,포항시 북구,325,128816,3889,133030,"2018-06-01",2018
"18-Jun",경남,계,6864,1595302,81782,1683948,"2018-06-01",2018
"18-Jun",경남,거제시,352,102404,2172,104928,"2018-06-01",2018
"18-Jun",경남,거창군,244,30326,781,31351,"2018-06-01",2018
"18-Jun",경남,고성군,212,25665,655,26532,"2018-06-01",2018
"18-Jun",경남,김해시,639,253814,6678,261131,"2018-06-01",2018
"18-Jun",경남,남해군,240,18671,487,19398,"2018-06-01",2018
"18-Jun",경남,밀양시,300,53146,4018,57464,"2018-06-01",2018
"18-Jun",경남,사천시,299,53654,1486,55439,"2018-06-01",2018
"18-Jun",경남,산청군,213,19016,761,19990,"2018-06-01",2018
"18-Jun",경남,양산시,383,152976,9325,162684,"2018-06-01",2018
"18-Jun",경남,의령군,190,13593,782,14565,"2018-06-01",2018
"18-Jun",경남,진주시,609,154903,6538,162050,"2018-06-01",2018
"18-Jun",경남,창녕군,231,34289,914,35434,"2018-06-01",2018
"18-Jun",경남,창원시 마산합포구,333,99250,3031,102614,"2018-06-01",2018
"18-Jun",경남,창원시 마산회원구,170,94439,5155,99764,"2018-06-01",2018
"18-Jun",경남,창원시 성산구,144,121592,17331,139067,"2018-06-01",2018
"18-Jun",경남,창원시 의창구,905,126503,6338,133746,"2018-06-01",2018
"18-Jun",경남,창원시 진해구,200,84767,1610,86577,"2018-06-01",2018
"18-Jun",경남,통영시,322,51672,1486,53480,"2018-06-01",2018
"18-Jun",경남,하동군,219,23718,448,24385,"2018-06-01",2018
"18-Jun",경남,함안군,205,40168,10774,51147,"2018-06-01",2018
"18-Jun",경남,함양군,204,18513,386,19103,"2018-06-01",2018
"18-Jun",경남,합천군,250,22223,626,23099,"2018-06-01",2018
"18-Jun",제주,계,2242,365936,158406,526584,"2018-06-01",2018
"18-Jun",제주,서귀포시,728,98936,2029,101693,"2018-06-01",2018
"18-Jun",제주,제주시,1514,267000,156377,424891,"2018-06-01",2018
"18-Jul",서울,계,12176,2907950,201371,3121497,"2018-07-01",2018
"18-Jul",서울,강남구,375,215815,18478,234668,"2018-07-01",2018
"18-Jul",서울,강동구,254,127826,8494,136574,"2018-07-01",2018
"18-Jul",서울,강북구,300,72797,4630,77727,"2018-07-01",2018
"18-Jul",서울,강서구,325,186872,16626,203823,"2018-07-01",2018
"18-Jul",서울,관악구,299,116272,5406,121977,"2018-07-01",2018
"18-Jul",서울,광진구,275,92879,5691,98845,"2018-07-01",2018
"18-Jul",서울,구로구,280,130003,14660,144943,"2018-07-01",2018
"18-Jul",서울,금천구,117,80189,6103,86409,"2018-07-01",2018
"18-Jul",서울,노원구,291,144732,9165,154188,"2018-07-01",2018
"18-Jul",서울,도봉구,256,89682,7486,97424,"2018-07-01",2018
"18-Jul",서울,동대문구,310,92401,5173,97884,"2018-07-01",2018
"18-Jul",서울,동작구,303,101978,2806,105087,"2018-07-01",2018
"18-Jul",서울,마포구,331,110007,6891,117229,"2018-07-01",2018
"18-Jul",서울,서대문구,432,80353,5514,86299,"2018-07-01",2018
"18-Jul",서울,서초구,581,168679,12774,182034,"2018-07-01",2018
"18-Jul",서울,성동구,324,95383,9499,105206,"2018-07-01",2018
"18-Jul",서울,성북구,283,111081,5442,116806,"2018-07-01",2018
"18-Jul",서울,송파구,369,221604,13026,234999,"2018-07-01",2018
"18-Jul",서울,양천구,329,141840,8544,150713,"2018-07-01",2018
"18-Jul",서울,영등포구,359,135176,9436,144971,"2018-07-01",2018
"18-Jul",서울,용산구,377,74592,2178,77147,"2018-07-01",2018
"18-Jul",서울,은평구,259,122195,7024,129478,"2018-07-01",2018
"18-Jul",서울,종로구,3865,45217,1641,50723,"2018-07-01",2018
"18-Jul",서울,중구,1066,46204,4923,52193,"2018-07-01",2018
"18-Jul",서울,중랑구,216,104173,9761,114150,"2018-07-01",2018
"18-Jul",부산,계,4586,1249410,102557,1356553,"2018-07-01",2018
"18-Jul",부산,강서구,326,66159,3819,70304,"2018-07-01",2018
"18-Jul",부산,금정구,273,81577,7336,89186,"2018-07-01",2018
"18-Jul",부산,기장군,245,69828,2142,72215,"2018-07-01",2018
"18-Jul",부산,남구,218,90467,8713,99398,"2018-07-01",2018
"18-Jul",부산,동구,229,44202,4671,49102,"2018-07-01",2018
"18-Jul",부산,동래구,178,88047,4292,92517,"2018-07-01",2018
"18-Jul",부산,부산진구,375,120793,10526,131694,"2018-07-01",2018
"18-Jul",부산,북구,236,100817,3290,104343,"2018-07-01",2018
"18-Jul",부산,사상구,278,84893,5965,91136,"2018-07-01",2018
"18-Jul",부산,사하구,262,108986,7003,116251,"2018-07-01",2018
"18-Jul",부산,서구,138,28158,1351,29647,"2018-07-01",2018
"18-Jul",부산,수영구,162,64106,17914,82182,"2018-07-01",2018
"18-Jul",부산,연제구,836,80467,7003,88306,"2018-07-01",2018
"18-Jul",부산,영도구,226,31752,2529,34507,"2018-07-01",2018
"18-Jul",부산,중구,309,21811,6953,29073,"2018-07-01",2018
"18-Jul",부산,해운대구,295,167347,9050,176692,"2018-07-01",2018
"18-Jul",대구,계,3157,1120071,47814,1171042,"2018-07-01",2018
"18-Jul",대구,남구,326,56339,1845,58510,"2018-07-01",2018
"18-Jul",대구,달서구,472,259378,11927,271777,"2018-07-01",2018
"18-Jul",대구,달성군,479,122006,4516,127001,"2018-07-01",2018
"18-Jul",대구,동구,334,150679,10084,161097,"2018-07-01",2018
"18-Jul",대구,북구,496,192635,7838,200969,"2018-07-01",2018
"18-Jul",대구,서구,229,74175,4324,78728,"2018-07-01",2018
"18-Jul",대구,수성구,549,209462,5403,215414,"2018-07-01",2018
"18-Jul",대구,중구,272,55397,1877,57546,"2018-07-01",2018
"18-Jul",인천,계,3771,1241337,303856,1548964,"2018-07-01",2018
"18-Jul",인천,강화군,310,32175,1318,33803,"2018-07-01",2018
"18-Jul",인천,계양구,275,121306,159439,281020,"2018-07-01",2018
"18-Jul",인천,남구,0,0,0,0,"2018-07-01",2018
"18-Jul",인천,남동구,842,242075,42367,285284,"2018-07-01",2018
"18-Jul",인천,동구,92,26207,2625,28924,"2018-07-01",2018
"18-Jul",인천,부평구,326,215285,8567,224178,"2018-07-01",2018
"18-Jul",인천,서구,370,224651,10622,235643,"2018-07-01",2018
"18-Jul",인천,연수구,341,162519,7244,170104,"2018-07-01",2018
"18-Jul",인천,옹진군,187,11587,210,11984,"2018-07-01",2018
"18-Jul",인천,중구,631,54449,17225,72305,"2018-07-01",2018
"18-Jul",인천,미추홀구,397,151083,54239,205719,"2018-07-01",2018
"18-Jul",광주,계,2087,623913,32381,658381,"2018-07-01",2018
"18-Jul",광주,광산구,501,180073,11246,191820,"2018-07-01",2018
"18-Jul",광주,남구,177,85556,2580,88313,"2018-07-01",2018
"18-Jul",광주,동구,232,35976,1043,37251,"2018-07-01",2018
"18-Jul",광주,북구,481,181504,10496,192481,"2018-07-01",2018
"18-Jul",광주,서구,696,140804,7016,148516,"2018-07-01",2018
"18-Jul",대전,계,1846,635285,28846,665977,"2018-07-01",2018
"18-Jul",대전,대덕구,211,85452,6745,92408,"2018-07-01",2018
"18-Jul",대전,동구,234,87027,4104,91365,"2018-07-01",2018
"18-Jul",대전,서구,795,201441,7164,209400,"2018-07-01",2018
"18-Jul",대전,유성구,371,164791,4945,170107,"2018-07-01",2018
"18-Jul",대전,중구,235,96574,5888,102697,"2018-07-01",2018
"18-Jul",울산,계,1756,533236,20991,555983,"2018-07-01",2018
"18-Jul",울산,남구,716,151715,7180,159611,"2018-07-01",2018
"18-Jul",울산,동구,207,62454,885,63546,"2018-07-01",2018
"18-Jul",울산,북구,144,100436,3935,104515,"2018-07-01",2018
"18-Jul",울산,울주군,350,115924,6266,122540,"2018-07-01",2018
"18-Jul",울산,중구,339,102707,2725,105771,"2018-07-01",2018
"18-Jul",세종,계,690,138729,2481,141900,"2018-07-01",2018
"18-Jul",세종,세종특별자치시,690,138729,2481,141900,"2018-07-01",2018
"18-Jul",경기,계,16546,5280277,224409,5521232,"2018-07-01",2018
"18-Jul",경기,가평군,368,29146,696,30210,"2018-07-01",2018
"18-Jul",경기,고양시 덕양구,634,160339,3659,164632,"2018-07-01",2018
"18-Jul",경기,고양시 일산동구,283,117707,7118,125108,"2018-07-01",2018
"18-Jul",경기,고양시 일산서구,125,108342,3695,112162,"2018-07-01",2018
"18-Jul",경기,과천시,697,19791,592,21080,"2018-07-01",2018
"18-Jul",경기,광명시,297,104375,4197,108869,"2018-07-01",2018
"18-Jul",경기,광주시,375,172095,7742,180212,"2018-07-01",2018
"18-Jul",경기,구리시,246,68946,2530,71722,"2018-07-01",2018
"18-Jul",경기,군포시,283,95060,5022,100365,"2018-07-01",2018
"18-Jul",경기,김포시,469,185978,6688,193135,"2018-07-01",2018
"18-Jul",경기,남양주시,638,266647,7038,274323,"2018-07-01",2018
"18-Jul",경기,동두천시,217,36852,1281,38350,"2018-07-01",2018
"18-Jul",경기,부천시,702,292949,12347,305998,"2018-07-01",2018
"18-Jul",경기,성남시 분당구,332,184043,6823,191198,"2018-07-01",2018
"18-Jul",경기,성남시 수정구,324,70215,2584,73123,"2018-07-01",2018
"18-Jul",경기,성남시 중원구,333,71630,3866,75829,"2018-07-01",2018
"18-Jul",경기,수원시 권선구,380,172342,7413,180135,"2018-07-01",2018
"18-Jul",경기,수원시 영통구,218,133807,3264,137289,"2018-07-01",2018
"18-Jul",경기,수원시 장안구,584,104947,3776,109307,"2018-07-01",2018
"18-Jul",경기,수원시 팔달구,468,69685,3247,73400,"2018-07-01",2018
"18-Jul",경기,시흥시,457,205298,7392,213147,"2018-07-01",2018
"18-Jul",경기,안산시 단원구,529,145206,8369,154104,"2018-07-01",2018
"18-Jul",경기,안산시 상록구,169,137214,4622,142005,"2018-07-01",2018
"18-Jul",경기,안성시,365,93625,4910,98900,"2018-07-01",2018
"18-Jul",경기,안양시 동안구,387,116803,6437,123627,"2018-07-01",2018
"18-Jul",경기,안양시 만안구,169,84435,3730,88334,"2018-07-01",2018
"18-Jul",경기,양주시,377,94223,3013,97613,"2018-07-01",2018
"18-Jul",경기,양평군,513,55894,1717,58124,"2018-07-01",2018
"18-Jul",경기,여주시,413,59223,7205,66841,"2018-07-01",2018
"18-Jul",경기,연천군,294,22899,5429,28622,"2018-07-01",2018
"18-Jul",경기,오산시,228,94695,3182,98105,"2018-07-01",2018
"18-Jul",경기,용인시 기흥구,115,174097,8539,182751,"2018-07-01",2018
"18-Jul",경기,용인시 수지구,45,131920,2083,134048,"2018-07-01",2018
"18-Jul",경기,용인시 처인구,679,115179,6907,122765,"2018-07-01",2018
"18-Jul",경기,의왕시,286,57062,2990,60338,"2018-07-01",2018
"18-Jul",경기,의정부시,579,146972,4615,152166,"2018-07-01",2018
"18-Jul",경기,이천시,379,103979,5939,110297,"2018-07-01",2018
"18-Jul",경기,파주시,474,192556,9508,202538,"2018-07-01",2018
"18-Jul",경기,평택시,676,240679,11124,252479,"2018-07-01",2018
"18-Jul",경기,포천시,335,81376,9476,91187,"2018-07-01",2018
"18-Jul",경기,하남시,360,96726,2242,99328,"2018-07-01",2018
"18-Jul",경기,화성시,744,365320,11402,377466,"2018-07-01",2018
"18-Jul",강원,계,5529,729576,24699,759804,"2018-07-01",2018
"18-Jul",강원,강릉시,494,101572,4513,106579,"2018-07-01",2018
"18-Jul",강원,고성군,187,13500,234,13921,"2018-07-01",2018
"18-Jul",강원,동해시,286,42441,1338,44065,"2018-07-01",2018
"18-Jul",강원,삼척시,359,30851,680,31890,"2018-07-01",2018
"18-Jul",강원,속초시,292,35372,1351,37015,"2018-07-01",2018
"18-Jul",강원,양구군,142,11559,116,11817,"2018-07-01",2018
"18-Jul",강원,양양군,170,14312,210,14692,"2018-07-01",2018
"18-Jul",강원,영월군,318,20037,365,20720,"2018-07-01",2018
"18-Jul",강원,원주시,543,157730,5831,164104,"2018-07-01",2018
"18-Jul",강원,인제군,193,17167,226,17586,"2018-07-01",2018
"18-Jul",강원,정선군,301,19794,447,20542,"2018-07-01",2018
"18-Jul",강원,철원군,213,23145,294,23652,"2018-07-01",2018
"18-Jul",강원,춘천시,738,123856,5696,130290,"2018-07-01",2018
"18-Jul",강원,태백시,214,20129,799,21142,"2018-07-01",2018
"18-Jul",강원,평창군,282,24739,476,25497,"2018-07-01",2018
"18-Jul",강원,홍천군,376,36798,1090,38264,"2018-07-01",2018
"18-Jul",강원,화천군,191,12155,191,12537,"2018-07-01",2018
"18-Jul",강원,횡성군,230,24419,842,25491,"2018-07-01",2018
"18-Jul",충북,계,3826,767460,32638,803924,"2018-07-01",2018
"18-Jul",충북,괴산군,192,21190,352,21734,"2018-07-01",2018
"18-Jul",충북,단양군,200,15278,806,16284,"2018-07-01",2018
"18-Jul",충북,보은군,204,17195,978,18377,"2018-07-01",2018
"18-Jul",충북,영동군,235,24333,386,24954,"2018-07-01",2018
"18-Jul",충북,옥천군,190,25527,1087,26804,"2018-07-01",2018
"18-Jul",충북,음성군,219,55795,1717,57731,"2018-07-01",2018
"18-Jul",충북,제천시,314,64256,3444,68014,"2018-07-01",2018
"18-Jul",충북,증평군,92,18223,746,19061,"2018-07-01",2018
"18-Jul",충북,진천군,204,42484,1186,43874,"2018-07-01",2018
"18-Jul",충북,청원군,1,21,0,22,"2018-07-01",2018
"18-Jul",충북,청주시 상당구,480,76204,2375,79059,"2018-07-01",2018
"18-Jul",충북,청주시 서원구,231,92295,5753,98279,"2018-07-01",2018
"18-Jul",충북,청주시 청원구,345,97260,3907,101512,"2018-07-01",2018
"18-Jul",충북,청주시 흥덕구,362,115053,6153,121568,"2018-07-01",2018
"18-Jul",충북,충주시,557,102346,3748,106651,"2018-07-01",2018
"18-Jul",충남,계,5265,1037813,38639,1081717,"2018-07-01",2018
"18-Jul",충남,계룡시,140,20842,558,21540,"2018-07-01",2018
"18-Jul",충남,공주시,509,51562,2038,54109,"2018-07-01",2018
"18-Jul",충남,금산군,180,27429,1912,29521,"2018-07-01",2018
"18-Jul",충남,논산시,352,58754,2216,61322,"2018-07-01",2018
"18-Jul",충남,당진시,369,89188,3761,93318,"2018-07-01",2018
"18-Jul",충남,보령시,386,49745,1273,51404,"2018-07-01",2018
"18-Jul",충남,부여군,265,33158,1328,34751,"2018-07-01",2018
"18-Jul",충남,서산시,377,87106,3487,90970,"2018-07-01",2018
"18-Jul",충남,서천군,225,26530,890,27645,"2018-07-01",2018
"18-Jul",충남,아산시,438,153810,6346,160594,"2018-07-01",2018
"18-Jul",충남,예산군,356,41171,1413,42940,"2018-07-01",2018
"18-Jul",충남,천안시 동남구,247,122655,4622,127524,"2018-07-01",2018
"18-Jul",충남,천안시 서북구,520,177414,5925,183859,"2018-07-01",2018
"18-Jul",충남,청양군,233,16160,937,17330,"2018-07-01",2018
"18-Jul",충남,태안군,268,32407,496,33171,"2018-07-01",2018
"18-Jul",충남,홍성군,400,49882,1437,51719,"2018-07-01",2018
"18-Jul",전북,계,4804,862980,40116,907900,"2018-07-01",2018
"18-Jul",전북,고창군,251,29382,547,30180,"2018-07-01",2018
"18-Jul",전북,군산시,497,124816,6747,132060,"2018-07-01",2018
"18-Jul",전북,김제시,279,43643,1870,45792,"2018-07-01",2018
"18-Jul",전북,남원시,399,38969,4259,43627,"2018-07-01",2018
"18-Jul",전북,무주군,182,12166,368,12716,"2018-07-01",2018
"18-Jul",전북,부안군,249,26834,591,27674,"2018-07-01",2018
"18-Jul",전북,순창군,200,13979,189,14368,"2018-07-01",2018
"18-Jul",전북,완주군,323,49569,3342,53234,"2018-07-01",2018
"18-Jul",전북,익산시,480,133796,6240,140516,"2018-07-01",2018
"18-Jul",전북,임실군,197,13978,414,14589,"2018-07-01",2018
"18-Jul",전북,장수군,218,11536,176,11930,"2018-07-01",2018
"18-Jul",전북,전주시 덕진구,405,153490,7335,161230,"2018-07-01",2018
"18-Jul",전북,전주시 완산구,584,145602,4087,150273,"2018-07-01",2018
"18-Jul",전북,정읍시,307,51861,3751,55919,"2018-07-01",2018
"18-Jul",전북,진안군,233,13359,200,13792,"2018-07-01",2018
"18-Jul",전남,계,5921,886400,126069,1018390,"2018-07-01",2018
"18-Jul",전남,강진군,208,17827,1036,19071,"2018-07-01",2018
"18-Jul",전남,고흥군,301,29789,658,30748,"2018-07-01",2018
"18-Jul",전남,곡성군,135,14220,802,15157,"2018-07-01",2018
"18-Jul",전남,광양시,240,76667,5900,82807,"2018-07-01",2018
"18-Jul",전남,구례군,122,12784,633,13539,"2018-07-01",2018
"18-Jul",전남,나주시,440,57883,3159,61482,"2018-07-01",2018
"18-Jul",전남,담양군,206,25191,1499,26896,"2018-07-01",2018
"18-Jul",전남,목포시,439,92905,6055,99399,"2018-07-01",2018
"18-Jul",전남,무안군,524,40490,966,41980,"2018-07-01",2018
"18-Jul",전남,보성군,200,20740,69691,90631,"2018-07-01",2018
"18-Jul",전남,순천시,466,128790,4982,134238,"2018-07-01",2018
"18-Jul",전남,신안군,218,19956,835,21009,"2018-07-01",2018
"18-Jul",전남,여수시,540,123025,6817,130382,"2018-07-01",2018
"18-Jul",전남,영광군,227,25966,716,26909,"2018-07-01",2018
"18-Jul",전남,영암군,245,31062,17102,48409,"2018-07-01",2018
"18-Jul",전남,완도군,214,23877,482,24573,"2018-07-01",2018
"18-Jul",전남,장성군,146,24923,1043,26112,"2018-07-01",2018
"18-Jul",전남,장흥군,199,19253,437,19889,"2018-07-01",2018
"18-Jul",전남,진도군,148,15793,302,16243,"2018-07-01",2018
"18-Jul",전남,함평군,162,17294,368,17824,"2018-07-01",2018
"18-Jul",전남,해남군,331,37165,566,38062,"2018-07-01",2018
"18-Jul",전남,화순군,210,30800,2020,33030,"2018-07-01",2018
"18-Jul",경북,계,7040,1355924,48210,1411174,"2018-07-01",2018
"18-Jul",경북,경산시,404,129846,4166,134416,"2018-07-01",2018
"18-Jul",경북,경주시,548,134494,4845,139887,"2018-07-01",2018
"18-Jul",경북,고령군,154,20208,513,20875,"2018-07-01",2018
"18-Jul",경북,구미시,501,203230,7194,210925,"2018-07-01",2018
"18-Jul",경북,군위군,113,14207,276,14596,"2018-07-01",2018
"18-Jul",경북,김천시,358,69983,1811,72152,"2018-07-01",2018
"18-Jul",경북,문경시,289,34388,773,35450,"2018-07-01",2018
"18-Jul",경북,봉화군,194,17009,203,17406,"2018-07-01",2018
"18-Jul",경북,상주시,369,50485,1829,52683,"2018-07-01",2018
"18-Jul",경북,성주군,187,28982,1439,30608,"2018-07-01",2018
"18-Jul",경북,안동시,577,78932,2574,82083,"2018-07-01",2018
"18-Jul",경북,영덕군,244,18329,298,18871,"2018-07-01",2018
"18-Jul",경북,영양군,143,9135,93,9371,"2018-07-01",2018
"18-Jul",경북,영주시,333,53872,1510,55715,"2018-07-01",2018
"18-Jul",경북,영천시,272,55785,2619,58676,"2018-07-01",2018
"18-Jul",경북,예천군,211,26086,453,26750,"2018-07-01",2018
"18-Jul",경북,울릉군,145,5112,406,5663,"2018-07-01",2018
"18-Jul",경북,울진군,282,24974,361,25617,"2018-07-01",2018
"18-Jul",경북,의성군,297,28805,1040,30142,"2018-07-01",2018
"18-Jul",경북,청도군,193,23675,629,24497,"2018-07-01",2018
"18-Jul",경북,청송군,194,14603,193,14990,"2018-07-01",2018
"18-Jul",경북,칠곡군,317,66958,2250,69525,"2018-07-01",2018
"18-Jul",경북,포항시 남구,387,117751,8784,126922,"2018-07-01",2018
"18-Jul",경북,포항시 북구,328,129075,3951,133354,"2018-07-01",2018
"18-Jul",경남,계,6822,1597910,81986,1686718,"2018-07-01",2018
"18-Jul",경남,거제시,346,102447,2174,104967,"2018-07-01",2018
"18-Jul",경남,거창군,245,30425,790,31460,"2018-07-01",2018
"18-Jul",경남,고성군,211,25799,654,26664,"2018-07-01",2018
"18-Jul",경남,김해시,632,254454,6807,261893,"2018-07-01",2018
"18-Jul",경남,남해군,237,18714,491,19442,"2018-07-01",2018
"18-Jul",경남,밀양시,297,53260,4016,57573,"2018-07-01",2018
"18-Jul",경남,사천시,299,53756,1514,55569,"2018-07-01",2018
"18-Jul",경남,산청군,213,19023,760,19996,"2018-07-01",2018
"18-Jul",경남,양산시,384,153758,9477,163619,"2018-07-01",2018
"18-Jul",경남,의령군,189,13623,667,14479,"2018-07-01",2018
"18-Jul",경남,진주시,606,155187,6537,162330,"2018-07-01",2018
"18-Jul",경남,창녕군,231,34256,915,35402,"2018-07-01",2018
"18-Jul",경남,창원시 마산합포구,338,99287,2993,102618,"2018-07-01",2018
"18-Jul",경남,창원시 마산회원구,169,94314,5214,99697,"2018-07-01",2018
"18-Jul",경남,창원시 성산구,143,121413,17088,138644,"2018-07-01",2018
"18-Jul",경남,창원시 의창구,897,126673,6337,133907,"2018-07-01",2018
"18-Jul",경남,창원시 진해구,197,85109,1615,86921,"2018-07-01",2018
"18-Jul",경남,통영시,319,51729,1487,53535,"2018-07-01",2018
"18-Jul",경남,하동군,219,23717,454,24390,"2018-07-01",2018
"18-Jul",경남,함안군,197,40167,10975,51339,"2018-07-01",2018
"18-Jul",경남,함양군,201,18546,387,19134,"2018-07-01",2018
"18-Jul",경남,합천군,252,22253,634,23139,"2018-07-01",2018
"18-Jul",제주,계,2265,366573,164000,532838,"2018-07-01",2018
"18-Jul",제주,서귀포시,739,99393,2046,102178,"2018-07-01",2018
"18-Jul",제주,제주시,1526,267180,161954,430660,"2018-07-01",2018
"18-Aug",서울,계,12205,2906505,202822,3121532,"2018-08-01",2018
"18-Aug",서울,강남구,378,215520,18507,234405,"2018-08-01",2018
"18-Aug",서울,강동구,255,127609,8535,136399,"2018-08-01",2018
"18-Aug",서울,강북구,298,72556,4720,77574,"2018-08-01",2018
"18-Aug",서울,강서구,329,186234,16840,203403,"2018-08-01",2018
"18-Aug",서울,관악구,298,116220,5505,122023,"2018-08-01",2018
"18-Aug",서울,광진구,274,93067,5886,99227,"2018-08-01",2018
"18-Aug",서울,구로구,281,129857,14695,144833,"2018-08-01",2018
"18-Aug",서울,금천구,118,80193,6084,86395,"2018-08-01",2018
"18-Aug",서울,노원구,287,144521,9221,154029,"2018-08-01",2018
"18-Aug",서울,도봉구,257,89595,7578,97430,"2018-08-01",2018
"18-Aug",서울,동대문구,311,92702,5209,98222,"2018-08-01",2018
"18-Aug",서울,동작구,303,102065,2832,105200,"2018-08-01",2018
"18-Aug",서울,마포구,335,110106,6957,117398,"2018-08-01",2018
"18-Aug",서울,서대문구,431,80365,5570,86366,"2018-08-01",2018
"18-Aug",서울,서초구,591,168774,12836,182201,"2018-08-01",2018
"18-Aug",서울,성동구,312,95278,9677,105267,"2018-08-01",2018
"18-Aug",서울,성북구,284,110958,5495,116737,"2018-08-01",2018
"18-Aug",서울,송파구,372,221967,13032,235371,"2018-08-01",2018
"18-Aug",서울,양천구,330,141827,8558,150715,"2018-08-01",2018
"18-Aug",서울,영등포구,358,134874,9424,144656,"2018-08-01",2018
"18-Aug",서울,용산구,378,74654,2197,77229,"2018-08-01",2018
"18-Aug",서울,은평구,258,122097,7147,129502,"2018-08-01",2018
"18-Aug",서울,종로구,3888,45207,1641,50736,"2018-08-01",2018
"18-Aug",서울,중구,1064,46145,4899,52108,"2018-08-01",2018
"18-Aug",서울,중랑구,215,104114,9777,114106,"2018-08-01",2018
"18-Aug",부산,계,4580,1249853,104205,1358638,"2018-08-01",2018
"18-Aug",부산,강서구,325,66554,3844,70723,"2018-08-01",2018
"18-Aug",부산,금정구,276,81500,7357,89133,"2018-08-01",2018
"18-Aug",부산,기장군,245,69926,2197,72368,"2018-08-01",2018
"18-Aug",부산,남구,220,90806,8709,99735,"2018-08-01",2018
"18-Aug",부산,동구,228,44553,4756,49537,"2018-08-01",2018
"18-Aug",부산,동래구,176,88179,4313,92668,"2018-08-01",2018
"18-Aug",부산,부산진구,366,120744,10601,131711,"2018-08-01",2018
"18-Aug",부산,북구,235,100693,3342,104270,"2018-08-01",2018
"18-Aug",부산,사상구,283,84767,6012,91062,"2018-08-01",2018
"18-Aug",부산,사하구,263,108849,7063,116175,"2018-08-01",2018
"18-Aug",부산,서구,137,28233,1361,29731,"2018-08-01",2018
"18-Aug",부산,수영구,163,63888,18935,82986,"2018-08-01",2018
"18-Aug",부산,연제구,831,80227,7064,88122,"2018-08-01",2018
"18-Aug",부산,영도구,229,31679,2114,34022,"2018-08-01",2018
"18-Aug",부산,중구,309,22028,6988,29325,"2018-08-01",2018
"18-Aug",부산,해운대구,294,167227,9549,177070,"2018-08-01",2018
"18-Aug",대구,계,3149,1120445,48209,1171803,"2018-08-01",2018
"18-Aug",대구,남구,328,56450,1875,58653,"2018-08-01",2018
"18-Aug",대구,달서구,461,259619,11947,272027,"2018-08-01",2018
"18-Aug",대구,달성군,480,122481,4685,127646,"2018-08-01",2018
"18-Aug",대구,동구,336,150555,10181,161072,"2018-08-01",2018
"18-Aug",대구,북구,494,192937,7908,201339,"2018-08-01",2018
"18-Aug",대구,서구,226,73761,4347,78334,"2018-08-01",2018
"18-Aug",대구,수성구,547,209362,5376,215285,"2018-08-01",2018
"18-Aug",대구,중구,277,55280,1890,57447,"2018-08-01",2018
"18-Aug",인천,계,3792,1243210,306502,1553504,"2018-08-01",2018
"18-Aug",인천,강화군,312,32273,1325,33910,"2018-08-01",2018
"18-Aug",인천,계양구,278,121300,160681,282259,"2018-08-01",2018
"18-Aug",인천,남구,0,0,0,0,"2018-08-01",2018
"18-Aug",인천,남동구,840,243127,42397,286364,"2018-08-01",2018
"18-Aug",인천,동구,90,26307,2634,29031,"2018-08-01",2018
"18-Aug",인천,부평구,336,215075,8837,224248,"2018-08-01",2018
"18-Aug",인천,서구,375,224862,10773,236010,"2018-08-01",2018
"18-Aug",인천,연수구,341,162722,7343,170406,"2018-08-01",2018
"18-Aug",인천,옹진군,186,11653,210,12049,"2018-08-01",2018
"18-Aug",인천,중구,632,54734,17233,72599,"2018-08-01",2018
"18-Aug",인천,미추홀구,402,151157,55069,206628,"2018-08-01",2018
"18-Aug",광주,계,2094,624794,32663,659551,"2018-08-01",2018
"18-Aug",광주,광산구,502,180586,11323,192411,"2018-08-01",2018
"18-Aug",광주,남구,178,85566,2606,88350,"2018-08-01",2018
"18-Aug",광주,동구,230,35968,1044,37242,"2018-08-01",2018
"18-Aug",광주,북구,483,182025,10377,192885,"2018-08-01",2018
"18-Aug",광주,서구,701,140649,7313,148663,"2018-08-01",2018
"18-Aug",대전,계,1837,635941,29117,666895,"2018-08-01",2018
"18-Aug",대전,대덕구,210,85284,6798,92292,"2018-08-01",2018
"18-Aug",대전,동구,238,87288,4131,91657,"2018-08-01",2018
"18-Aug",대전,서구,791,201571,7269,209631,"2018-08-01",2018
"18-Aug",대전,유성구,367,165213,4982,170562,"2018-08-01",2018
"18-Aug",대전,중구,231,96585,5937,102753,"2018-08-01",2018
"18-Aug",울산,계,1753,533340,21216,556309,"2018-08-01",2018
"18-Aug",울산,남구,714,151590,7224,159528,"2018-08-01",2018
"18-Aug",울산,동구,207,62348,940,63495,"2018-08-01",2018
"18-Aug",울산,북구,140,100633,3962,104735,"2018-08-01",2018
"18-Aug",울산,울주군,349,116181,6326,122856,"2018-08-01",2018
"18-Aug",울산,중구,343,102588,2764,105695,"2018-08-01",2018
"18-Aug",세종,계,699,140193,2514,143406,"2018-08-01",2018
"18-Aug",세종,세종특별자치시,699,140193,2514,143406,"2018-08-01",2018
"18-Aug",경기,계,16604,5293614,227405,5537623,"2018-08-01",2018
"18-Aug",경기,가평군,359,29220,690,30269,"2018-08-01",2018
"18-Aug",경기,고양시 덕양구,645,160681,3785,165111,"2018-08-01",2018
"18-Aug",경기,고양시 일산동구,291,118047,7188,125526,"2018-08-01",2018
"18-Aug",경기,고양시 일산서구,126,108042,3787,111955,"2018-08-01",2018
"18-Aug",경기,과천시,693,19980,604,21277,"2018-08-01",2018
"18-Aug",경기,광명시,298,104179,4239,108716,"2018-08-01",2018
"18-Aug",경기,광주시,380,172839,7874,181093,"2018-08-01",2018
"18-Aug",경기,구리시,245,69020,2581,71846,"2018-08-01",2018
"18-Aug",경기,군포시,290,94991,5069,100350,"2018-08-01",2018
"18-Aug",경기,김포시,461,187555,6825,194841,"2018-08-01",2018
"18-Aug",경기,남양주시,652,267853,7288,275793,"2018-08-01",2018
"18-Aug",경기,동두천시,216,36837,1320,38373,"2018-08-01",2018
"18-Aug",경기,부천시,703,292657,12525,305885,"2018-08-01",2018
"18-Aug",경기,성남시 분당구,337,183897,6937,191171,"2018-08-01",2018
"18-Aug",경기,성남시 수정구,322,70215,2625,73162,"2018-08-01",2018
"18-Aug",경기,성남시 중원구,333,71603,3883,75819,"2018-08-01",2018
"18-Aug",경기,수원시 권선구,374,172421,7599,180394,"2018-08-01",2018
"18-Aug",경기,수원시 영통구,224,134151,3288,137663,"2018-08-01",2018
"18-Aug",경기,수원시 장안구,585,104671,3840,109096,"2018-08-01",2018
"18-Aug",경기,수원시 팔달구,469,69523,3226,73218,"2018-08-01",2018
"18-Aug",경기,시흥시,456,206693,7512,214661,"2018-08-01",2018
"18-Aug",경기,안산시 단원구,532,144947,8408,153887,"2018-08-01",2018
"18-Aug",경기,안산시 상록구,172,136909,4701,141782,"2018-08-01",2018
"18-Aug",경기,안성시,363,93980,4959,99302,"2018-08-01",2018
"18-Aug",경기,안양시 동안구,384,116652,6427,123463,"2018-08-01",2018
"18-Aug",경기,안양시 만안구,169,84308,3797,88274,"2018-08-01",2018
"18-Aug",경기,양주시,378,94623,3121,98122,"2018-08-01",2018
"18-Aug",경기,양평군,520,56012,1746,58278,"2018-08-01",2018
"18-Aug",경기,여주시,415,59420,7187,67022,"2018-08-01",2018
"18-Aug",경기,연천군,294,22937,5439,28670,"2018-08-01",2018
"18-Aug",경기,오산시,226,94674,3224,98124,"2018-08-01",2018
"18-Aug",경기,용인시 기흥구,115,174631,8599,183345,"2018-08-01",2018
"18-Aug",경기,용인시 수지구,45,131948,2095,134088,"2018-08-01",2018
"18-Aug",경기,용인시 처인구,680,116719,6902,124301,"2018-08-01",2018
"18-Aug",경기,의왕시,285,56991,2986,60262,"2018-08-01",2018
"18-Aug",경기,의정부시,577,147406,4772,152755,"2018-08-01",2018
"18-Aug",경기,이천시,391,104141,5870,110402,"2018-08-01",2018
"18-Aug",경기,파주시,471,193892,9647,204010,"2018-08-01",2018
"18-Aug",경기,평택시,674,241807,11537,254018,"2018-08-01",2018
"18-Aug",경기,포천시,349,81334,9374,91057,"2018-08-01",2018
"18-Aug",경기,하남시,359,97350,2341,100050,"2018-08-01",2018
"18-Aug",경기,화성시,746,367858,11588,380192,"2018-08-01",2018
"18-Aug",강원,계,5534,731142,24921,761597,"2018-08-01",2018
"18-Aug",강원,강릉시,494,101735,4552,106781,"2018-08-01",2018
"18-Aug",강원,고성군,183,13554,237,13974,"2018-08-01",2018
"18-Aug",강원,동해시,286,42574,1358,44218,"2018-08-01",2018
"18-Aug",강원,삼척시,361,30875,691,31927,"2018-08-01",2018
"18-Aug",강원,속초시,289,35367,1368,37024,"2018-08-01",2018
"18-Aug",강원,양구군,142,11548,120,11810,"2018-08-01",2018
"18-Aug",강원,양양군,169,14383,212,14764,"2018-08-01",2018
"18-Aug",강원,영월군,319,20080,365,20764,"2018-08-01",2018
"18-Aug",강원,원주시,541,158143,5867,164551,"2018-08-01",2018
"18-Aug",강원,인제군,194,17203,225,17622,"2018-08-01",2018
"18-Aug",강원,정선군,304,19812,453,20569,"2018-08-01",2018
"18-Aug",강원,철원군,214,23252,303,23769,"2018-08-01",2018
"18-Aug",강원,춘천시,744,124143,5765,130652,"2018-08-01",2018
"18-Aug",강원,태백시,215,20133,802,21150,"2018-08-01",2018
"18-Aug",강원,평창군,281,24717,476,25474,"2018-08-01",2018
"18-Aug",강원,홍천군,375,36870,1099,38344,"2018-08-01",2018
"18-Aug",강원,화천군,194,12180,191,12565,"2018-08-01",2018
"18-Aug",강원,횡성군,229,24573,837,25639,"2018-08-01",2018
"18-Aug",충북,계,3818,768944,33029,805791,"2018-08-01",2018
"18-Aug",충북,괴산군,191,21203,360,21754,"2018-08-01",2018
"18-Aug",충북,단양군,198,15324,809,16331,"2018-08-01",2018
"18-Aug",충북,보은군,206,17217,984,18407,"2018-08-01",2018
"18-Aug",충북,영동군,237,24339,374,24950,"2018-08-01",2018
"18-Aug",충북,옥천군,192,25550,1067,26809,"2018-08-01",2018
"18-Aug",충북,음성군,218,55800,1733,57751,"2018-08-01",2018
"18-Aug",충북,제천시,313,64422,3478,68213,"2018-08-01",2018
"18-Aug",충북,증평군,94,18257,755,19106,"2018-08-01",2018
"18-Aug",충북,진천군,204,42911,1248,44363,"2018-08-01",2018
"18-Aug",충북,청원군,1,21,0,22,"2018-08-01",2018
"18-Aug",충북,청주시 상당구,474,76175,2311,78960,"2018-08-01",2018
"18-Aug",충북,청주시 서원구,231,92351,5898,98480,"2018-08-01",2018
"18-Aug",충북,청주시 청원구,344,97362,3965,101671,"2018-08-01",2018
"18-Aug",충북,청주시 흥덕구,361,115468,6235,122064,"2018-08-01",2018
"18-Aug",충북,충주시,554,102544,3812,106910,"2018-08-01",2018
"18-Aug",충남,계,5288,1039866,39018,1084172,"2018-08-01",2018
"18-Aug",충남,계룡시,140,20883,569,21592,"2018-08-01",2018
"18-Aug",충남,공주시,515,51736,2069,54320,"2018-08-01",2018
"18-Aug",충남,금산군,181,27517,1935,29633,"2018-08-01",2018
"18-Aug",충남,논산시,353,58789,2245,61387,"2018-08-01",2018
"18-Aug",충남,당진시,370,89396,3795,93561,"2018-08-01",2018
"18-Aug",충남,보령시,386,49852,1281,51519,"2018-08-01",2018
"18-Aug",충남,부여군,265,33233,1348,34846,"2018-08-01",2018
"18-Aug",충남,서산시,378,87406,3528,91312,"2018-08-01",2018
"18-Aug",충남,서천군,227,26503,903,27633,"2018-08-01",2018
"18-Aug",충남,아산시,435,154026,6384,160845,"2018-08-01",2018
"18-Aug",충남,예산군,355,41248,1420,43023,"2018-08-01",2018
"18-Aug",충남,천안시 동남구,256,122815,4673,127744,"2018-08-01",2018
"18-Aug",충남,천안시 서북구,523,177876,5980,184379,"2018-08-01",2018
"18-Aug",충남,청양군,235,16182,940,17357,"2018-08-01",2018
"18-Aug",충남,태안군,269,32491,504,33264,"2018-08-01",2018
"18-Aug",충남,홍성군,400,49913,1444,51757,"2018-08-01",2018
"18-Aug",전북,계,4815,864512,40492,909819,"2018-08-01",2018
"18-Aug",전북,고창군,251,29398,558,30207,"2018-08-01",2018
"18-Aug",전북,군산시,496,125005,6811,132312,"2018-08-01",2018
"18-Aug",전북,김제시,280,43708,1919,45907,"2018-08-01",2018
"18-Aug",전북,남원시,399,39067,4240,43706,"2018-08-01",2018
"18-Aug",전북,무주군,183,12212,375,12770,"2018-08-01",2018
"18-Aug",전북,부안군,250,26876,598,27724,"2018-08-01",2018
"18-Aug",전북,순창군,202,13998,196,14396,"2018-08-01",2018
"18-Aug",전북,완주군,326,49592,3356,53274,"2018-08-01",2018
"18-Aug",전북,익산시,481,133977,6281,140739,"2018-08-01",2018
"18-Aug",전북,임실군,196,13998,421,14615,"2018-08-01",2018
"18-Aug",전북,장수군,219,11526,178,11923,"2018-08-01",2018
"18-Aug",전북,전주시 덕진구,409,154234,7447,162090,"2018-08-01",2018
"18-Aug",전북,전주시 완산구,585,145507,4110,150202,"2018-08-01",2018
"18-Aug",전북,정읍시,304,52003,3800,56107,"2018-08-01",2018
"18-Aug",전북,진안군,234,13411,202,13847,"2018-08-01",2018
"18-Aug",전남,계,5894,887877,126181,1019952,"2018-08-01",2018
"18-Aug",전남,강진군,210,17809,1036,19055,"2018-08-01",2018
"18-Aug",전남,고흥군,293,29848,659,30800,"2018-08-01",2018
"18-Aug",전남,곡성군,135,14224,804,15163,"2018-08-01",2018
"18-Aug",전남,광양시,240,76613,5951,82804,"2018-08-01",2018
"18-Aug",전남,구례군,124,12790,637,13551,"2018-08-01",2018
"18-Aug",전남,나주시,440,58121,3102,61663,"2018-08-01",2018
"18-Aug",전남,담양군,205,25205,1516,26926,"2018-08-01",2018
"18-Aug",전남,목포시,440,93067,6149,99656,"2018-08-01",2018
"18-Aug",전남,무안군,521,40525,973,42019,"2018-08-01",2018
"18-Aug",전남,보성군,198,20745,69625,90568,"2018-08-01",2018
"18-Aug",전남,순천시,466,129308,5030,134804,"2018-08-01",2018
"18-Aug",전남,신안군,212,19976,843,21031,"2018-08-01",2018
"18-Aug",전남,여수시,533,123082,6879,130494,"2018-08-01",2018
"18-Aug",전남,영광군,228,25984,727,26939,"2018-08-01",2018
"18-Aug",전남,영암군,245,31155,16464,47864,"2018-08-01",2018
"18-Aug",전남,완도군,213,23910,492,24615,"2018-08-01",2018
"18-Aug",전남,장성군,146,25017,993,26156,"2018-08-01",2018
"18-Aug",전남,장흥군,201,19220,436,19857,"2018-08-01",2018
"18-Aug",전남,진도군,147,15811,306,16264,"2018-08-01",2018
"18-Aug",전남,함평군,165,17316,970,18451,"2018-08-01",2018
"18-Aug",전남,해남군,323,37272,571,38166,"2018-08-01",2018
"18-Aug",전남,화순군,209,30879,2018,33106,"2018-08-01",2018
"18-Aug",경북,계,7018,1357562,48619,1413199,"2018-08-01",2018
"18-Aug",경북,경산시,317,129994,4291,134602,"2018-08-01",2018
"18-Aug",경북,경주시,549,134745,4849,140143,"2018-08-01",2018
"18-Aug",경북,고령군,155,20122,522,20799,"2018-08-01",2018
"18-Aug",경북,구미시,498,203356,7264,211118,"2018-08-01",2018
"18-Aug",경북,군위군,112,14196,277,14585,"2018-08-01",2018
"18-Aug",경북,김천시,357,70100,1839,72296,"2018-08-01",2018
"18-Aug",경북,문경시,290,34382,799,35471,"2018-08-01",2018
"18-Aug",경북,봉화군,195,17018,206,17419,"2018-08-01",2018
"18-Aug",경북,상주시,365,50597,1855,52817,"2018-08-01",2018
"18-Aug",경북,성주군,187,29064,1453,30704,"2018-08-01",2018
"18-Aug",경북,안동시,663,78857,2592,82112,"2018-08-01",2018
"18-Aug",경북,영덕군,245,18341,308,18894,"2018-08-01",2018
"18-Aug",경북,영양군,141,9129,95,9365,"2018-08-01",2018
"18-Aug",경북,영주시,334,53889,1512,55735,"2018-08-01",2018
"18-Aug",경북,영천시,272,55918,2665,58855,"2018-08-01",2018
"18-Aug",경북,예천군,208,26336,460,27004,"2018-08-01",2018
"18-Aug",경북,울릉군,146,5122,406,5674,"2018-08-01",2018
"18-Aug",경북,울진군,281,24972,362,25615,"2018-08-01",2018
"18-Aug",경북,의성군,291,28871,1022,30184,"2018-08-01",2018
"18-Aug",경북,청도군,192,23693,640,24525,"2018-08-01",2018
"18-Aug",경북,청송군,195,14605,195,14995,"2018-08-01",2018
"18-Aug",경북,칠곡군,315,66955,2266,69536,"2018-08-01",2018
"18-Aug",경북,포항시 남구,383,117939,8821,127143,"2018-08-01",2018
"18-Aug",경북,포항시 북구,327,129361,3920,133608,"2018-08-01",2018
"18-Aug",경남,계,6817,1599321,82556,1688694,"2018-08-01",2018
"18-Aug",경남,거제시,342,102468,2247,105057,"2018-08-01",2018
"18-Aug",경남,거창군,248,30445,804,31497,"2018-08-01",2018
"18-Aug",경남,고성군,206,25831,651,26688,"2018-08-01",2018
"18-Aug",경남,김해시,633,255021,6901,262555,"2018-08-01",2018
"18-Aug",경남,남해군,243,18743,497,19483,"2018-08-01",2018
"18-Aug",경남,밀양시,294,53286,4037,57617,"2018-08-01",2018
"18-Aug",경남,사천시,309,53912,1515,55736,"2018-08-01",2018
"18-Aug",경남,산청군,218,19084,755,20057,"2018-08-01",2018
"18-Aug",경남,양산시,385,154281,9584,164250,"2018-08-01",2018
"18-Aug",경남,의령군,189,13627,674,14490,"2018-08-01",2018
"18-Aug",경남,진주시,608,155401,6577,162586,"2018-08-01",2018
"18-Aug",경남,창녕군,229,34231,944,35404,"2018-08-01",2018
"18-Aug",경남,창원시 마산합포구,336,99017,3025,102378,"2018-08-01",2018
"18-Aug",경남,창원시 마산회원구,169,94388,5269,99826,"2018-08-01",2018
"18-Aug",경남,창원시 성산구,141,121219,16843,138203,"2018-08-01",2018
"18-Aug",경남,창원시 의창구,886,126624,6405,133915,"2018-08-01",2018
"18-Aug",경남,창원시 진해구,197,85391,1651,87239,"2018-08-01",2018
"18-Aug",경남,통영시,316,51724,1506,53546,"2018-08-01",2018
"18-Aug",경남,하동군,220,23711,457,24388,"2018-08-01",2018
"18-Aug",경남,함안군,199,40101,11177,51477,"2018-08-01",2018
"18-Aug",경남,함양군,200,18553,401,19154,"2018-08-01",2018
"18-Aug",경남,합천군,249,22263,636,23148,"2018-08-01",2018
"18-Aug",제주,계,2253,366849,168068,537170,"2018-08-01",2018
"18-Aug",제주,서귀포시,739,99720,2051,102510,"2018-08-01",2018
"18-Aug",제주,제주시,1514,267129,166017,434660,"2018-08-01",2018
"18-Sep",서울,계,12133,2907162,204629,3123924,"2018-09-01",2018
"18-Sep",서울,강남구,380,215311,19597,235288,"2018-09-01",2018
"18-Sep",서울,강동구,260,127450,8599,136309,"2018-09-01",2018
"18-Sep",서울,강북구,297,72510,4725,77532,"2018-09-01",2018
"18-Sep",서울,강서구,329,185951,17052,203332,"2018-09-01",2018
"18-Sep",서울,관악구,299,116267,5527,122093,"2018-09-01",2018
"18-Sep",서울,광진구,274,93375,6045,99694,"2018-09-01",2018
"18-Sep",서울,구로구,283,129884,14716,144883,"2018-09-01",2018
"18-Sep",서울,금천구,118,80376,6020,86514,"2018-09-01",2018
"18-Sep",서울,노원구,290,144529,9227,154046,"2018-09-01",2018
"18-Sep",서울,도봉구,259,89608,7590,97457,"2018-09-01",2018
"18-Sep",서울,동대문구,312,92794,5235,98341,"2018-09-01",2018
"18-Sep",서울,동작구,303,102189,2830,105322,"2018-09-01",2018
"18-Sep",서울,마포구,336,110238,6933,117507,"2018-09-01",2018
"18-Sep",서울,서대문구,441,80399,5587,86427,"2018-09-01",2018
"18-Sep",서울,서초구,600,168833,12899,182332,"2018-09-01",2018
"18-Sep",서울,성동구,312,95490,9712,105514,"2018-09-01",2018
"18-Sep",서울,성북구,289,110950,5518,116757,"2018-09-01",2018
"18-Sep",서울,송파구,374,222215,13114,235703,"2018-09-01",2018
"18-Sep",서울,양천구,333,141862,8601,150796,"2018-09-01",2018
"18-Sep",서울,영등포구,361,134538,9431,144330,"2018-09-01",2018
"18-Sep",서울,용산구,381,74732,2205,77318,"2018-09-01",2018
"18-Sep",서울,은평구,263,122110,7155,129528,"2018-09-01",2018
"18-Sep",서울,종로구,3751,45279,1653,50683,"2018-09-01",2018
"18-Sep",서울,중구,1074,46121,4879,52074,"2018-09-01",2018
"18-Sep",서울,중랑구,214,104151,9779,114144,"2018-09-01",2018
"18-Sep",부산,계,4584,1251275,105205,1361064,"2018-09-01",2018
"18-Sep",부산,강서구,323,66835,3823,70981,"2018-09-01",2018
"18-Sep",부산,금정구,279,81598,7364,89241,"2018-09-01",2018
"18-Sep",부산,기장군,246,70122,2215,72583,"2018-09-01",2018
"18-Sep",부산,남구,223,91174,8725,100122,"2018-09-01",2018
"18-Sep",부산,동구,228,44871,4716,49815,"2018-09-01",2018
"18-Sep",부산,동래구,174,88270,4266,92710,"2018-09-01",2018
"18-Sep",부산,부산진구,366,120576,10731,131673,"2018-09-01",2018
"18-Sep",부산,북구,235,100764,3328,104327,"2018-09-01",2018
"18-Sep",부산,사상구,286,84774,6021,91081,"2018-09-01",2018
"18-Sep",부산,사하구,262,108847,7054,116163,"2018-09-01",2018
"18-Sep",부산,서구,135,28266,1368,29769,"2018-09-01",2018
"18-Sep",부산,수영구,164,63755,19417,83336,"2018-09-01",2018
"18-Sep",부산,연제구,831,80227,7161,88219,"2018-09-01",2018
"18-Sep",부산,영도구,229,31659,2110,33998,"2018-09-01",2018
"18-Sep",부산,중구,310,22187,7003,29500,"2018-09-01",2018
"18-Sep",부산,해운대구,293,167350,9903,177546,"2018-09-01",2018
"18-Sep",대구,계,3149,1122391,48313,1173853,"2018-09-01",2018
"18-Sep",대구,남구,327,56429,1876,58632,"2018-09-01",2018
"18-Sep",대구,달서구,464,260225,11977,272666,"2018-09-01",2018
"18-Sep",대구,달성군,480,122869,4699,128048,"2018-09-01",2018
"18-Sep",대구,동구,336,150685,10162,161183,"2018-09-01",2018
"18-Sep",대구,북구,491,193463,7942,201896,"2018-09-01",2018
"18-Sep",대구,서구,224,73595,4362,78181,"2018-09-01",2018
"18-Sep",대구,수성구,546,209466,5395,215407,"2018-09-01",2018
"18-Sep",대구,중구,281,55659,1900,57840,"2018-09-01",2018
"18-Sep",인천,계,3788,1249126,305653,1558567,"2018-09-01",2018
"18-Sep",인천,강화군,311,32381,1314,34006,"2018-09-01",2018
"18-Sep",인천,계양구,277,121495,159614,281386,"2018-09-01",2018
"18-Sep",인천,남구,0,0,0,0,"2018-09-01",2018
"18-Sep",인천,남동구,843,247178,42529,290550,"2018-09-01",2018
"18-Sep",인천,동구,87,26346,2628,29061,"2018-09-01",2018
"18-Sep",인천,부평구,336,215393,9026,224755,"2018-09-01",2018
"18-Sep",인천,서구,376,225486,10810,236672,"2018-09-01",2018
"18-Sep",인천,연수구,346,162777,7415,170538,"2018-09-01",2018
"18-Sep",인천,옹진군,187,11667,209,12063,"2018-09-01",2018
"18-Sep",인천,중구,625,55059,17253,72937,"2018-09-01",2018
"18-Sep",인천,미추홀구,400,151344,54855,206599,"2018-09-01",2018
"18-Sep",광주,계,2099,626053,32685,660837,"2018-09-01",2018
"18-Sep",광주,광산구,502,180952,11372,192826,"2018-09-01",2018
"18-Sep",광주,남구,177,85618,2618,88413,"2018-09-01",2018
"18-Sep",광주,동구,230,36069,1054,37353,"2018-09-01",2018
"18-Sep",광주,북구,485,182570,10352,193407,"2018-09-01",2018
"18-Sep",광주,서구,705,140844,7289,148838,"2018-09-01",2018
"18-Sep",대전,계,1840,637005,29244,668089,"2018-09-01",2018
"18-Sep",대전,대덕구,211,85293,6789,92293,"2018-09-01",2018
"18-Sep",대전,동구,240,87548,4157,91945,"2018-09-01",2018
"18-Sep",대전,서구,790,201828,7362,209980,"2018-09-01",2018
"18-Sep",대전,유성구,368,165647,4991,171006,"2018-09-01",2018
"18-Sep",대전,중구,231,96689,5945,102865,"2018-09-01",2018
"18-Sep",울산,계,1722,534007,21219,556948,"2018-09-01",2018
"18-Sep",울산,남구,689,151749,7278,159716,"2018-09-01",2018
"18-Sep",울산,동구,195,62353,941,63489,"2018-09-01",2018
"18-Sep",울산,북구,167,100896,3944,105007,"2018-09-01",2018
"18-Sep",울산,울주군,341,116492,6329,123162,"2018-09-01",2018
"18-Sep",울산,중구,330,102517,2727,105574,"2018-09-01",2018
"18-Sep",세종,계,703,141500,2531,144734,"2018-09-01",2018
"18-Sep",세종,세종특별자치시,703,141500,2531,144734,"2018-09-01",2018
"18-Sep",경기,계,16664,5309535,229423,5555622,"2018-09-01",2018
"18-Sep",경기,가평군,358,29290,690,30338,"2018-09-01",2018
"18-Sep",경기,고양시 덕양구,644,160990,3788,165422,"2018-09-01",2018
"18-Sep",경기,고양시 일산동구,288,118294,7421,126003,"2018-09-01",2018
"18-Sep",경기,고양시 일산서구,126,108041,3739,111906,"2018-09-01",2018
"18-Sep",경기,과천시,691,20143,601,21435,"2018-09-01",2018
"18-Sep",경기,광명시,302,104125,4073,108500,"2018-09-01",2018
"18-Sep",경기,광주시,374,173588,7876,181838,"2018-09-01",2018
"18-Sep",경기,구리시,245,69239,2600,72084,"2018-09-01",2018
"18-Sep",경기,군포시,291,95142,5061,100494,"2018-09-01",2018
"18-Sep",경기,김포시,458,188812,6833,196103,"2018-09-01",2018
"18-Sep",경기,남양주시,651,268683,7382,276716,"2018-09-01",2018
"18-Sep",경기,동두천시,215,36910,1317,38442,"2018-09-01",2018
"18-Sep",경기,부천시,709,293072,12607,306388,"2018-09-01",2018
"18-Sep",경기,성남시 분당구,337,184104,6907,191348,"2018-09-01",2018
"18-Sep",경기,성남시 수정구,335,70221,2627,73183,"2018-09-01",2018
"18-Sep",경기,성남시 중원구,333,71633,3937,75903,"2018-09-01",2018
"18-Sep",경기,수원시 권선구,373,172563,7652,180588,"2018-09-01",2018
"18-Sep",경기,수원시 영통구,224,134362,3309,137895,"2018-09-01",2018
"18-Sep",경기,수원시 장안구,589,104416,3956,108961,"2018-09-01",2018
"18-Sep",경기,수원시 팔달구,472,69409,3233,73114,"2018-09-01",2018
"18-Sep",경기,시흥시,455,207624,7507,215586,"2018-09-01",2018
"18-Sep",경기,안산시 단원구,540,145330,8432,154302,"2018-09-01",2018
"18-Sep",경기,안산시 상록구,172,136670,4728,141570,"2018-09-01",2018
"18-Sep",경기,안성시,369,94397,4941,99707,"2018-09-01",2018
"18-Sep",경기,안양시 동안구,386,116551,6442,123379,"2018-09-01",2018
"18-Sep",경기,안양시 만안구,151,84206,3808,88165,"2018-09-01",2018
"18-Sep",경기,양주시,378,95003,3134,98515,"2018-09-01",2018
"18-Sep",경기,양평군,524,56110,1752,58386,"2018-09-01",2018
"18-Sep",경기,여주시,421,59503,7214,67138,"2018-09-01",2018
"18-Sep",경기,연천군,293,22940,5432,28665,"2018-09-01",2018
"18-Sep",경기,오산시,227,94788,3243,98258,"2018-09-01",2018
"18-Sep",경기,용인시 기흥구,116,175245,8598,183959,"2018-09-01",2018
"18-Sep",경기,용인시 수지구,45,132367,2107,134519,"2018-09-01",2018
"18-Sep",경기,용인시 처인구,681,118282,6916,125879,"2018-09-01",2018
"18-Sep",경기,의왕시,281,57042,3014,60337,"2018-09-01",2018
"18-Sep",경기,의정부시,578,147988,4841,153407,"2018-09-01",2018
"18-Sep",경기,이천시,401,104335,5776,110512,"2018-09-01",2018
"18-Sep",경기,파주시,474,195143,9737,205354,"2018-09-01",2018
"18-Sep",경기,평택시,684,242711,11551,254946,"2018-09-01",2018
"18-Sep",경기,포천시,350,81525,10437,92312,"2018-09-01",2018
"18-Sep",경기,하남시,358,98067,2351,100776,"2018-09-01",2018
"18-Sep",경기,화성시,765,370671,11853,383289,"2018-09-01",2018
"18-Sep",강원,계,5573,732901,24941,763415,"2018-09-01",2018
"18-Sep",강원,강릉시,496,101882,4581,106959,"2018-09-01",2018
"18-Sep",강원,고성군,182,13601,239,14022,"2018-09-01",2018
"18-Sep",강원,동해시,290,42632,1356,44278,"2018-09-01",2018
"18-Sep",강원,삼척시,365,30985,686,32036,"2018-09-01",2018
"18-Sep",강원,속초시,287,35471,1368,37126,"2018-09-01",2018
"18-Sep",강원,양구군,142,11566,119,11827,"2018-09-01",2018
"18-Sep",강원,양양군,171,14399,211,14781,"2018-09-01",2018
"18-Sep",강원,영월군,321,20157,366,20844,"2018-09-01",2018
"18-Sep",강원,원주시,543,158589,5878,165010,"2018-09-01",2018
"18-Sep",강원,인제군,195,17222,231,17648,"2018-09-01",2018
"18-Sep",강원,정선군,308,19875,452,20635,"2018-09-01",2018
"18-Sep",강원,철원군,216,23268,302,23786,"2018-09-01",2018
"18-Sep",강원,춘천시,749,124455,5760,130964,"2018-09-01",2018
"18-Sep",강원,태백시,217,20133,803,21153,"2018-09-01",2018
"18-Sep",강원,평창군,286,24775,473,25534,"2018-09-01",2018
"18-Sep",강원,홍천군,381,36974,1096,38451,"2018-09-01",2018
"18-Sep",강원,화천군,196,12207,197,12600,"2018-09-01",2018
"18-Sep",강원,횡성군,228,24710,823,25761,"2018-09-01",2018
"18-Sep",충북,계,3836,770791,33199,807826,"2018-09-01",2018
"18-Sep",충북,괴산군,191,21183,362,21736,"2018-09-01",2018
"18-Sep",충북,단양군,199,15378,805,16382,"2018-09-01",2018
"18-Sep",충북,보은군,201,17238,992,18431,"2018-09-01",2018
"18-Sep",충북,영동군,238,24332,379,24949,"2018-09-01",2018
"18-Sep",충북,옥천군,192,25622,1084,26898,"2018-09-01",2018
"18-Sep",충북,음성군,220,55908,1739,57867,"2018-09-01",2018
"18-Sep",충북,제천시,313,64595,3476,68384,"2018-09-01",2018
"18-Sep",충북,증평군,95,18273,764,19132,"2018-09-01",2018
"18-Sep",충북,진천군,206,43186,1249,44641,"2018-09-01",2018
"18-Sep",충북,청원군,1,21,0,22,"2018-09-01",2018
"18-Sep",충북,청주시 상당구,485,76201,2319,79005,"2018-09-01",2018
"18-Sep",충북,청주시 서원구,238,92281,5273,97792,"2018-09-01",2018
"18-Sep",충북,청주시 청원구,340,98040,4009,102389,"2018-09-01",2018
"18-Sep",충북,청주시 흥덕구,360,115786,6933,123079,"2018-09-01",2018
"18-Sep",충북,충주시,557,102747,3815,107119,"2018-09-01",2018
"18-Sep",충남,계,5319,1042275,39044,1086638,"2018-09-01",2018
"18-Sep",충남,계룡시,140,20953,566,21659,"2018-09-01",2018
"18-Sep",충남,공주시,521,51850,2080,54451,"2018-09-01",2018
"18-Sep",충남,금산군,182,27568,1969,29719,"2018-09-01",2018
"18-Sep",충남,논산시,355,58874,2246,61475,"2018-09-01",2018
"18-Sep",충남,당진시,371,89554,3793,93718,"2018-09-01",2018
"18-Sep",충남,보령시,387,49981,1282,51650,"2018-09-01",2018
"18-Sep",충남,부여군,266,33321,1338,34925,"2018-09-01",2018
"18-Sep",충남,서산시,382,87702,3539,91623,"2018-09-01",2018
"18-Sep",충남,서천군,227,26528,903,27658,"2018-09-01",2018
"18-Sep",충남,아산시,436,154359,6374,161169,"2018-09-01",2018
"18-Sep",충남,예산군,357,41351,1427,43135,"2018-09-01",2018
"18-Sep",충남,천안시 동남구,258,123284,4691,128233,"2018-09-01",2018
"18-Sep",충남,천안시 서북구,529,178323,5963,184815,"2018-09-01",2018
"18-Sep",충남,청양군,239,16182,940,17361,"2018-09-01",2018
"18-Sep",충남,태안군,270,32509,504,33283,"2018-09-01",2018
"18-Sep",충남,홍성군,399,49936,1429,51764,"2018-09-01",2018
"18-Sep",전북,계,4837,866255,40436,911528,"2018-09-01",2018
"18-Sep",전북,고창군,251,29467,556,30274,"2018-09-01",2018
"18-Sep",전북,군산시,496,125231,6791,132518,"2018-09-01",2018
"18-Sep",전북,김제시,281,43729,1925,45935,"2018-09-01",2018
"18-Sep",전북,남원시,402,39178,4225,43805,"2018-09-01",2018
"18-Sep",전북,무주군,183,12217,375,12775,"2018-09-01",2018
"18-Sep",전북,부안군,251,26917,601,27769,"2018-09-01",2018
"18-Sep",전북,순창군,202,14036,194,14432,"2018-09-01",2018
"18-Sep",전북,완주군,327,49648,3347,53322,"2018-09-01",2018
"18-Sep",전북,익산시,482,134165,6290,140937,"2018-09-01",2018
"18-Sep",전북,임실군,196,13932,419,14547,"2018-09-01",2018
"18-Sep",전북,장수군,224,11580,169,11973,"2018-09-01",2018
"18-Sep",전북,전주시 덕진구,414,154956,7538,162908,"2018-09-01",2018
"18-Sep",전북,전주시 완산구,587,145594,4018,150199,"2018-09-01",2018
"18-Sep",전북,정읍시,307,52158,3784,56249,"2018-09-01",2018
"18-Sep",전북,진안군,234,13447,204,13885,"2018-09-01",2018
"18-Sep",전남,계,5920,889608,127290,1022818,"2018-09-01",2018
"18-Sep",전남,강진군,208,17857,1056,19121,"2018-09-01",2018
"18-Sep",전남,고흥군,296,29924,660,30880,"2018-09-01",2018
"18-Sep",전남,곡성군,136,14224,804,15164,"2018-09-01",2018
"18-Sep",전남,광양시,241,76802,5941,82984,"2018-09-01",2018
"18-Sep",전남,구례군,125,12784,655,13564,"2018-09-01",2018
"18-Sep",전남,나주시,442,58379,3099,61920,"2018-09-01",2018
"18-Sep",전남,담양군,206,25229,1513,26948,"2018-09-01",2018
"18-Sep",전남,목포시,440,93210,6117,99767,"2018-09-01",2018
"18-Sep",전남,무안군,526,40512,970,42008,"2018-09-01",2018
"18-Sep",전남,보성군,199,20790,68810,89799,"2018-09-01",2018
"18-Sep",전남,순천시,468,129618,5095,135181,"2018-09-01",2018
"18-Sep",전남,신안군,214,20021,852,21087,"2018-09-01",2018
"18-Sep",전남,여수시,533,123352,6901,130786,"2018-09-01",2018
"18-Sep",전남,영광군,228,26055,729,27012,"2018-09-01",2018
"18-Sep",전남,영암군,246,31234,15973,47453,"2018-09-01",2018
"18-Sep",전남,완도군,220,23931,488,24639,"2018-09-01",2018
"18-Sep",전남,장성군,150,25064,1003,26217,"2018-09-01",2018
"18-Sep",전남,장흥군,196,19225,439,19860,"2018-09-01",2018
"18-Sep",전남,진도군,147,15825,305,16277,"2018-09-01",2018
"18-Sep",전남,함평군,166,17294,3272,20732,"2018-09-01",2018
"18-Sep",전남,해남군,323,37400,588,38311,"2018-09-01",2018
"18-Sep",전남,화순군,210,30878,2020,33108,"2018-09-01",2018
"18-Sep",경북,계,7070,1359999,48697,1415766,"2018-09-01",2018
"18-Sep",경북,경산시,316,130335,4300,134951,"2018-09-01",2018
"18-Sep",경북,경주시,555,135008,4826,140389,"2018-09-01",2018
"18-Sep",경북,고령군,153,20113,522,20788,"2018-09-01",2018
"18-Sep",경북,구미시,497,203828,7304,211629,"2018-09-01",2018
"18-Sep",경북,군위군,112,14171,277,14560,"2018-09-01",2018
"18-Sep",경북,김천시,361,70137,1845,72343,"2018-09-01",2018
"18-Sep",경북,문경시,296,34415,799,35510,"2018-09-01",2018
"18-Sep",경북,봉화군,195,17040,205,17440,"2018-09-01",2018
"18-Sep",경북,상주시,366,50719,1861,52946,"2018-09-01",2018
"18-Sep",경북,성주군,188,29054,1445,30687,"2018-09-01",2018
"18-Sep",경북,안동시,671,78877,2603,82151,"2018-09-01",2018
"18-Sep",경북,영덕군,247,18376,307,18930,"2018-09-01",2018
"18-Sep",경북,영양군,142,9136,96,9374,"2018-09-01",2018
"18-Sep",경북,영주시,338,53977,1517,55832,"2018-09-01",2018
"18-Sep",경북,영천시,279,56077,2661,59017,"2018-09-01",2018
"18-Sep",경북,예천군,209,26547,461,27217,"2018-09-01",2018
"18-Sep",경북,울릉군,146,5101,409,5656,"2018-09-01",2018
"18-Sep",경북,울진군,281,24956,365,25602,"2018-09-01",2018
"18-Sep",경북,의성군,294,28875,1026,30195,"2018-09-01",2018
"18-Sep",경북,청도군,192,23721,642,24555,"2018-09-01",2018
"18-Sep",경북,청송군,193,14661,195,15049,"2018-09-01",2018
"18-Sep",경북,칠곡군,319,67057,2271,69647,"2018-09-01",2018
"18-Sep",경북,포항시 남구,391,118192,8810,127393,"2018-09-01",2018
"18-Sep",경북,포항시 북구,329,129626,3950,133905,"2018-09-01",2018
"18-Sep",경남,계,6842,1599867,82548,1689257,"2018-09-01",2018
"18-Sep",경남,거제시,342,102546,2242,105130,"2018-09-01",2018
"18-Sep",경남,거창군,247,30463,805,31515,"2018-09-01",2018
"18-Sep",경남,고성군,207,25883,658,26748,"2018-09-01",2018
"18-Sep",경남,김해시,638,255391,6930,262959,"2018-09-01",2018
"18-Sep",경남,남해군,245,18753,493,19491,"2018-09-01",2018
"18-Sep",경남,밀양시,306,53332,4046,57684,"2018-09-01",2018
"18-Sep",경남,사천시,310,53961,1510,55781,"2018-09-01",2018
"18-Sep",경남,산청군,219,19140,755,20114,"2018-09-01",2018
"18-Sep",경남,양산시,391,154525,9577,164493,"2018-09-01",2018
"18-Sep",경남,의령군,189,13670,675,14534,"2018-09-01",2018
"18-Sep",경남,진주시,611,155535,6617,162763,"2018-09-01",2018
"18-Sep",경남,창녕군,231,34218,953,35402,"2018-09-01",2018
"18-Sep",경남,창원시 마산합포구,332,98700,3024,102056,"2018-09-01",2018
"18-Sep",경남,창원시 마산회원구,169,94402,5273,99844,"2018-09-01",2018
"18-Sep",경남,창원시 성산구,143,120897,16622,137662,"2018-09-01",2018
"18-Sep",경남,창원시 의창구,881,126460,6474,133815,"2018-09-01",2018
"18-Sep",경남,창원시 진해구,197,85605,1649,87451,"2018-09-01",2018
"18-Sep",경남,통영시,318,51732,1507,53557,"2018-09-01",2018
"18-Sep",경남,하동군,220,23708,456,24384,"2018-09-01",2018
"18-Sep",경남,함안군,198,40082,11239,51519,"2018-09-01",2018
"18-Sep",경남,함양군,201,18558,401,19160,"2018-09-01",2018
"18-Sep",경남,합천군,247,22306,642,23195,"2018-09-01",2018
"18-Sep",제주,계,2255,367467,171970,541692,"2018-09-01",2018
"18-Sep",제주,서귀포시,740,100037,2056,102833,"2018-09-01",2018
"18-Sep",제주,제주시,1515,267430,169914,438859,"2018-09-01",2018
"18-Oct",서울,강남구,377,215294,19545,235216,"2018-10-01",2018
"18-Oct",서울,강동구,262,127154,8633,136049,"2018-10-01",2018
"18-Oct",서울,강북구,298,72486,4711,77495,"2018-10-01",2018
"18-Oct",서울,강서구,329,186018,17128,203475,"2018-10-01",2018
"18-Oct",서울,관악구,299,116125,5536,121960,"2018-10-01",2018
"18-Oct",서울,광진구,279,93748,6002,100029,"2018-10-01",2018
"18-Oct",서울,구로구,282,129804,14744,144830,"2018-10-01",2018
"18-Oct",서울,금천구,120,80451,5977,86548,"2018-10-01",2018
"18-Oct",서울,노원구,296,144427,9211,153934,"2018-10-01",2018
"18-Oct",서울,도봉구,258,89634,7552,97444,"2018-10-01",2018
"18-Oct",서울,동대문구,314,92874,5304,98492,"2018-10-01",2018
"18-Oct",서울,동작구,304,102062,2812,105178,"2018-10-01",2018
"18-Oct",서울,마포구,332,110475,6959,117766,"2018-10-01",2018
"18-Oct",서울,서대문구,442,80386,5578,86406,"2018-10-01",2018
"18-Oct",서울,서초구,597,168685,12945,182227,"2018-10-01",2018
"18-Oct",서울,성동구,315,95553,9414,105282,"2018-10-01",2018
"18-Oct",서울,성북구,285,110741,5525,116551,"2018-10-01",2018
"18-Oct",서울,송파구,384,222316,13314,236014,"2018-10-01",2018
"18-Oct",서울,양천구,327,141815,8605,150747,"2018-10-01",2018
"18-Oct",서울,영등포구,363,134384,9505,144252,"2018-10-01",2018
"18-Oct",서울,용산구,383,74864,2209,77456,"2018-10-01",2018
"18-Oct",서울,은평구,265,122247,7146,129658,"2018-10-01",2018
"18-Oct",서울,종로구,3855,45238,1654,50747,"2018-10-01",2018
"18-Oct",서울,중구,1076,46136,4825,52037,"2018-10-01",2018
"18-Oct",서울,중랑구,217,104147,9739,114103,"2018-10-01",2018
"18-Oct",서울,계,12259,2907064,204573,3123896,"2018-10-01",2018
"18-Oct",부산,강서구,323,67098,3826,71247,"2018-10-01",2018
"18-Oct",부산,금정구,285,81585,7371,89241,"2018-10-01",2018
"18-Oct",부산,기장군,250,70374,2213,72837,"2018-10-01",2018
"18-Oct",부산,남구,229,91470,8702,100401,"2018-10-01",2018
"18-Oct",부산,동구,229,45018,4711,49958,"2018-10-01",2018
"18-Oct",부산,동래구,175,88239,4243,92657,"2018-10-01",2018
"18-Oct",부산,부산진구,365,120353,11028,131746,"2018-10-01",2018
"18-Oct",부산,북구,240,100799,3343,104382,"2018-10-01",2018
"18-Oct",부산,사상구,286,84846,6004,91136,"2018-10-01",2018
"18-Oct",부산,사하구,266,108943,7053,116262,"2018-10-01",2018
"18-Oct",부산,서구,136,28345,1369,29850,"2018-10-01",2018
"18-Oct",부산,수영구,163,63583,20020,83766,"2018-10-01",2018
"18-Oct",부산,연제구,837,80409,7211,88457,"2018-10-01",2018
"18-Oct",부산,영도구,229,31620,2111,33960,"2018-10-01",2018
"18-Oct",부산,중구,311,22445,7034,29790,"2018-10-01",2018
"18-Oct",부산,해운대구,298,167505,10211,178014,"2018-10-01",2018
"18-Oct",부산,계,4622,1252632,106450,1363704,"2018-10-01",2018
"18-Oct",대구,남구,346,56324,1870,58540,"2018-10-01",2018
"18-Oct",대구,달서구,468,260567,12132,273167,"2018-10-01",2018
"18-Oct",대구,달성군,486,123066,4686,128238,"2018-10-01",2018
"18-Oct",대구,동구,344,150781,10152,161277,"2018-10-01",2018
"18-Oct",대구,북구,495,193693,7949,202137,"2018-10-01",2018
"18-Oct",대구,서구,236,73305,4260,77801,"2018-10-01",2018
"18-Oct",대구,수성구,555,209309,5371,215235,"2018-10-01",2018
"18-Oct",대구,중구,291,55712,1880,57883,"2018-10-01",2018
"18-Oct",대구,계,3221,1122757,48300,1174278,"2018-10-01",2018
"18-Oct",인천,강화군,317,32501,1314,34132,"2018-10-01",2018
"18-Oct",인천,계양구,281,121383,161268,282932,"2018-10-01",2018
"18-Oct",인천,남동구,852,248877,42398,292127,"2018-10-01",2018
"18-Oct",인천,동구,89,26385,2658,29132,"2018-10-01",2018
"18-Oct",인천,미추홀구,405,151621,54548,206574,"2018-10-01",2018
"18-Oct",인천,부평구,339,215491,9232,225062,"2018-10-01",2018
"18-Oct",인천,서구,378,226495,10838,237711,"2018-10-01",2018
"18-Oct",인천,연수구,348,163624,7438,171410,"2018-10-01",2018
"18-Oct",인천,옹진군,189,11686,205,12080,"2018-10-01",2018
"18-Oct",인천,중구,638,55441,17369,73448,"2018-10-01",2018
"18-Oct",인천,계,3836,1253504,307268,1564608,"2018-10-01",2018
"18-Oct",광주,광산구,507,181348,11520,193375,"2018-10-01",2018
"18-Oct",광주,남구,176,85675,2628,88479,"2018-10-01",2018
"18-Oct",광주,동구,233,36158,1074,37465,"2018-10-01",2018
"18-Oct",광주,북구,487,183192,10299,193978,"2018-10-01",2018
"18-Oct",광주,서구,709,141157,7215,149081,"2018-10-01",2018
"18-Oct",광주,계,2112,627530,32736,662378,"2018-10-01",2018
"18-Oct",대전,대덕구,214,85216,6794,92224,"2018-10-01",2018
"18-Oct",대전,동구,243,87714,4166,92123,"2018-10-01",2018
"18-Oct",대전,서구,804,201615,7453,209872,"2018-10-01",2018
"18-Oct",대전,유성구,375,166282,4979,171636,"2018-10-01",2018
"18-Oct",대전,중구,235,96611,5944,102790,"2018-10-01",2018
"18-Oct",대전,계,1871,637438,29336,668645,"2018-10-01",2018
"18-Oct",울산,남구,685,151811,7273,159769,"2018-10-01",2018
"18-Oct",울산,동구,196,62348,946,63490,"2018-10-01",2018
"18-Oct",울산,북구,168,101127,3912,105207,"2018-10-01",2018
"18-Oct",울산,울주군,338,116631,6336,123305,"2018-10-01",2018
"18-Oct",울산,중구,331,102511,2727,105569,"2018-10-01",2018
"18-Oct",울산,계,1718,534428,21194,557340,"2018-10-01",2018
"18-Oct",세종,세종특별자치시,705,142776,2598,146079,"2018-10-01",2018
"18-Oct",세종,계,705,142776,2598,146079,"2018-10-01",2018
"18-Oct",경기,가평군,359,29311,684,30354,"2018-10-01",2018
"18-Oct",경기,고양시 덕양구,650,161120,3886,165656,"2018-10-01",2018
"18-Oct",경기,고양시 일산동구,289,118478,7373,126140,"2018-10-01",2018
"18-Oct",경기,고양시 일산서구,128,108423,3915,112466,"2018-10-01",2018
"18-Oct",경기,과천시,692,20221,601,21514,"2018-10-01",2018
"18-Oct",경기,광명시,303,104186,4067,108556,"2018-10-01",2018
"18-Oct",경기,광주시,370,174738,7894,183002,"2018-10-01",2018
"18-Oct",경기,구리시,245,69719,2612,72576,"2018-10-01",2018
"18-Oct",경기,군포시,291,95195,5086,100572,"2018-10-01",2018
"18-Oct",경기,김포시,453,190115,6880,197448,"2018-10-01",2018
"18-Oct",경기,남양주시,650,269529,7394,277573,"2018-10-01",2018
"18-Oct",경기,동두천시,216,36805,1318,38339,"2018-10-01",2018
"18-Oct",경기,부천시,714,293490,12621,306825,"2018-10-01",2018
"18-Oct",경기,성남시 분당구,338,184022,6790,191150,"2018-10-01",2018
"18-Oct",경기,성남시 수정구,337,70316,2432,73085,"2018-10-01",2018
"18-Oct",경기,성남시 중원구,336,71485,4135,75956,"2018-10-01",2018
"18-Oct",경기,수원시 권선구,360,173142,7807,181309,"2018-10-01",2018
"18-Oct",경기,수원시 영통구,224,134703,3216,138143,"2018-10-01",2018
"18-Oct",경기,수원시 장안구,586,104216,3955,108757,"2018-10-01",2018
"18-Oct",경기,수원시 팔달구,484,69241,3132,72857,"2018-10-01",2018
"18-Oct",경기,시흥시,457,209114,7527,217098,"2018-10-01",2018
"18-Oct",경기,안산시 단원구,544,145788,8399,154731,"2018-10-01",2018
"18-Oct",경기,안산시 상록구,173,136730,4764,141667,"2018-10-01",2018
"18-Oct",경기,안성시,376,94546,4943,99865,"2018-10-01",2018
"18-Oct",경기,안양시 동안구,389,116412,6425,123226,"2018-10-01",2018
"18-Oct",경기,안양시 만안구,153,84354,3824,88331,"2018-10-01",2018
"18-Oct",경기,양주시,379,95452,3097,98928,"2018-10-01",2018
"18-Oct",경기,양평군,535,56244,1758,58537,"2018-10-01",2018
"18-Oct",경기,여주시,415,59651,7218,67284,"2018-10-01",2018
"18-Oct",경기,연천군,298,22959,5420,28677,"2018-10-01",2018
"18-Oct",경기,오산시,236,95204,3216,98656,"2018-10-01",2018
"18-Oct",경기,용인시 기흥구,117,176417,8774,185308,"2018-10-01",2018
"18-Oct",경기,용인시 수지구,45,132834,2115,134994,"2018-10-01",2018
"18-Oct",경기,용인시 처인구,686,119549,6894,127129,"2018-10-01",2018
"18-Oct",경기,의왕시,282,57124,3140,60546,"2018-10-01",2018
"18-Oct",경기,의정부시,578,148440,4887,153905,"2018-10-01",2018
"18-Oct",경기,이천시,406,104729,5764,110899,"2018-10-01",2018
"18-Oct",경기,파주시,479,196198,9684,206361,"2018-10-01",2018
"18-Oct",경기,평택시,684,244219,11614,256517,"2018-10-01",2018
"18-Oct",경기,포천시,353,81675,10238,92266,"2018-10-01",2018
"18-Oct",경기,하남시,359,98957,2397,101713,"2018-10-01",2018
"18-Oct",경기,화성시,785,373696,11742,386223,"2018-10-01",2018
"18-Oct",경기,계,16754,5328747,229638,5575139,"2018-10-01",2018
"18-Oct",강원,강릉시,511,102070,4583,107164,"2018-10-01",2018
"18-Oct",강원,고성군,183,13593,238,14014,"2018-10-01",2018
"18-Oct",강원,동해시,292,42670,1355,44317,"2018-10-01",2018
"18-Oct",강원,삼척시,371,31058,690,32119,"2018-10-01",2018
"18-Oct",강원,속초시,283,35555,1374,37212,"2018-10-01",2018
"18-Oct",강원,양구군,143,11602,120,11865,"2018-10-01",2018
"18-Oct",강원,양양군,173,14468,216,14857,"2018-10-01",2018
"18-Oct",강원,영월군,322,20172,363,20857,"2018-10-01",2018
"18-Oct",강원,원주시,542,158954,5891,165387,"2018-10-01",2018
"18-Oct",강원,인제군,204,17254,232,17690,"2018-10-01",2018
"18-Oct",강원,정선군,313,19913,451,20677,"2018-10-01",2018
"18-Oct",강원,철원군,218,23268,303,23789,"2018-10-01",2018
"18-Oct",강원,춘천시,760,124640,5771,131171,"2018-10-01",2018
"18-Oct",강원,태백시,215,20066,801,21082,"2018-10-01",2018
"18-Oct",강원,평창군,287,24777,477,25541,"2018-10-01",2018
"18-Oct",강원,홍천군,387,36955,1098,38440,"2018-10-01",2018
"18-Oct",강원,화천군,196,12258,196,12650,"2018-10-01",2018
"18-Oct",강원,횡성군,230,24850,680,25760,"2018-10-01",2018
"18-Oct",강원,계,5630,734123,24839,764592,"2018-10-01",2018
"18-Oct",충북,괴산군,198,21218,364,21780,"2018-10-01",2018
"18-Oct",충북,단양군,203,15424,810,16437,"2018-10-01",2018
"18-Oct",충북,보은군,203,17281,987,18471,"2018-10-01",2018
"18-Oct",충북,영동군,238,24330,380,24948,"2018-10-01",2018
"18-Oct",충북,옥천군,195,25631,1093,26919,"2018-10-01",2018
"18-Oct",충북,음성군,224,56025,1742,57991,"2018-10-01",2018
"18-Oct",충북,제천시,316,64600,3476,68392,"2018-10-01",2018
"18-Oct",충북,증평군,94,18232,749,19075,"2018-10-01",2018
"18-Oct",충북,진천군,208,43432,1251,44891,"2018-10-01",2018
"18-Oct",충북,청원군,1,21,0,22,"2018-10-01",2018
"18-Oct",충북,청주시 상당구,496,77694,2351,80541,"2018-10-01",2018
"18-Oct",충북,청주시 서원구,236,91563,5253,97052,"2018-10-01",2018
"18-Oct",충북,청주시 청원구,345,98647,4045,103037,"2018-10-01",2018
"18-Oct",충북,청주시 흥덕구,361,115973,6920,123254,"2018-10-01",2018
"18-Oct",충북,충주시,560,103068,3838,107466,"2018-10-01",2018
"18-Oct",충북,계,3878,773139,33259,810276,"2018-10-01",2018
"18-Oct",충남,계룡시,142,20908,571,21621,"2018-10-01",2018
"18-Oct",충남,공주시,519,51840,2070,54429,"2018-10-01",2018
"18-Oct",충남,금산군,184,27576,1985,29745,"2018-10-01",2018
"18-Oct",충남,논산시,362,58840,2244,61446,"2018-10-01",2018
"18-Oct",충남,당진시,368,89848,3799,94015,"2018-10-01",2018
"18-Oct",충남,보령시,389,50072,1286,51747,"2018-10-01",2018
"18-Oct",충남,부여군,268,33323,1333,34924,"2018-10-01",2018
"18-Oct",충남,서산시,385,87985,3495,91865,"2018-10-01",2018
"18-Oct",충남,서천군,228,26520,897,27645,"2018-10-01",2018
"18-Oct",충남,아산시,440,154801,6387,161628,"2018-10-01",2018
"18-Oct",충남,예산군,362,41439,1418,43219,"2018-10-01",2018
"18-Oct",충남,천안시 동남구,260,123721,4705,128686,"2018-10-01",2018
"18-Oct",충남,천안시 서북구,541,178933,5936,185410,"2018-10-01",2018
"18-Oct",충남,청양군,240,16182,897,17319,"2018-10-01",2018
"18-Oct",충남,태안군,271,32516,504,33291,"2018-10-01",2018
"18-Oct",충남,홍성군,402,50093,1420,51915,"2018-10-01",2018
"18-Oct",충남,계,5361,1044597,38947,1088905,"2018-10-01",2018
"18-Oct",전북,고창군,257,29525,563,30345,"2018-10-01",2018
"18-Oct",전북,군산시,507,125366,6763,132636,"2018-10-01",2018
"18-Oct",전북,김제시,282,43738,1928,45948,"2018-10-01",2018
"18-Oct",전북,남원시,416,39169,4196,43781,"2018-10-01",2018
"18-Oct",전북,무주군,182,12250,369,12801,"2018-10-01",2018
"18-Oct",전북,부안군,260,26935,608,27803,"2018-10-01",2018
"18-Oct",전북,순창군,204,14090,191,14485,"2018-10-01",2018
"18-Oct",전북,완주군,336,49716,3338,53390,"2018-10-01",2018
"18-Oct",전북,익산시,487,134243,6313,141043,"2018-10-01",2018
"18-Oct",전북,임실군,196,13939,421,14556,"2018-10-01",2018
"18-Oct",전북,장수군,224,11603,169,11996,"2018-10-01",2018
"18-Oct",전북,전주시 덕진구,423,155355,7529,163307,"2018-10-01",2018
"18-Oct",전북,전주시 완산구,587,145808,4021,150416,"2018-10-01",2018
"18-Oct",전북,정읍시,315,52260,3799,56374,"2018-10-01",2018
"18-Oct",전북,진안군,233,13472,198,13903,"2018-10-01",2018
"18-Oct",전북,계,4909,867469,40406,912784,"2018-10-01",2018
"18-Oct",전남,강진군,210,17809,1063,19082,"2018-10-01",2018
"18-Oct",전남,고흥군,301,29944,655,30900,"2018-10-01",2018
"18-Oct",전남,곡성군,138,14233,798,15169,"2018-10-01",2018
"18-Oct",전남,광양시,245,76977,5945,83167,"2018-10-01",2018
"18-Oct",전남,구례군,129,12822,635,13586,"2018-10-01",2018
"18-Oct",전남,나주시,443,58730,3109,62282,"2018-10-01",2018
"18-Oct",전남,담양군,209,25232,1519,26960,"2018-10-01",2018
"18-Oct",전남,목포시,439,93136,6058,99633,"2018-10-01",2018
"18-Oct",전남,무안군,529,40673,967,42169,"2018-10-01",2018
"18-Oct",전남,보성군,201,20845,67458,88504,"2018-10-01",2018
"18-Oct",전남,순천시,474,130077,5089,135640,"2018-10-01",2018
"18-Oct",전남,신안군,214,20092,850,21156,"2018-10-01",2018
"18-Oct",전남,여수시,533,123527,6885,130945,"2018-10-01",2018
"18-Oct",전남,영광군,229,26076,720,27025,"2018-10-01",2018
"18-Oct",전남,영암군,252,31319,15137,46708,"2018-10-01",2018
"18-Oct",전남,완도군,222,23966,491,24679,"2018-10-01",2018
"18-Oct",전남,장성군,155,25177,998,26330,"2018-10-01",2018
"18-Oct",전남,장흥군,197,19302,439,19938,"2018-10-01",2018
"18-Oct",전남,진도군,152,15858,305,16315,"2018-10-01",2018
"18-Oct",전남,함평군,169,17349,5167,22685,"2018-10-01",2018
"18-Oct",전남,해남군,327,37558,583,38468,"2018-10-01",2018
"18-Oct",전남,화순군,214,30920,2021,33155,"2018-10-01",2018
"18-Oct",전남,계,5982,891622,126892,1024496,"2018-10-01",2018
"18-Oct",경북,경산시,320,130817,4313,135450,"2018-10-01",2018
"18-Oct",경북,경주시,563,135290,4789,140642,"2018-10-01",2018
"18-Oct",경북,고령군,157,20144,523,20824,"2018-10-01",2018
"18-Oct",경북,구미시,505,204178,7277,211960,"2018-10-01",2018
"18-Oct",경북,군위군,114,14187,277,14578,"2018-10-01",2018
"18-Oct",경북,김천시,368,70271,1836,72475,"2018-10-01",2018
"18-Oct",경북,문경시,302,34528,800,35630,"2018-10-01",2018
"18-Oct",경북,봉화군,195,17083,205,17483,"2018-10-01",2018
"18-Oct",경북,상주시,374,50868,1868,53110,"2018-10-01",2018
"18-Oct",경북,성주군,198,29111,1449,30758,"2018-10-01",2018
"18-Oct",경북,안동시,679,78905,2598,82182,"2018-10-01",2018
"18-Oct",경북,영덕군,248,18288,307,18843,"2018-10-01",2018
"18-Oct",경북,영양군,143,9171,96,9410,"2018-10-01",2018
"18-Oct",경북,영주시,343,54047,1515,55905,"2018-10-01",2018
"18-Oct",경북,영천시,285,56158,2680,59123,"2018-10-01",2018
"18-Oct",경북,예천군,214,26657,460,27331,"2018-10-01",2018
"18-Oct",경북,울릉군,147,5115,411,5673,"2018-10-01",2018
"18-Oct",경북,울진군,286,25007,363,25656,"2018-10-01",2018
"18-Oct",경북,의성군,300,28902,1026,30228,"2018-10-01",2018
"18-Oct",경북,청도군,191,23746,642,24579,"2018-10-01",2018
"18-Oct",경북,청송군,193,14632,194,15019,"2018-10-01",2018
"18-Oct",경북,칠곡군,322,67105,2268,69695,"2018-10-01",2018
"18-Oct",경북,포항시 남구,402,118203,8810,127415,"2018-10-01",2018
"18-Oct",경북,포항시 북구,332,129621,3916,133869,"2018-10-01",2018
"18-Oct",경북,계,7181,1362034,48623,1417838,"2018-10-01",2018
"18-Oct",경남,거제시,341,102722,2236,105299,"2018-10-01",2018
"18-Oct",경남,거창군,248,30505,808,31561,"2018-10-01",2018
"18-Oct",경남,고성군,213,25910,645,26768,"2018-10-01",2018
"18-Oct",경남,김해시,645,255685,6957,263287,"2018-10-01",2018
"18-Oct",경남,남해군,249,18731,491,19471,"2018-10-01",2018
"18-Oct",경남,밀양시,311,53416,4047,57774,"2018-10-01",2018
"18-Oct",경남,사천시,311,54043,1508,55862,"2018-10-01",2018
"18-Oct",경남,산청군,221,19181,765,20167,"2018-10-01",2018
"18-Oct",경남,양산시,402,154942,9545,164889,"2018-10-01",2018
"18-Oct",경남,의령군,192,13663,672,14527,"2018-10-01",2018
"18-Oct",경남,진주시,612,155862,6631,163105,"2018-10-01",2018
"18-Oct",경남,창녕군,236,34341,954,35531,"2018-10-01",2018
"18-Oct",경남,창원시 마산합포구,336,98482,3018,101836,"2018-10-01",2018
"18-Oct",경남,창원시 마산회원구,174,94342,5278,99794,"2018-10-01",2018
"18-Oct",경남,창원시 성산구,143,120857,16196,137196,"2018-10-01",2018
"18-Oct",경남,창원시 의창구,891,126766,6480,134137,"2018-10-01",2018
"18-Oct",경남,창원시 진해구,206,85862,1644,87712,"2018-10-01",2018
"18-Oct",경남,통영시,316,51782,1514,53612,"2018-10-01",2018
"18-Oct",경남,하동군,222,23707,456,24385,"2018-10-01",2018
"18-Oct",경남,함안군,199,40047,11314,51560,"2018-10-01",2018
"18-Oct",경남,함양군,193,18684,398,19275,"2018-10-01",2018
"18-Oct",경남,합천군,250,22346,635,23231,"2018-10-01",2018
"18-Oct",경남,계,6911,1601876,82192,1690979,"2018-10-01",2018
"18-Oct",제주,서귀포시,748,100260,2058,103066,"2018-10-01",2018
"18-Oct",제주,제주시,1524,267480,173320,442324,"2018-10-01",2018
"18-Oct",제주,계,2272,367740,175378,545390,"2018-10-01",2018
"18-Nov",서울,강남구,375,215072,19692,235139,"2018-11-01",2018
"18-Nov",서울,강동구,266,126744,8560,135570,"2018-11-01",2018
"18-Nov",서울,강북구,301,72392,4739,77432,"2018-11-01",2018
"18-Nov",서울,강서구,325,186313,17295,203933,"2018-11-01",2018
"18-Nov",서울,관악구,303,115814,5545,121662,"2018-11-01",2018
"18-Nov",서울,광진구,281,94159,5999,100439,"2018-11-01",2018
"18-Nov",서울,구로구,281,129599,14733,144613,"2018-11-01",2018
"18-Nov",서울,금천구,122,80887,5922,86931,"2018-11-01",2018
"18-Nov",서울,노원구,299,144218,9218,153735,"2018-11-01",2018
"18-Nov",서울,도봉구,255,89566,7565,97386,"2018-11-01",2018
"18-Nov",서울,동대문구,313,92907,5290,98510,"2018-11-01",2018
"18-Nov",서울,동작구,307,102028,2798,105133,"2018-11-01",2018
"18-Nov",서울,마포구,331,110651,6909,117891,"2018-11-01",2018
"18-Nov",서울,서대문구,444,80556,5587,86587,"2018-11-01",2018
"18-Nov",서울,서초구,583,168360,13040,181983,"2018-11-01",2018
"18-Nov",서울,성동구,317,95887,9608,105812,"2018-11-01",2018
"18-Nov",서울,성북구,285,110693,5510,116488,"2018-11-01",2018
"18-Nov",서울,송파구,386,222334,13482,236202,"2018-11-01",2018
"18-Nov",서울,양천구,325,141640,8660,150625,"2018-11-01",2018
"18-Nov",서울,영등포구,364,133956,9432,143752,"2018-11-01",2018
"18-Nov",서울,용산구,374,74702,2262,77338,"2018-11-01",2018
"18-Nov",서울,은평구,265,122326,7157,129748,"2018-11-01",2018
"18-Nov",서울,종로구,3866,45253,1661,50780,"2018-11-01",2018
"18-Nov",서울,중구,1065,46107,4816,51988,"2018-11-01",2018
"18-Nov",서울,중랑구,214,104111,9700,114025,"2018-11-01",2018
"18-Nov",서울,계,12247,2906275,205180,3123702,"2018-11-01",2018
"18-Nov",부산,강서구,326,67498,3771,71595,"2018-11-01",2018
"18-Nov",부산,금정구,287,81725,7373,89385,"2018-11-01",2018
"18-Nov",부산,기장군,251,70563,2209,73023,"2018-11-01",2018
"18-Nov",부산,남구,234,91669,8683,100586,"2018-11-01",2018
"18-Nov",부산,동구,230,45355,4741,50326,"2018-11-01",2018
"18-Nov",부산,동래구,175,88094,4204,92473,"2018-11-01",2018
"18-Nov",부산,부산진구,370,120176,11431,131977,"2018-11-01",2018
"18-Nov",부산,북구,247,100691,3348,104286,"2018-11-01",2018
"18-Nov",부산,사상구,291,84896,6053,91240,"2018-11-01",2018
"18-Nov",부산,사하구,270,108928,7077,116275,"2018-11-01",2018
"18-Nov",부산,서구,141,28361,1370,29872,"2018-11-01",2018
"18-Nov",부산,수영구,164,65982,20420,86566,"2018-11-01",2018
"18-Nov",부산,연제구,845,81018,7395,89258,"2018-11-01",2018
"18-Nov",부산,영도구,230,31614,2117,33961,"2018-11-01",2018
"18-Nov",부산,중구,309,22671,7091,30071,"2018-11-01",2018
"18-Nov",부산,해운대구,304,167706,10506,178516,"2018-11-01",2018
"18-Nov",부산,계,4674,1256947,107789,1369410,"2018-11-01",2018
"18-Nov",대구,남구,347,56228,1873,58448,"2018-11-01",2018
"18-Nov",대구,달서구,477,261446,12172,274095,"2018-11-01",2018
"18-Nov",대구,달성군,490,123538,4694,128722,"2018-11-01",2018
"18-Nov",대구,동구,350,151303,10109,161762,"2018-11-01",2018
"18-Nov",대구,북구,500,194279,7941,202720,"2018-11-01",2018
"18-Nov",대구,서구,236,73230,4244,77710,"2018-11-01",2018
"18-Nov",대구,수성구,559,209574,5352,215485,"2018-11-01",2018
"18-Nov",대구,중구,287,55796,1862,57945,"2018-11-01",2018
"18-Nov",대구,계,3246,1125394,48247,1176887,"2018-11-01",2018
"18-Nov",인천,강화군,317,32571,1216,34104,"2018-11-01",2018
"18-Nov",인천,계양구,275,121562,163550,285387,"2018-11-01",2018
"18-Nov",인천,남동구,864,250569,42247,293680,"2018-11-01",2018
"18-Nov",인천,동구,88,26439,2666,29193,"2018-11-01",2018
"18-Nov",인천,미추홀구,403,149566,54511,204480,"2018-11-01",2018
"18-Nov",인천,부평구,336,215352,9594,225282,"2018-11-01",2018
"18-Nov",인천,서구,376,227582,10862,238820,"2018-11-01",2018
"18-Nov",인천,연수구,374,164657,7504,172535,"2018-11-01",2018
"18-Nov",인천,옹진군,187,11684,204,12075,"2018-11-01",2018
"18-Nov",인천,중구,699,55871,17476,74046,"2018-11-01",2018
"18-Nov",인천,계,3919,1255853,309830,1569602,"2018-11-01",2018
"18-Nov",광주,광산구,515,182056,11692,194263,"2018-11-01",2018
"18-Nov",광주,남구,177,85664,2634,88475,"2018-11-01",2018
"18-Nov",광주,동구,248,36235,1089,37572,"2018-11-01",2018
"18-Nov",광주,북구,489,183341,10258,194088,"2018-11-01",2018
"18-Nov",광주,서구,709,141490,7202,149401,"2018-11-01",2018
"18-Nov",광주,계,2138,628786,32875,663799,"2018-11-01",2018
"18-Nov",대전,대덕구,216,85363,6782,92361,"2018-11-01",2018
"18-Nov",대전,동구,246,87940,4188,92374,"2018-11-01",2018
"18-Nov",대전,서구,793,201836,7433,210062,"2018-11-01",2018
"18-Nov",대전,유성구,375,166800,4996,172171,"2018-11-01",2018
"18-Nov",대전,중구,237,96510,5953,102700,"2018-11-01",2018
"18-Nov",대전,계,1867,638449,29352,669668,"2018-11-01",2018
"18-Nov",울산,남구,698,152017,7283,159998,"2018-11-01",2018
"18-Nov",울산,동구,197,62399,951,63547,"2018-11-01",2018
"18-Nov",울산,북구,174,101479,3896,105549,"2018-11-01",2018
"18-Nov",울산,울주군,350,116740,6402,123492,"2018-11-01",2018
"18-Nov",울산,중구,343,102398,2707,105448,"2018-11-01",2018
"18-Nov",울산,계,1762,535033,21239,558034,"2018-11-01",2018
"18-Nov",세종,세종특별자치시,676,143722,2660,147058,"2018-11-01",2018
"18-Nov",세종,계,676,143722,2660,147058,"2018-11-01",2018
"18-Nov",경기,가평군,363,29370,688,30421,"2018-11-01",2018
"18-Nov",경기,고양시 덕양구,662,161397,3882,165941,"2018-11-01",2018
"18-Nov",경기,고양시 일산동구,285,118742,7311,126338,"2018-11-01",2018
"18-Nov",경기,고양시 일산서구,128,109220,3937,113285,"2018-11-01",2018
"18-Nov",경기,과천시,690,20318,602,21610,"2018-11-01",2018
"18-Nov",경기,광명시,301,104224,4099,108624,"2018-11-01",2018
"18-Nov",경기,광주시,376,175680,7991,184047,"2018-11-01",2018
"18-Nov",경기,구리시,245,70042,2607,72894,"2018-11-01",2018
"18-Nov",경기,군포시,294,95330,5112,100736,"2018-11-01",2018
"18-Nov",경기,김포시,456,191912,7109,199477,"2018-11-01",2018
"18-Nov",경기,남양주시,653,270506,7404,278563,"2018-11-01",2018
"18-Nov",경기,동두천시,215,36825,1330,38370,"2018-11-01",2018
"18-Nov",경기,부천시,723,294323,12749,307795,"2018-11-01",2018
"18-Nov",경기,성남시 분당구,349,184001,6828,191178,"2018-11-01",2018
"18-Nov",경기,성남시 수정구,346,70450,2445,73241,"2018-11-01",2018
"18-Nov",경기,성남시 중원구,323,71467,4167,75957,"2018-11-01",2018
"18-Nov",경기,수원시 권선구,370,174817,7877,183064,"2018-11-01",2018
"18-Nov",경기,수원시 영통구,226,135492,3126,138844,"2018-11-01",2018
"18-Nov",경기,수원시 장안구,589,104181,3961,108731,"2018-11-01",2018
"18-Nov",경기,수원시 팔달구,486,69099,3125,72710,"2018-11-01",2018
"18-Nov",경기,시흥시,462,210853,7567,218882,"2018-11-01",2018
"18-Nov",경기,안산시 단원구,548,146590,8301,155439,"2018-11-01",2018
"18-Nov",경기,안산시 상록구,177,136751,4864,141792,"2018-11-01",2018
"18-Nov",경기,안성시,375,94991,4890,100256,"2018-11-01",2018
"18-Nov",경기,안양시 동안구,391,116258,6444,123093,"2018-11-01",2018
"18-Nov",경기,안양시 만안구,156,84502,3827,88485,"2018-11-01",2018
"18-Nov",경기,양주시,379,95727,3118,99224,"2018-11-01",2018
"18-Nov",경기,양평군,535,56438,1765,58738,"2018-11-01",2018
"18-Nov",경기,여주시,409,59764,7154,67327,"2018-11-01",2018
"18-Nov",경기,연천군,303,23029,5410,28742,"2018-11-01",2018
"18-Nov",경기,오산시,255,95979,3203,99437,"2018-11-01",2018
"18-Nov",경기,용인시 기흥구,118,177586,8652,186356,"2018-11-01",2018
"18-Nov",경기,용인시 수지구,45,133252,2193,135490,"2018-11-01",2018
"18-Nov",경기,용인시 처인구,686,120316,7040,128042,"2018-11-01",2018
"18-Nov",경기,의왕시,287,57191,3154,60632,"2018-11-01",2018
"18-Nov",경기,의정부시,589,149029,4888,154506,"2018-11-01",2018
"18-Nov",경기,이천시,411,105154,5724,111289,"2018-11-01",2018
"18-Nov",경기,파주시,484,197256,9678,207418,"2018-11-01",2018
"18-Nov",경기,평택시,681,245784,11608,258073,"2018-11-01",2018
"18-Nov",경기,포천시,354,81859,10045,92258,"2018-11-01",2018
"18-Nov",경기,하남시,361,100399,2434,103194,"2018-11-01",2018
"18-Nov",경기,화성시,781,377131,11741,389653,"2018-11-01",2018
"18-Nov",경기,계,16867,5353235,230050,5600152,"2018-11-01",2018
"18-Nov",강원,강릉시,516,102499,4596,107611,"2018-11-01",2018
"18-Nov",강원,고성군,182,13621,226,14029,"2018-11-01",2018
"18-Nov",강원,동해시,298,42709,1352,44359,"2018-11-01",2018
"18-Nov",강원,삼척시,374,31160,690,32224,"2018-11-01",2018
"18-Nov",강원,속초시,285,35611,1379,37275,"2018-11-01",2018
"18-Nov",강원,양구군,147,11679,121,11947,"2018-11-01",2018
"18-Nov",강원,양양군,176,14526,223,14925,"2018-11-01",2018
"18-Nov",강원,영월군,325,20199,363,20887,"2018-11-01",2018
"18-Nov",강원,원주시,554,159449,5879,165882,"2018-11-01",2018
"18-Nov",강원,인제군,210,17262,235,17707,"2018-11-01",2018
"18-Nov",강원,정선군,311,19893,453,20657,"2018-11-01",2018
"18-Nov",강원,철원군,220,23294,305,23819,"2018-11-01",2018
"18-Nov",강원,춘천시,775,124927,5780,131482,"2018-11-01",2018
"18-Nov",강원,태백시,218,20092,802,21112,"2018-11-01",2018
"18-Nov",강원,평창군,291,24822,465,25578,"2018-11-01",2018
"18-Nov",강원,홍천군,401,36925,1102,38428,"2018-11-01",2018
"18-Nov",강원,화천군,198,12288,198,12684,"2018-11-01",2018
"18-Nov",강원,횡성군,231,24872,680,25783,"2018-11-01",2018
"18-Nov",강원,계,5712,735828,24849,766389,"2018-11-01",2018
"18-Nov",충북,괴산군,197,21452,365,22014,"2018-11-01",2018
"18-Nov",충북,단양군,206,15435,816,16457,"2018-11-01",2018
"18-Nov",충북,보은군,202,17309,963,18474,"2018-11-01",2018
"18-Nov",충북,영동군,236,24349,380,24965,"2018-11-01",2018
"18-Nov",충북,옥천군,200,25674,1095,26969,"2018-11-01",2018
"18-Nov",충북,음성군,223,56055,1769,58047,"2018-11-01",2018
"18-Nov",충북,제천시,313,64685,3473,68471,"2018-11-01",2018
"18-Nov",충북,증평군,93,18209,751,19053,"2018-11-01",2018
"18-Nov",충북,진천군,210,43776,1243,45229,"2018-11-01",2018
"18-Nov",충북,청원군,1,20,0,21,"2018-11-01",2018
"18-Nov",충북,청주시 상당구,506,78795,2355,81656,"2018-11-01",2018
"18-Nov",충북,청주시 서원구,238,91118,5217,96573,"2018-11-01",2018
"18-Nov",충북,청주시 청원구,350,99072,4078,103500,"2018-11-01",2018
"18-Nov",충북,청주시 흥덕구,367,116067,6965,123399,"2018-11-01",2018
"18-Nov",충북,충주시,567,103217,3839,107623,"2018-11-01",2018
"18-Nov",충북,계,3909,775233,33309,812451,"2018-11-01",2018
"18-Nov",충남,계룡시,143,20901,535,21579,"2018-11-01",2018
"18-Nov",충남,공주시,530,52106,2237,54873,"2018-11-01",2018
"18-Nov",충남,금산군,184,27593,2004,29781,"2018-11-01",2018
"18-Nov",충남,논산시,367,58959,2255,61581,"2018-11-01",2018
"18-Nov",충남,당진시,370,89938,3796,94104,"2018-11-01",2018
"18-Nov",충남,보령시,390,50020,1293,51703,"2018-11-01",2018
"18-Nov",충남,부여군,271,33367,1318,34956,"2018-11-01",2018
"18-Nov",충남,서산시,388,88391,3509,92288,"2018-11-01",2018
"18-Nov",충남,서천군,230,26488,883,27601,"2018-11-01",2018
"18-Nov",충남,아산시,448,155258,6395,162101,"2018-11-01",2018
"18-Nov",충남,예산군,367,41476,1422,43265,"2018-11-01",2018
"18-Nov",충남,천안시 동남구,269,124213,4716,129198,"2018-11-01",2018
"18-Nov",충남,천안시 서북구,548,179559,5880,185987,"2018-11-01",2018
"18-Nov",충남,청양군,242,16319,889,17450,"2018-11-01",2018
"18-Nov",충남,태안군,273,32555,483,33311,"2018-11-01",2018
"18-Nov",충남,홍성군,408,50205,1424,52037,"2018-11-01",2018
"18-Nov",충남,계,5428,1047403,39040,1091871,"2018-11-01",2018
"18-Nov",전북,고창군,258,29536,568,30362,"2018-11-01",2018
"18-Nov",전북,군산시,511,125543,6721,132775,"2018-11-01",2018
"18-Nov",전북,김제시,291,43844,1948,46083,"2018-11-01",2018
"18-Nov",전북,남원시,420,39238,4181,43839,"2018-11-01",2018
"18-Nov",전북,무주군,181,12247,368,12796,"2018-11-01",2018
"18-Nov",전북,부안군,258,26857,606,27721,"2018-11-01",2018
"18-Nov",전북,순창군,205,14092,188,14485,"2018-11-01",2018
"18-Nov",전북,완주군,338,49794,3336,53468,"2018-11-01",2018
"18-Nov",전북,익산시,487,134419,6311,141217,"2018-11-01",2018
"18-Nov",전북,임실군,198,13971,422,14591,"2018-11-01",2018
"18-Nov",전북,장수군,224,11574,172,11970,"2018-11-01",2018
"18-Nov",전북,전주시 덕진구,422,156463,7512,164397,"2018-11-01",2018
"18-Nov",전북,전주시 완산구,593,145918,4055,150566,"2018-11-01",2018
"18-Nov",전북,정읍시,326,52353,3821,56500,"2018-11-01",2018
"18-Nov",전북,진안군,243,13480,197,13920,"2018-11-01",2018
"18-Nov",전북,계,4955,869329,40406,914690,"2018-11-01",2018
"18-Nov",전남,강진군,213,17901,1066,19180,"2018-11-01",2018
"18-Nov",전남,고흥군,299,29986,656,30941,"2018-11-01",2018
"18-Nov",전남,곡성군,138,14253,775,15166,"2018-11-01",2018
"18-Nov",전남,광양시,250,77548,5942,83740,"2018-11-01",2018
"18-Nov",전남,구례군,131,12886,627,13644,"2018-11-01",2018
"18-Nov",전남,나주시,448,59155,3118,62721,"2018-11-01",2018
"18-Nov",전남,담양군,223,25367,1522,27112,"2018-11-01",2018
"18-Nov",전남,목포시,448,93376,6050,99874,"2018-11-01",2018
"18-Nov",전남,무안군,538,40832,968,42338,"2018-11-01",2018
"18-Nov",전남,보성군,204,20917,66192,87313,"2018-11-01",2018
"18-Nov",전남,순천시,484,130394,5083,135961,"2018-11-01",2018
"18-Nov",전남,신안군,216,20160,855,21231,"2018-11-01",2018
"18-Nov",전남,여수시,543,123915,6922,131380,"2018-11-01",2018
"18-Nov",전남,영광군,213,26143,718,27074,"2018-11-01",2018
"18-Nov",전남,영암군,242,31388,14503,46133,"2018-11-01",2018
"18-Nov",전남,완도군,223,24062,490,24775,"2018-11-01",2018
"18-Nov",전남,장성군,160,25311,1056,26527,"2018-11-01",2018
"18-Nov",전남,장흥군,200,19345,442,19987,"2018-11-01",2018
"18-Nov",전남,진도군,153,15956,303,16412,"2018-11-01",2018
"18-Nov",전남,함평군,189,17378,7234,24801,"2018-11-01",2018
"18-Nov",전남,해남군,334,37548,582,38464,"2018-11-01",2018
"18-Nov",전남,화순군,218,31106,2024,33348,"2018-11-01",2018
"18-Nov",전남,계,6067,894927,127128,1028122,"2018-11-01",2018
"18-Nov",경북,경산시,323,131140,4323,135786,"2018-11-01",2018
"18-Nov",경북,경주시,571,135641,4699,140911,"2018-11-01",2018
"18-Nov",경북,고령군,158,20136,521,20815,"2018-11-01",2018
"18-Nov",경북,구미시,513,204451,7312,212276,"2018-11-01",2018
"18-Nov",경북,군위군,116,14183,278,14577,"2018-11-01",2018
"18-Nov",경북,김천시,376,70439,1842,72657,"2018-11-01",2018
"18-Nov",경북,문경시,303,34538,799,35640,"2018-11-01",2018
"18-Nov",경북,봉화군,192,17109,203,17504,"2018-11-01",2018
"18-Nov",경북,상주시,378,51020,1855,53253,"2018-11-01",2018
"18-Nov",경북,성주군,198,29159,1438,30795,"2018-11-01",2018
"18-Nov",경북,안동시,689,78981,2593,82263,"2018-11-01",2018
"18-Nov",경북,영덕군,251,18321,305,18877,"2018-11-01",2018
"18-Nov",경북,영양군,146,9213,96,9455,"2018-11-01",2018
"18-Nov",경북,영주시,348,54038,1518,55904,"2018-11-01",2018
"18-Nov",경북,영천시,286,56529,2686,59501,"2018-11-01",2018
"18-Nov",경북,예천군,215,26750,456,27421,"2018-11-01",2018
"18-Nov",경북,울릉군,147,5106,405,5658,"2018-11-01",2018
"18-Nov",경북,울진군,286,25016,364,25666,"2018-11-01",2018
"18-Nov",경북,의성군,304,28983,980,30267,"2018-11-01",2018
"18-Nov",경북,청도군,193,23791,628,24612,"2018-11-01",2018
"18-Nov",경북,청송군,193,14699,194,15086,"2018-11-01",2018
"18-Nov",경북,칠곡군,338,67095,2179,69612,"2018-11-01",2018
"18-Nov",경북,포항시 남구,400,118530,8815,127745,"2018-11-01",2018
"18-Nov",경북,포항시 북구,337,129845,3936,134118,"2018-11-01",2018
"18-Nov",경북,계,7261,1364713,48425,1420399,"2018-11-01",2018
"18-Nov",경남,거제시,344,102842,2243,105429,"2018-11-01",2018
"18-Nov",경남,거창군,249,30576,807,31632,"2018-11-01",2018
"18-Nov",경남,고성군,211,25948,635,26794,"2018-11-01",2018
"18-Nov",경남,김해시,645,256185,6959,263789,"2018-11-01",2018
"18-Nov",경남,남해군,249,18749,483,19481,"2018-11-01",2018
"18-Nov",경남,밀양시,314,53446,3988,57748,"2018-11-01",2018
"18-Nov",경남,사천시,310,54193,1509,56012,"2018-11-01",2018
"18-Nov",경남,산청군,224,19228,767,20219,"2018-11-01",2018
"18-Nov",경남,양산시,397,155544,9611,165552,"2018-11-01",2018
"18-Nov",경남,의령군,194,13708,673,14575,"2018-11-01",2018
"18-Nov",경남,진주시,618,156191,6637,163446,"2018-11-01",2018
"18-Nov",경남,창녕군,238,34415,945,35598,"2018-11-01",2018
"18-Nov",경남,창원시 마산합포구,338,98502,3042,101882,"2018-11-01",2018
"18-Nov",경남,창원시 마산회원구,171,94372,5266,99809,"2018-11-01",2018
"18-Nov",경남,창원시 성산구,142,120750,15858,136750,"2018-11-01",2018
"18-Nov",경남,창원시 의창구,899,126739,6546,134184,"2018-11-01",2018
"18-Nov",경남,창원시 진해구,208,86084,1648,87940,"2018-11-01",2018
"18-Nov",경남,통영시,314,51836,1534,53684,"2018-11-01",2018
"18-Nov",경남,하동군,218,23761,452,24431,"2018-11-01",2018
"18-Nov",경남,함안군,200,40640,11375,52215,"2018-11-01",2018
"18-Nov",경남,함양군,193,18672,395,19260,"2018-11-01",2018
"18-Nov",경남,합천군,254,22339,640,23233,"2018-11-01",2018
"18-Nov",경남,계,6930,1604720,82013,1693663,"2018-11-01",2018
"18-Nov",제주,서귀포시,747,100566,2054,103367,"2018-11-01",2018
"18-Nov",제주,제주시,1539,267838,177270,446647,"2018-11-01",2018
"18-Nov",제주,계,2286,368404,179324,550014,"2018-11-01",2018
"18-Dec",서울,강남구,373,215232,19709,235314,"2018-12-01",2018
"18-Dec",서울,강동구,263,126528,8629,135420,"2018-12-01",2018
"18-Dec",서울,강북구,301,72325,4739,77365,"2018-12-01",2018
"18-Dec",서울,강서구,326,186482,17658,204466,"2018-12-01",2018
"18-Dec",서울,관악구,306,115564,5560,121430,"2018-12-01",2018
"18-Dec",서울,광진구,282,94290,5980,100552,"2018-12-01",2018
"18-Dec",서울,구로구,283,129451,14706,144440,"2018-12-01",2018
"18-Dec",서울,금천구,125,81022,5916,87063,"2018-12-01",2018
"18-Dec",서울,노원구,295,144063,9262,153620,"2018-12-01",2018
"18-Dec",서울,도봉구,254,89465,7589,97308,"2018-12-01",2018
"18-Dec",서울,동대문구,315,92689,5320,98324,"2018-12-01",2018
"18-Dec",서울,동작구,308,102357,2811,105476,"2018-12-01",2018
"18-Dec",서울,마포구,333,110743,6915,117991,"2018-12-01",2018
"18-Dec",서울,서대문구,449,80677,5627,86753,"2018-12-01",2018
"18-Dec",서울,서초구,587,168412,13124,182123,"2018-12-01",2018
"18-Dec",서울,성동구,318,96092,9684,106094,"2018-12-01",2018
"18-Dec",서울,성북구,286,110754,5503,116543,"2018-12-01",2018
"18-Dec",서울,송파구,382,222420,13377,236179,"2018-12-01",2018
"18-Dec",서울,양천구,322,141629,8570,150521,"2018-12-01",2018
"18-Dec",서울,영등포구,365,134034,9541,143940,"2018-12-01",2018
"18-Dec",서울,용산구,368,74888,2259,77515,"2018-12-01",2018
"18-Dec",서울,은평구,269,122249,7129,129647,"2018-12-01",2018
"18-Dec",서울,종로구,3859,45207,1666,50732,"2018-12-01",2018
"18-Dec",서울,중구,1058,45977,4778,51813,"2018-12-01",2018
"18-Dec",서울,중랑구,213,104092,9717,114022,"2018-12-01",2018
"18-Dec",서울,계,12240,2906642,205769,3124651,"2018-12-01",2018
"18-Dec",부산,강서구,324,67988,3801,72113,"2018-12-01",2018
"18-Dec",부산,금정구,284,81729,7390,89403,"2018-12-01",2018
"18-Dec",부산,기장군,253,70718,2219,73190,"2018-12-01",2018
"18-Dec",부산,남구,239,91638,8533,100410,"2018-12-01",2018
"18-Dec",부산,동구,230,45699,4794,50723,"2018-12-01",2018
"18-Dec",부산,동래구,177,87804,4206,92187,"2018-12-01",2018
"18-Dec",부산,부산진구,361,119882,11863,132106,"2018-12-01",2018
"18-Dec",부산,북구,250,100606,3348,104204,"2018-12-01",2018
"18-Dec",부산,사상구,291,84933,6027,91251,"2018-12-01",2018
"18-Dec",부산,사하구,271,108741,7103,116115,"2018-12-01",2018
"18-Dec",부산,서구,138,28371,1380,29889,"2018-12-01",2018
"18-Dec",부산,수영구,163,65796,20970,86929,"2018-12-01",2018
"18-Dec",부산,연제구,837,81461,7562,89860,"2018-12-01",2018
"18-Dec",부산,영도구,234,31615,2102,33951,"2018-12-01",2018
"18-Dec",부산,중구,309,22900,7103,30312,"2018-12-01",2018
"18-Dec",부산,해운대구,305,167484,10740,178529,"2018-12-01",2018
"18-Dec",부산,계,4666,1257365,109141,1371172,"2018-12-01",2018
"18-Dec",대구,남구,346,56155,1862,58363,"2018-12-01",2018
"18-Dec",대구,달서구,480,261979,12206,274665,"2018-12-01",2018
"18-Dec",대구,달성군,494,123914,4712,129120,"2018-12-01",2018
"18-Dec",대구,동구,351,151594,10258,162203,"2018-12-01",2018
"18-Dec",대구,북구,506,194171,7954,202631,"2018-12-01",2018
"18-Dec",대구,서구,240,73113,4244,77597,"2018-12-01",2018
"18-Dec",대구,수성구,562,210066,5338,215966,"2018-12-01",2018
"18-Dec",대구,중구,290,55674,1844,57808,"2018-12-01",2018
"18-Dec",대구,계,3269,1126666,48418,1178353,"2018-12-01",2018
"18-Dec",인천,강화군,322,32669,1248,34239,"2018-12-01",2018
"18-Dec",인천,계양구,273,121812,166536,288621,"2018-12-01",2018
"18-Dec",인천,남동구,860,251673,42371,294904,"2018-12-01",2018
"18-Dec",인천,동구,89,26424,2737,29250,"2018-12-01",2018
"18-Dec",인천,미추홀구,405,150078,54920,205403,"2018-12-01",2018
"18-Dec",인천,부평구,334,215218,9911,225463,"2018-12-01",2018
"18-Dec",인천,서구,391,228339,10887,239617,"2018-12-01",2018
"18-Dec",인천,연수구,373,165723,7574,173670,"2018-12-01",2018
"18-Dec",인천,옹진군,189,11648,207,12044,"2018-12-01",2018
"18-Dec",인천,중구,668,56216,17512,74396,"2018-12-01",2018
"18-Dec",인천,계,3904,1259800,313903,1577607,"2018-12-01",2018
"18-Dec",광주,광산구,509,182480,11618,194607,"2018-12-01",2018
"18-Dec",광주,남구,173,85709,2654,88536,"2018-12-01",2018
"18-Dec",광주,동구,245,36210,1103,37558,"2018-12-01",2018
"18-Dec",광주,북구,496,183242,10288,194026,"2018-12-01",2018
"18-Dec",광주,서구,721,141683,7185,149589,"2018-12-01",2018
"18-Dec",광주,계,2144,629324,32848,664316,"2018-12-01",2018
"18-Dec",대전,대덕구,219,85234,6750,92203,"2018-12-01",2018
"18-Dec",대전,동구,248,88272,4205,92725,"2018-12-01",2018
"18-Dec",대전,서구,792,201829,7592,210213,"2018-12-01",2018
"18-Dec",대전,유성구,378,166990,5020,172388,"2018-12-01",2018
"18-Dec",대전,중구,239,96258,5933,102430,"2018-12-01",2018
"18-Dec",대전,계,1876,638583,29500,669959,"2018-12-01",2018
"18-Dec",울산,남구,698,152102,7284,160084,"2018-12-01",2018
"18-Dec",울산,동구,197,62235,962,63394,"2018-12-01",2018
"18-Dec",울산,북구,176,101768,3931,105875,"2018-12-01",2018
"18-Dec",울산,울주군,366,116756,6417,123539,"2018-12-01",2018
"18-Dec",울산,중구,345,102181,2688,105214,"2018-12-01",2018
"18-Dec",울산,계,1782,535042,21282,558106,"2018-12-01",2018
"18-Dec",세종,세종특별자치시,678,144548,2699,147925,"2018-12-01",2018
"18-Dec",세종,계,678,144548,2699,147925,"2018-12-01",2018
"18-Dec",경기,가평군,356,29381,677,30414,"2018-12-01",2018
"18-Dec",경기,고양시 덕양구,658,161586,3869,166113,"2018-12-01",2018
"18-Dec",경기,고양시 일산동구,284,118946,7296,126526,"2018-12-01",2018
"18-Dec",경기,고양시 일산서구,129,109641,3880,113650,"2018-12-01",2018
"18-Dec",경기,과천시,704,20379,605,21688,"2018-12-01",2018
"18-Dec",경기,광명시,308,104358,4088,108754,"2018-12-01",2018
"18-Dec",경기,광주시,381,176422,8089,184892,"2018-12-01",2018
"18-Dec",경기,구리시,242,70016,2610,72868,"2018-12-01",2018
"18-Dec",경기,군포시,295,95463,5107,100865,"2018-12-01",2018
"18-Dec",경기,김포시,465,193394,7141,201000,"2018-12-01",2018
"18-Dec",경기,남양주시,651,271037,7459,279147,"2018-12-01",2018
"18-Dec",경기,동두천시,214,36856,1311,38381,"2018-12-01",2018
"18-Dec",경기,부천시,734,294401,12723,307858,"2018-12-01",2018
"18-Dec",경기,성남시 분당구,351,183916,6877,191144,"2018-12-01",2018
"18-Dec",경기,성남시 수정구,345,70532,2414,73291,"2018-12-01",2018
"18-Dec",경기,성남시 중원구,322,71400,4154,75876,"2018-12-01",2018
"18-Dec",경기,수원시 권선구,369,176126,7872,184367,"2018-12-01",2018
"18-Dec",경기,수원시 영통구,226,135973,3114,139313,"2018-12-01",2018
"18-Dec",경기,수원시 장안구,584,104054,3954,108592,"2018-12-01",2018
"18-Dec",경기,수원시 팔달구,486,69053,3133,72672,"2018-12-01",2018
"18-Dec",경기,시흥시,465,212166,7622,220253,"2018-12-01",2018
"18-Dec",경기,안산시 단원구,559,147460,8302,156321,"2018-12-01",2018
"18-Dec",경기,안산시 상록구,181,136511,4837,141529,"2018-12-01",2018
"18-Dec",경기,안성시,376,95144,4898,100418,"2018-12-01",2018
"18-Dec",경기,안양시 동안구,396,116023,6444,122863,"2018-12-01",2018
"18-Dec",경기,안양시 만안구,158,84532,3823,88513,"2018-12-01",2018
"18-Dec",경기,양주시,385,96102,3134,99621,"2018-12-01",2018
"18-Dec",경기,양평군,546,56412,1738,58696,"2018-12-01",2018
"18-Dec",경기,여주시,406,59781,7200,67387,"2018-12-01",2018
"18-Dec",경기,연천군,293,23017,5369,28679,"2018-12-01",2018
"18-Dec",경기,오산시,261,96262,3235,99758,"2018-12-01",2018
"18-Dec",경기,용인시 기흥구,119,178698,8562,187379,"2018-12-01",2018
"18-Dec",경기,용인시 수지구,45,133560,2218,135823,"2018-12-01",2018
"18-Dec",경기,용인시 처인구,692,120954,7104,128750,"2018-12-01",2018
"18-Dec",경기,의왕시,294,57340,3155,60789,"2018-12-01",2018
"18-Dec",경기,의정부시,585,149869,4902,155356,"2018-12-01",2018
"18-Dec",경기,이천시,411,105403,5720,111534,"2018-12-01",2018
"18-Dec",경기,파주시,485,198065,9658,208208,"2018-12-01",2018
"18-Dec",경기,평택시,692,246718,11598,259008,"2018-12-01",2018
"18-Dec",경기,포천시,354,81962,9873,92189,"2018-12-01",2018
"18-Dec",경기,하남시,360,101705,2477,104542,"2018-12-01",2018
"18-Dec",경기,화성시,799,380041,11744,392584,"2018-12-01",2018
"18-Dec",경기,계,16966,5370659,229986,5617611,"2018-12-01",2018
"18-Dec",강원,강릉시,507,101845,4577,106929,"2018-12-01",2018
"18-Dec",강원,고성군,178,13631,227,14036,"2018-12-01",2018
"18-Dec",강원,동해시,294,42772,1353,44419,"2018-12-01",2018
"18-Dec",강원,삼척시,366,31191,691,32248,"2018-12-01",2018
"18-Dec",강원,속초시,283,35600,1386,37269,"2018-12-01",2018
"18-Dec",강원,양구군,147,11719,123,11989,"2018-12-01",2018
"18-Dec",강원,양양군,177,14615,224,15016,"2018-12-01",2018
"18-Dec",강원,영월군,326,20238,362,20926,"2018-12-01",2018
"18-Dec",강원,원주시,544,159705,5866,166115,"2018-12-01",2018
"18-Dec",강원,인제군,203,17305,236,17744,"2018-12-01",2018
"18-Dec",강원,정선군,315,19927,454,20696,"2018-12-01",2018
"18-Dec",강원,철원군,216,23328,305,23849,"2018-12-01",2018
"18-Dec",강원,춘천시,823,124999,5783,131605,"2018-12-01",2018
"18-Dec",강원,태백시,214,20047,794,21055,"2018-12-01",2018
"18-Dec",강원,평창군,280,24848,465,25593,"2018-12-01",2018
"18-Dec",강원,홍천군,391,36968,1099,38458,"2018-12-01",2018
"18-Dec",강원,화천군,199,12289,199,12687,"2018-12-01",2018
"18-Dec",강원,횡성군,228,24834,678,25740,"2018-12-01",2018
"18-Dec",강원,계,5691,735861,24822,766374,"2018-12-01",2018
"18-Dec",충북,괴산군,193,21879,366,22438,"2018-12-01",2018
"18-Dec",충북,단양군,211,15409,812,16432,"2018-12-01",2018
"18-Dec",충북,보은군,201,17345,960,18506,"2018-12-01",2018
"18-Dec",충북,영동군,236,24429,379,25044,"2018-12-01",2018
"18-Dec",충북,옥천군,198,25757,1101,27056,"2018-12-01",2018
"18-Dec",충북,음성군,214,55993,1788,57995,"2018-12-01",2018
"18-Dec",충북,제천시,317,64785,3494,68596,"2018-12-01",2018
"18-Dec",충북,증평군,93,18185,753,19031,"2018-12-01",2018
"18-Dec",충북,진천군,209,44069,1250,45528,"2018-12-01",2018
"18-Dec",충북,청원군,1,19,0,20,"2018-12-01",2018
"18-Dec",충북,청주시 상당구,494,79183,2357,82034,"2018-12-01",2018
"18-Dec",충북,청주시 서원구,237,90910,5209,96356,"2018-12-01",2018
"18-Dec",충북,청주시 청원구,344,99089,4090,103523,"2018-12-01",2018
"18-Dec",충북,청주시 흥덕구,365,116710,6979,124054,"2018-12-01",2018
"18-Dec",충북,충주시,565,103434,4086,108085,"2018-12-01",2018
"18-Dec",충북,계,3878,777196,33624,814698,"2018-12-01",2018
"18-Dec",충남,계룡시,149,20952,528,21629,"2018-12-01",2018
"18-Dec",충남,공주시,529,52138,2207,54874,"2018-12-01",2018
"18-Dec",충남,금산군,180,27626,1887,29693,"2018-12-01",2018
"18-Dec",충남,논산시,365,58972,2260,61597,"2018-12-01",2018
"18-Dec",충남,당진시,371,90096,3784,94251,"2018-12-01",2018
"18-Dec",충남,보령시,388,50145,1296,51829,"2018-12-01",2018
"18-Dec",충남,부여군,272,33353,1315,34940,"2018-12-01",2018
"18-Dec",충남,서산시,390,88590,3519,92499,"2018-12-01",2018
"18-Dec",충남,서천군,230,26492,887,27609,"2018-12-01",2018
"18-Dec",충남,아산시,465,155650,6323,162438,"2018-12-01",2018
"18-Dec",충남,예산군,368,41538,1428,43334,"2018-12-01",2018
"18-Dec",충남,천안시 동남구,272,124482,4719,129473,"2018-12-01",2018
"18-Dec",충남,천안시 서북구,544,179989,5896,186429,"2018-12-01",2018
"18-Dec",충남,청양군,242,16421,874,17537,"2018-12-01",2018
"18-Dec",충남,태안군,273,32619,489,33381,"2018-12-01",2018
"18-Dec",충남,홍성군,407,50244,1418,52069,"2018-12-01",2018
"18-Dec",충남,계,5445,1049307,38830,1093582,"2018-12-01",2018
"18-Dec",전북,고창군,253,29568,588,30409,"2018-12-01",2018
"18-Dec",전북,군산시,511,125562,6707,132780,"2018-12-01",2018
"18-Dec",전북,김제시,291,43833,1959,46083,"2018-12-01",2018
"18-Dec",전북,남원시,417,39216,4157,43790,"2018-12-01",2018
"18-Dec",전북,무주군,181,12294,369,12844,"2018-12-01",2018
"18-Dec",전북,부안군,256,26791,609,27656,"2018-12-01",2018
"18-Dec",전북,순창군,201,14170,193,14564,"2018-12-01",2018
"18-Dec",전북,완주군,340,49723,3336,53399,"2018-12-01",2018
"18-Dec",전북,익산시,488,134474,6320,141282,"2018-12-01",2018
"18-Dec",전북,임실군,197,14518,421,15136,"2018-12-01",2018
"18-Dec",전북,장수군,224,11743,177,12144,"2018-12-01",2018
"18-Dec",전북,전주시 덕진구,418,157157,7488,165063,"2018-12-01",2018
"18-Dec",전북,전주시 완산구,595,145773,4058,150426,"2018-12-01",2018
"18-Dec",전북,정읍시,331,52318,3826,56475,"2018-12-01",2018
"18-Dec",전북,진안군,244,13452,197,13893,"2018-12-01",2018
"18-Dec",전북,계,4947,870592,40405,915944,"2018-12-01",2018
"18-Dec",전남,강진군,214,17918,1073,19205,"2018-12-01",2018
"18-Dec",전남,고흥군,299,30001,671,30971,"2018-12-01",2018
"18-Dec",전남,곡성군,137,14239,748,15124,"2018-12-01",2018
"18-Dec",전남,광양시,246,79018,5925,85189,"2018-12-01",2018
"18-Dec",전남,구례군,131,13071,632,13834,"2018-12-01",2018
"18-Dec",전남,나주시,447,59357,3247,63051,"2018-12-01",2018
"18-Dec",전남,담양군,219,25445,1526,27190,"2018-12-01",2018
"18-Dec",전남,목포시,452,93396,5932,99780,"2018-12-01",2018
"18-Dec",전남,무안군,536,40864,968,42368,"2018-12-01",2018
"18-Dec",전남,보성군,205,20973,64890,86068,"2018-12-01",2018
"18-Dec",전남,순천시,474,130199,5071,135744,"2018-12-01",2018
"18-Dec",전남,신안군,222,20163,853,21238,"2018-12-01",2018
"18-Dec",전남,여수시,541,123952,6878,131371,"2018-12-01",2018
"18-Dec",전남,영광군,215,26236,717,27168,"2018-12-01",2018
"18-Dec",전남,영암군,242,31425,14199,45866,"2018-12-01",2018
"18-Dec",전남,완도군,225,24092,497,24814,"2018-12-01",2018
"18-Dec",전남,장성군,156,25404,1081,26641,"2018-12-01",2018
"18-Dec",전남,장흥군,198,19357,445,20000,"2018-12-01",2018
"18-Dec",전남,진도군,154,15980,302,16436,"2018-12-01",2018
"18-Dec",전남,함평군,191,17429,10630,28250,"2018-12-01",2018
"18-Dec",전남,해남군,333,37522,582,38437,"2018-12-01",2018
"18-Dec",전남,화순군,220,31073,2036,33329,"2018-12-01",2018
"18-Dec",전남,계,6057,897114,128903,1032074,"2018-12-01",2018
"18-Dec",경북,경산시,321,131270,4293,135884,"2018-12-01",2018
"18-Dec",경북,경주시,575,135836,4664,141075,"2018-12-01",2018
"18-Dec",경북,고령군,156,20150,523,20829,"2018-12-01",2018
"18-Dec",경북,구미시,523,204650,7276,212449,"2018-12-01",2018
"18-Dec",경북,군위군,117,14169,281,14567,"2018-12-01",2018
"18-Dec",경북,김천시,375,70357,1837,72569,"2018-12-01",2018
"18-Dec",경북,문경시,307,34558,799,35664,"2018-12-01",2018
"18-Dec",경북,봉화군,194,17144,203,17541,"2018-12-01",2018
"18-Dec",경북,상주시,379,51135,1844,53358,"2018-12-01",2018
"18-Dec",경북,성주군,197,29273,1431,30901,"2018-12-01",2018
"18-Dec",경북,안동시,695,79171,2597,82463,"2018-12-01",2018
"18-Dec",경북,영덕군,250,18373,306,18929,"2018-12-01",2018
"18-Dec",경북,영양군,143,9217,100,9460,"2018-12-01",2018
"18-Dec",경북,영주시,350,54020,1515,55885,"2018-12-01",2018
"18-Dec",경북,영천시,287,56777,2685,59749,"2018-12-01",2018
"18-Dec",경북,예천군,215,26840,455,27510,"2018-12-01",2018
"18-Dec",경북,울릉군,148,5087,397,5632,"2018-12-01",2018
"18-Dec",경북,울진군,285,25082,365,25732,"2018-12-01",2018
"18-Dec",경북,의성군,304,29029,969,30302,"2018-12-01",2018
"18-Dec",경북,청도군,194,23835,630,24659,"2018-12-01",2018
"18-Dec",경북,청송군,195,14752,193,15140,"2018-12-01",2018
"18-Dec",경북,칠곡군,338,67154,2226,69718,"2018-12-01",2018
"18-Dec",경북,포항시 남구,397,118772,8806,127975,"2018-12-01",2018
"18-Dec",경북,포항시 북구,339,129893,3934,134166,"2018-12-01",2018
"18-Dec",경북,계,7284,1366544,48329,1422157,"2018-12-01",2018
"18-Dec",경남,거제시,347,102755,2239,105341,"2018-12-01",2018
"18-Dec",경남,거창군,250,30620,801,31671,"2018-12-01",2018
"18-Dec",경남,고성군,211,25996,632,26839,"2018-12-01",2018
"18-Dec",경남,김해시,652,256658,6992,264302,"2018-12-01",2018
"18-Dec",경남,남해군,254,18801,483,19538,"2018-12-01",2018
"18-Dec",경남,밀양시,319,53502,3996,57817,"2018-12-01",2018
"18-Dec",경남,사천시,324,54210,1510,56044,"2018-12-01",2018
"18-Dec",경남,산청군,233,19267,766,20266,"2018-12-01",2018
"18-Dec",경남,양산시,398,155722,9619,165739,"2018-12-01",2018
"18-Dec",경남,의령군,195,13750,676,14621,"2018-12-01",2018
"18-Dec",경남,진주시,615,156387,6636,163638,"2018-12-01",2018
"18-Dec",경남,창녕군,239,34418,946,35603,"2018-12-01",2018
"18-Dec",경남,창원시 마산합포구,340,98465,3003,101808,"2018-12-01",2018
"18-Dec",경남,창원시 마산회원구,170,94233,5305,99708,"2018-12-01",2018
"18-Dec",경남,창원시 성산구,146,120649,15486,136281,"2018-12-01",2018
"18-Dec",경남,창원시 의창구,905,126785,6387,134077,"2018-12-01",2018
"18-Dec",경남,창원시 진해구,206,86433,1657,88296,"2018-12-01",2018
"18-Dec",경남,통영시,324,51772,1525,53621,"2018-12-01",2018
"18-Dec",경남,하동군,222,23848,451,24521,"2018-12-01",2018
"18-Dec",경남,함안군,203,40581,11494,52278,"2018-12-01",2018
"18-Dec",경남,함양군,194,18633,394,19221,"2018-12-01",2018
"18-Dec",경남,합천군,256,22318,644,23218,"2018-12-01",2018
"18-Dec",경남,계,7003,1605803,81642,1694448,"2018-12-01",2018
"18-Dec",제주,서귀포시,744,100724,2049,103517,"2018-12-01",2018
"18-Dec",제주,제주시,1526,267803,180732,450061,"2018-12-01",2018
"18-Dec",제주,계,2270,368527,182781,553578,"2018-12-01",2018
"19-Jan",서울,강남구,374,215130,19320,234824,"2019-01-01",2019
"19-Jan",서울,강동구,265,126602,8771,135638,"2019-01-01",2019
"19-Jan",서울,강북구,303,72377,4738,77418,"2019-01-01",2019
"19-Jan",서울,강서구,325,186389,17722,204436,"2019-01-01",2019
"19-Jan",서울,관악구,307,115555,5613,121475,"2019-01-01",2019
"19-Jan",서울,광진구,282,94356,5987,100625,"2019-01-01",2019
"19-Jan",서울,구로구,283,129603,14595,144481,"2019-01-01",2019
"19-Jan",서울,금천구,125,81263,5898,87286,"2019-01-01",2019
"19-Jan",서울,노원구,297,144287,9236,153820,"2019-01-01",2019
"19-Jan",서울,도봉구,255,89542,7600,97397,"2019-01-01",2019
"19-Jan",서울,동대문구,313,92739,5401,98453,"2019-01-01",2019
"19-Jan",서울,동작구,310,103085,2809,106204,"2019-01-01",2019
"19-Jan",서울,마포구,330,110778,6935,118043,"2019-01-01",2019
"19-Jan",서울,서대문구,448,81046,5650,87144,"2019-01-01",2019
"19-Jan",서울,서초구,583,168405,13251,182239,"2019-01-01",2019
"19-Jan",서울,성동구,313,95846,9583,105742,"2019-01-01",2019
"19-Jan",서울,성북구,283,110853,5488,116624,"2019-01-01",2019
"19-Jan",서울,송파구,384,224180,13132,237696,"2019-01-01",2019
"19-Jan",서울,양천구,319,141782,8580,150681,"2019-01-01",2019
"19-Jan",서울,영등포구,364,133937,9469,143770,"2019-01-01",2019
"19-Jan",서울,용산구,365,74979,2252,77596,"2019-01-01",2019
"19-Jan",서울,은평구,276,122756,7022,130054,"2019-01-01",2019
"19-Jan",서울,종로구,3857,45185,1679,50721,"2019-01-01",2019
"19-Jan",서울,중구,1164,46008,4722,51894,"2019-01-01",2019
"19-Jan",서울,중랑구,214,104239,9706,114159,"2019-01-01",2019
"19-Jan",서울,계,12339,2910922,205159,3128420,"2019-01-01",2019
"19-Jan",부산,강서구,318,68584,3799,72701,"2019-01-01",2019
"19-Jan",부산,금정구,280,81718,7387,89385,"2019-01-01",2019
"19-Jan",부산,기장군,251,70999,2235,73485,"2019-01-01",2019
"19-Jan",부산,남구,229,91689,8517,100435,"2019-01-01",2019
"19-Jan",부산,동구,228,45873,4734,50835,"2019-01-01",2019
"19-Jan",부산,동래구,177,88059,4295,92531,"2019-01-01",2019
"19-Jan",부산,부산진구,354,119831,12285,132470,"2019-01-01",2019
"19-Jan",부산,북구,239,100716,3310,104265,"2019-01-01",2019
"19-Jan",부산,사상구,284,84922,5985,91191,"2019-01-01",2019
"19-Jan",부산,사하구,266,108546,7111,115923,"2019-01-01",2019
"19-Jan",부산,서구,136,28448,1385,29969,"2019-01-01",2019
"19-Jan",부산,수영구,163,65634,21667,87464,"2019-01-01",2019
"19-Jan",부산,연제구,836,81586,7691,90113,"2019-01-01",2019
"19-Jan",부산,영도구,233,31520,2101,33854,"2019-01-01",2019
"19-Jan",부산,중구,309,23155,7138,30602,"2019-01-01",2019
"19-Jan",부산,해운대구,302,167806,10906,179014,"2019-01-01",2019
"19-Jan",부산,계,4605,1259086,110546,1374237,"2019-01-01",2019
"19-Jan",대구,남구,348,56244,1808,58400,"2019-01-01",2019
"19-Jan",대구,달서구,475,261949,12189,274613,"2019-01-01",2019
"19-Jan",대구,달성군,492,125021,4811,130324,"2019-01-01",2019
"19-Jan",대구,동구,345,151669,10235,162249,"2019-01-01",2019
"19-Jan",대구,북구,499,194293,7914,202706,"2019-01-01",2019
"19-Jan",대구,서구,236,72785,4241,77262,"2019-01-01",2019
"19-Jan",대구,수성구,555,210915,5391,216861,"2019-01-01",2019
"19-Jan",대구,중구,288,55731,1846,57865,"2019-01-01",2019
"19-Jan",대구,계,3238,1128607,48435,1180280,"2019-01-01",2019
"19-Jan",인천,강화군,318,32839,1246,34403,"2019-01-01",2019
"19-Jan",인천,계양구,280,121909,168788,290977,"2019-01-01",2019
"19-Jan",인천,남동구,859,252568,42352,295779,"2019-01-01",2019
"19-Jan",인천,동구,89,26536,2787,29412,"2019-01-01",2019
"19-Jan",인천,미추홀구,403,150488,55446,206337,"2019-01-01",2019
"19-Jan",인천,부평구,335,215316,10407,226058,"2019-01-01",2019
"19-Jan",인천,서구,390,229240,10930,240560,"2019-01-01",2019
"19-Jan",인천,연수구,374,167118,7639,175131,"2019-01-01",2019
"19-Jan",인천,옹진군,190,11734,210,12134,"2019-01-01",2019
"19-Jan",인천,중구,638,56743,17694,75075,"2019-01-01",2019
"19-Jan",인천,계,3876,1264491,317499,1585866,"2019-01-01",2019
"19-Jan",광주,광산구,502,183166,11751,195419,"2019-01-01",2019
"19-Jan",광주,남구,172,86122,2652,88946,"2019-01-01",2019
"19-Jan",광주,동구,239,36338,1110,37687,"2019-01-01",2019
"19-Jan",광주,북구,489,183951,10229,194669,"2019-01-01",2019
"19-Jan",광주,서구,721,141690,7179,149590,"2019-01-01",2019
"19-Jan",광주,계,2123,631267,32921,666311,"2019-01-01",2019
"19-Jan",대전,대덕구,233,85168,6822,92223,"2019-01-01",2019
"19-Jan",대전,동구,244,88531,4172,92947,"2019-01-01",2019
"19-Jan",대전,서구,772,202229,7663,210664,"2019-01-01",2019
"19-Jan",대전,유성구,377,167261,4981,172619,"2019-01-01",2019
"19-Jan",대전,중구,234,96303,5974,102511,"2019-01-01",2019
"19-Jan",대전,계,1860,639492,29612,670964,"2019-01-01",2019
"19-Jan",울산,남구,689,152372,7286,160347,"2019-01-01",2019
"19-Jan",울산,동구,196,62257,953,63406,"2019-01-01",2019
"19-Jan",울산,북구,175,102231,3852,106258,"2019-01-01",2019
"19-Jan",울산,울주군,374,117000,6438,123812,"2019-01-01",2019
"19-Jan",울산,중구,344,102233,2708,105285,"2019-01-01",2019
"19-Jan",울산,계,1778,536093,21237,559108,"2019-01-01",2019
"19-Jan",세종,세종특별자치시,680,146361,2716,149757,"2019-01-01",2019
"19-Jan",세종,계,680,146361,2716,149757,"2019-01-01",2019
"19-Jan",경기,가평군,353,29470,666,30489,"2019-01-01",2019
"19-Jan",경기,고양시 덕양구,657,161962,3838,166457,"2019-01-01",2019
"19-Jan",경기,고양시 일산동구,282,119294,7227,126803,"2019-01-01",2019
"19-Jan",경기,고양시 일산서구,128,109979,3958,114065,"2019-01-01",2019
"19-Jan",경기,과천시,704,20447,605,21756,"2019-01-01",2019
"19-Jan",경기,광명시,308,104617,4087,109012,"2019-01-01",2019
"19-Jan",경기,광주시,377,177282,8149,185808,"2019-01-01",2019
"19-Jan",경기,구리시,237,70204,2612,73053,"2019-01-01",2019
"19-Jan",경기,군포시,294,95887,5076,101257,"2019-01-01",2019
"19-Jan",경기,김포시,460,194965,7252,202677,"2019-01-01",2019
"19-Jan",경기,남양주시,649,272483,7486,280618,"2019-01-01",2019
"19-Jan",경기,동두천시,212,36892,1309,38413,"2019-01-01",2019
"19-Jan",경기,부천시,733,294867,12716,308316,"2019-01-01",2019
"19-Jan",경기,성남시 분당구,346,184015,7044,191405,"2019-01-01",2019
"19-Jan",경기,성남시 수정구,343,70761,2537,73641,"2019-01-01",2019
"19-Jan",경기,성남시 중원구,322,71571,4159,76052,"2019-01-01",2019
"19-Jan",경기,수원시 권선구,367,175776,7925,184068,"2019-01-01",2019
"19-Jan",경기,수원시 영통구,224,136628,3112,139964,"2019-01-01",2019
"19-Jan",경기,수원시 장안구,587,104013,3956,108556,"2019-01-01",2019
"19-Jan",경기,수원시 팔달구,484,68963,3153,72600,"2019-01-01",2019
"19-Jan",경기,시흥시,464,213883,7629,221976,"2019-01-01",2019
"19-Jan",경기,안산시 단원구,565,148001,8295,156861,"2019-01-01",2019
"19-Jan",경기,안산시 상록구,181,136750,4800,141731,"2019-01-01",2019
"19-Jan",경기,안성시,376,95668,4986,101030,"2019-01-01",2019
"19-Jan",경기,안양시 동안구,397,116061,6458,122916,"2019-01-01",2019
"19-Jan",경기,안양시 만안구,158,84431,3843,88432,"2019-01-01",2019
"19-Jan",경기,양주시,375,96935,3156,100466,"2019-01-01",2019
"19-Jan",경기,양평군,548,56502,1740,58790,"2019-01-01",2019
"19-Jan",경기,여주시,406,60058,7190,67654,"2019-01-01",2019
"19-Jan",경기,연천군,289,23074,5341,28704,"2019-01-01",2019
"19-Jan",경기,오산시,219,96409,3251,99879,"2019-01-01",2019
"19-Jan",경기,용인시 기흥구,119,179497,8464,188080,"2019-01-01",2019
"19-Jan",경기,용인시 수지구,45,133855,2240,136140,"2019-01-01",2019
"19-Jan",경기,용인시 처인구,692,121779,7128,129599,"2019-01-01",2019
"19-Jan",경기,의왕시,292,57603,3167,61062,"2019-01-01",2019
"19-Jan",경기,의정부시,612,150801,4924,156337,"2019-01-01",2019
"19-Jan",경기,이천시,409,105990,5739,112138,"2019-01-01",2019
"19-Jan",경기,파주시,476,199095,9643,209214,"2019-01-01",2019
"19-Jan",경기,평택시,691,248098,11642,260431,"2019-01-01",2019
"19-Jan",경기,포천시,352,82305,9681,92338,"2019-01-01",2019
"19-Jan",경기,하남시,371,102806,2505,105682,"2019-01-01",2019
"19-Jan",경기,화성시,835,384758,11626,397219,"2019-01-01",2019
"19-Jan",경기,계,16939,5394435,230315,5641689,"2019-01-01",2019
"19-Jan",강원,강릉시,507,102224,4541,107272,"2019-01-01",2019
"19-Jan",강원,고성군,179,13699,224,14102,"2019-01-01",2019
"19-Jan",강원,동해시,293,42879,1360,44532,"2019-01-01",2019
"19-Jan",강원,삼척시,359,31288,696,32343,"2019-01-01",2019
"19-Jan",강원,속초시,282,35646,1373,37301,"2019-01-01",2019
"19-Jan",강원,양구군,147,11755,123,12025,"2019-01-01",2019
"19-Jan",강원,양양군,176,14705,220,15101,"2019-01-01",2019
"19-Jan",강원,영월군,334,20320,364,21018,"2019-01-01",2019
"19-Jan",강원,원주시,539,160558,5888,166985,"2019-01-01",2019
"19-Jan",강원,인제군,202,17342,236,17780,"2019-01-01",2019
"19-Jan",강원,정선군,318,19935,452,20705,"2019-01-01",2019
"19-Jan",강원,철원군,217,23379,305,23901,"2019-01-01",2019
"19-Jan",강원,춘천시,777,125465,5817,132059,"2019-01-01",2019
"19-Jan",강원,태백시,215,20043,796,21054,"2019-01-01",2019
"19-Jan",강원,평창군,279,24905,463,25647,"2019-01-01",2019
"19-Jan",강원,홍천군,386,37061,1102,38549,"2019-01-01",2019
"19-Jan",강원,화천군,196,12346,199,12741,"2019-01-01",2019
"19-Jan",강원,횡성군,224,24962,680,25866,"2019-01-01",2019
"19-Jan",강원,계,5630,738512,24839,768981,"2019-01-01",2019
"19-Jan",충북,괴산군,191,21793,364,22348,"2019-01-01",2019
"19-Jan",충북,단양군,211,15463,793,16467,"2019-01-01",2019
"19-Jan",충북,보은군,202,17414,963,18579,"2019-01-01",2019
"19-Jan",충북,영동군,231,24420,380,25031,"2019-01-01",2019
"19-Jan",충북,옥천군,196,25822,1111,27129,"2019-01-01",2019
"19-Jan",충북,음성군,212,56224,1795,58231,"2019-01-01",2019
"19-Jan",충북,제천시,312,64956,3521,68789,"2019-01-01",2019
"19-Jan",충북,증평군,94,18191,731,19016,"2019-01-01",2019
"19-Jan",충북,진천군,209,44523,1274,46006,"2019-01-01",2019
"19-Jan",충북,청원군,1,19,0,20,"2019-01-01",2019
"19-Jan",충북,청주시 상당구,495,79797,2392,82684,"2019-01-01",2019
"19-Jan",충북,청주시 서원구,235,90858,5223,96316,"2019-01-01",2019
"19-Jan",충북,청주시 청원구,340,99434,4114,103888,"2019-01-01",2019
"19-Jan",충북,청주시 흥덕구,350,117509,7009,124868,"2019-01-01",2019
"19-Jan",충북,충주시,566,103892,4297,108755,"2019-01-01",2019
"19-Jan",충북,계,3845,780315,33967,818127,"2019-01-01",2019
"19-Jan",충남,계룡시,151,20969,524,21644,"2019-01-01",2019
"19-Jan",충남,공주시,530,52273,2131,54934,"2019-01-01",2019
"19-Jan",충남,금산군,182,27625,1912,29719,"2019-01-01",2019
"19-Jan",충남,논산시,366,59262,2277,61905,"2019-01-01",2019
"19-Jan",충남,당진시,372,90350,3791,94513,"2019-01-01",2019
"19-Jan",충남,보령시,388,50338,1305,52031,"2019-01-01",2019
"19-Jan",충남,부여군,271,33431,1307,35009,"2019-01-01",2019
"19-Jan",충남,서산시,390,88958,3520,92868,"2019-01-01",2019
"19-Jan",충남,서천군,230,26581,889,27700,"2019-01-01",2019
"19-Jan",충남,아산시,471,156466,6271,163208,"2019-01-01",2019
"19-Jan",충남,예산군,366,41659,1427,43452,"2019-01-01",2019
"19-Jan",충남,천안시 동남구,264,124733,4719,129716,"2019-01-01",2019
"19-Jan",충남,천안시 서북구,541,180786,5882,187209,"2019-01-01",2019
"19-Jan",충남,청양군,242,16417,855,17514,"2019-01-01",2019
"19-Jan",충남,태안군,277,32681,512,33470,"2019-01-01",2019
"19-Jan",충남,홍성군,409,50474,1414,52297,"2019-01-01",2019
"19-Jan",충남,계,5450,1053003,38736,1097189,"2019-01-01",2019
"19-Jan",전북,고창군,253,29754,594,30601,"2019-01-01",2019
"19-Jan",전북,군산시,509,125989,6715,133213,"2019-01-01",2019
"19-Jan",전북,김제시,291,44029,1944,46264,"2019-01-01",2019
"19-Jan",전북,남원시,416,39421,4103,43940,"2019-01-01",2019
"19-Jan",전북,무주군,181,12314,370,12865,"2019-01-01",2019
"19-Jan",전북,부안군,256,26865,619,27740,"2019-01-01",2019
"19-Jan",전북,순창군,200,14202,185,14587,"2019-01-01",2019
"19-Jan",전북,완주군,343,49901,3346,53590,"2019-01-01",2019
"19-Jan",전북,익산시,488,134768,6343,141599,"2019-01-01",2019
"19-Jan",전북,임실군,198,14293,423,14914,"2019-01-01",2019
"19-Jan",전북,장수군,224,11809,180,12213,"2019-01-01",2019
"19-Jan",전북,전주시 덕진구,418,157590,7489,165497,"2019-01-01",2019
"19-Jan",전북,전주시 완산구,592,146267,4070,150929,"2019-01-01",2019
"19-Jan",전북,정읍시,332,52591,3803,56726,"2019-01-01",2019
"19-Jan",전북,진안군,243,13537,199,13979,"2019-01-01",2019
"19-Jan",전북,계,4944,873330,40383,918657,"2019-01-01",2019
"19-Jan",전남,강진군,210,17962,1080,19252,"2019-01-01",2019
"19-Jan",전남,고흥군,294,30164,670,31128,"2019-01-01",2019
"19-Jan",전남,곡성군,136,14283,744,15163,"2019-01-01",2019
"19-Jan",전남,광양시,240,78416,5940,84596,"2019-01-01",2019
"19-Jan",전남,구례군,128,13020,625,13773,"2019-01-01",2019
"19-Jan",전남,나주시,442,59835,3321,63598,"2019-01-01",2019
"19-Jan",전남,담양군,214,25461,1533,27208,"2019-01-01",2019
"19-Jan",전남,목포시,451,93628,5922,100001,"2019-01-01",2019
"19-Jan",전남,무안군,521,41002,965,42488,"2019-01-01",2019
"19-Jan",전남,보성군,201,21090,63859,85150,"2019-01-01",2019
"19-Jan",전남,순천시,469,131039,5100,136608,"2019-01-01",2019
"19-Jan",전남,신안군,224,20251,861,21336,"2019-01-01",2019
"19-Jan",전남,여수시,537,124460,6874,131871,"2019-01-01",2019
"19-Jan",전남,영광군,214,26338,722,27274,"2019-01-01",2019
"19-Jan",전남,영암군,238,31542,13612,45392,"2019-01-01",2019
"19-Jan",전남,완도군,224,24250,497,24971,"2019-01-01",2019
"19-Jan",전남,장성군,151,25523,1093,26767,"2019-01-01",2019
"19-Jan",전남,장흥군,196,19412,447,20055,"2019-01-01",2019
"19-Jan",전남,진도군,150,16028,306,16484,"2019-01-01",2019
"19-Jan",전남,함평군,190,17494,12039,29723,"2019-01-01",2019
"19-Jan",전남,해남군,326,37698,583,38607,"2019-01-01",2019
"19-Jan",전남,화순군,217,31078,2037,33332,"2019-01-01",2019
"19-Jan",전남,계,5973,899974,128830,1034777,"2019-01-01",2019
"19-Jan",경북,경산시,319,131648,4353,136320,"2019-01-01",2019
"19-Jan",경북,경주시,572,136164,4657,141393,"2019-01-01",2019
"19-Jan",경북,고령군,157,20204,526,20887,"2019-01-01",2019
"19-Jan",경북,구미시,524,205253,7282,213059,"2019-01-01",2019
"19-Jan",경북,군위군,117,14217,280,14614,"2019-01-01",2019
"19-Jan",경북,김천시,376,70559,1838,72773,"2019-01-01",2019
"19-Jan",경북,문경시,306,34729,806,35841,"2019-01-01",2019
"19-Jan",경북,봉화군,193,17183,202,17578,"2019-01-01",2019
"19-Jan",경북,상주시,378,51228,1871,53477,"2019-01-01",2019
"19-Jan",경북,성주군,192,29291,1433,30916,"2019-01-01",2019
"19-Jan",경북,안동시,697,79293,2597,82587,"2019-01-01",2019
"19-Jan",경북,영덕군,249,18435,308,18992,"2019-01-01",2019
"19-Jan",경북,영양군,143,9252,102,9497,"2019-01-01",2019
"19-Jan",경북,영주시,349,54160,1520,56029,"2019-01-01",2019
"19-Jan",경북,영천시,284,56838,2686,59808,"2019-01-01",2019
"19-Jan",경북,예천군,215,27007,454,27676,"2019-01-01",2019
"19-Jan",경북,울릉군,146,5085,398,5629,"2019-01-01",2019
"19-Jan",경북,울진군,286,25120,364,25770,"2019-01-01",2019
"19-Jan",경북,의성군,303,29101,971,30375,"2019-01-01",2019
"19-Jan",경북,청도군,193,23906,636,24735,"2019-01-01",2019
"19-Jan",경북,청송군,196,14855,196,15247,"2019-01-01",2019
"19-Jan",경북,칠곡군,341,67251,2275,69867,"2019-01-01",2019
"19-Jan",경북,포항시 남구,396,118954,8802,128152,"2019-01-01",2019
"19-Jan",경북,포항시 북구,338,130705,3939,134982,"2019-01-01",2019
"19-Jan",경북,계,7270,1370438,48496,1426204,"2019-01-01",2019
"19-Jan",경남,거제시,345,102903,2208,105456,"2019-01-01",2019
"19-Jan",경남,거창군,249,30751,807,31807,"2019-01-01",2019
"19-Jan",경남,고성군,208,26061,640,26909,"2019-01-01",2019
"19-Jan",경남,김해시,638,257709,6979,265326,"2019-01-01",2019
"19-Jan",경남,남해군,250,18843,483,19576,"2019-01-01",2019
"19-Jan",경남,밀양시,308,53737,4017,58062,"2019-01-01",2019
"19-Jan",경남,사천시,316,54434,1517,56267,"2019-01-01",2019
"19-Jan",경남,산청군,229,19337,770,20336,"2019-01-01",2019
"19-Jan",경남,양산시,393,156477,9703,166573,"2019-01-01",2019
"19-Jan",경남,의령군,188,13792,675,14655,"2019-01-01",2019
"19-Jan",경남,진주시,601,157017,6656,164274,"2019-01-01",2019
"19-Jan",경남,창녕군,232,34520,960,35712,"2019-01-01",2019
"19-Jan",경남,창원시 마산합포구,331,98414,2982,101727,"2019-01-01",2019
"19-Jan",경남,창원시 마산회원구,170,94139,5294,99603,"2019-01-01",2019
"19-Jan",경남,창원시 성산구,144,120116,15101,135361,"2019-01-01",2019
"19-Jan",경남,창원시 의창구,893,127559,6336,134788,"2019-01-01",2019
"19-Jan",경남,창원시 진해구,202,86841,1655,88698,"2019-01-01",2019
"19-Jan",경남,통영시,319,51864,1522,53705,"2019-01-01",2019
"19-Jan",경남,하동군,217,23949,449,24615,"2019-01-01",2019
"19-Jan",경남,함안군,198,40580,11555,52333,"2019-01-01",2019
"19-Jan",경남,함양군,192,18657,393,19242,"2019-01-01",2019
"19-Jan",경남,합천군,252,22394,646,23292,"2019-01-01",2019
"19-Jan",경남,계,6875,1610094,81348,1698317,"2019-01-01",2019
"19-Jan",제주,서귀포시,747,101085,2063,103895,"2019-01-01",2019
"19-Jan",제주,제주시,1526,267666,184043,453235,"2019-01-01",2019
"19-Jan",제주,계,2273,368751,186106,557130,"2019-01-01",2019
"19-Feb",서울,강남구,370,215267,19203,234840,"2019-02-01",2019
"19-Feb",서울,강동구,265,126598,8862,135725,"2019-02-01",2019
"19-Feb",서울,강북구,303,72309,4738,77350,"2019-02-01",2019
"19-Feb",서울,강서구,323,185699,17781,203803,"2019-02-01",2019
"19-Feb",서울,관악구,307,115394,5613,121314,"2019-02-01",2019
"19-Feb",서울,광진구,282,94472,5912,100666,"2019-02-01",2019
"19-Feb",서울,구로구,282,129469,14933,144684,"2019-02-01",2019
"19-Feb",서울,금천구,126,81483,5876,87485,"2019-02-01",2019
"19-Feb",서울,노원구,299,144206,9208,153713,"2019-02-01",2019
"19-Feb",서울,도봉구,256,89548,7581,97385,"2019-02-01",2019
"19-Feb",서울,동대문구,313,92708,5373,98394,"2019-02-01",2019
"19-Feb",서울,동작구,312,103266,2809,106387,"2019-02-01",2019
"19-Feb",서울,마포구,332,110748,6916,117996,"2019-02-01",2019
"19-Feb",서울,서대문구,449,81358,5691,87498,"2019-02-01",2019
"19-Feb",서울,서초구,571,168229,13452,182252,"2019-02-01",2019
"19-Feb",서울,성동구,314,95338,9571,105223,"2019-02-01",2019
"19-Feb",서울,성북구,287,110854,5490,116631,"2019-02-01",2019
"19-Feb",서울,송파구,386,225871,13163,239420,"2019-02-01",2019
"19-Feb",서울,양천구,319,141688,8560,150567,"2019-02-01",2019
"19-Feb",서울,영등포구,364,133418,9411,143193,"2019-02-01",2019
"19-Feb",서울,용산구,361,74801,2174,77336,"2019-02-01",2019
"19-Feb",서울,은평구,278,123055,7011,130344,"2019-02-01",2019
"19-Feb",서울,종로구,3856,45146,1675,50677,"2019-02-01",2019
"19-Feb",서울,중구,1157,46058,4710,51925,"2019-02-01",2019
"19-Feb",서울,중랑구,214,104205,9735,114154,"2019-02-01",2019
"19-Feb",서울,계,12326,2911188,205448,3128962,"2019-02-01",2019
"19-Feb",부산,강서구,318,69165,3812,73295,"2019-02-01",2019
"19-Feb",부산,금정구,280,81699,7415,89394,"2019-02-01",2019
"19-Feb",부산,기장군,255,71148,2236,73639,"2019-02-01",2019
"19-Feb",부산,남구,228,91512,8528,100268,"2019-02-01",2019
"19-Feb",부산,동구,230,45962,4712,50904,"2019-02-01",2019
"19-Feb",부산,동래구,178,88272,4284,92734,"2019-02-01",2019
"19-Feb",부산,부산진구,354,119737,12623,132714,"2019-02-01",2019
"19-Feb",부산,북구,240,100556,3309,104105,"2019-02-01",2019
"19-Feb",부산,사상구,283,84580,5989,90852,"2019-02-01",2019
"19-Feb",부산,사하구,265,108319,7106,115690,"2019-02-01",2019
"19-Feb",부산,서구,136,28443,1359,29938,"2019-02-01",2019
"19-Feb",부산,수영구,164,67906,22222,90292,"2019-02-01",2019
"19-Feb",부산,연제구,825,81435,7784,90044,"2019-02-01",2019
"19-Feb",부산,영도구,235,31487,2103,33825,"2019-02-01",2019
"19-Feb",부산,중구,309,23398,7153,30860,"2019-02-01",2019
"19-Feb",부산,해운대구,299,167935,10985,179219,"2019-02-01",2019
"19-Feb",부산,계,4599,1261554,111620,1377773,"2019-02-01",2019
"19-Feb",대구,남구,348,56090,1808,58246,"2019-02-01",2019
"19-Feb",대구,달서구,480,262072,12148,274700,"2019-02-01",2019
"19-Feb",대구,달성군,494,125688,4776,130958,"2019-02-01",2019
"19-Feb",대구,동구,350,151285,10343,161978,"2019-02-01",2019
"19-Feb",대구,북구,501,194007,7913,202421,"2019-02-01",2019
"19-Feb",대구,서구,237,72404,4232,76873,"2019-02-01",2019
"19-Feb",대구,수성구,549,211222,5347,217118,"2019-02-01",2019
"19-Feb",대구,중구,292,55537,1833,57662,"2019-02-01",2019
"19-Feb",대구,계,3251,1128305,48400,1179956,"2019-02-01",2019
"19-Feb",인천,강화군,314,32974,1251,34539,"2019-02-01",2019
"19-Feb",인천,계양구,279,121746,170526,292551,"2019-02-01",2019
"19-Feb",인천,남동구,842,252788,42189,295819,"2019-02-01",2019
"19-Feb",인천,동구,89,26472,2841,29402,"2019-02-01",2019
"19-Feb",인천,미추홀구,404,150405,55267,206076,"2019-02-01",2019
"19-Feb",인천,부평구,335,215248,10879,226462,"2019-02-01",2019
"19-Feb",인천,서구,389,229495,10931,240815,"2019-02-01",2019
"19-Feb",인천,연수구,379,168133,7683,176195,"2019-02-01",2019
"19-Feb",인천,옹진군,188,11690,211,12089,"2019-02-01",2019
"19-Feb",인천,중구,655,57397,17791,75843,"2019-02-01",2019
"19-Feb",인천,계,3874,1266348,319569,1589791,"2019-02-01",2019
"19-Feb",광주,광산구,500,183623,11779,195902,"2019-02-01",2019
"19-Feb",광주,남구,174,86782,2645,89601,"2019-02-01",2019
"19-Feb",광주,동구,238,36337,1116,37691,"2019-02-01",2019
"19-Feb",광주,북구,482,184068,10209,194759,"2019-02-01",2019
"19-Feb",광주,서구,716,140875,7114,148705,"2019-02-01",2019
"19-Feb",광주,계,2110,631685,32863,666658,"2019-02-01",2019
"19-Feb",대전,대덕구,232,84969,6772,91973,"2019-02-01",2019
"19-Feb",대전,동구,243,88676,4153,93072,"2019-02-01",2019
"19-Feb",대전,서구,784,202141,7537,210462,"2019-02-01",2019
"19-Feb",대전,유성구,375,167115,4969,172459,"2019-02-01",2019
"19-Feb",대전,중구,229,96276,5927,102432,"2019-02-01",2019
"19-Feb",대전,계,1863,639177,29358,670398,"2019-02-01",2019
"19-Feb",울산,남구,691,152364,7268,160323,"2019-02-01",2019
"19-Feb",울산,동구,195,62065,956,63216,"2019-02-01",2019
"19-Feb",울산,북구,176,102644,3832,106652,"2019-02-01",2019
"19-Feb",울산,울주군,374,117531,6438,124343,"2019-02-01",2019
"19-Feb",울산,중구,345,102023,2697,105065,"2019-02-01",2019
"19-Feb",울산,계,1781,536627,21191,559599,"2019-02-01",2019
"19-Feb",세종,세종특별자치시,682,147998,2710,151390,"2019-02-01",2019
"19-Feb",세종,계,682,147998,2710,151390,"2019-02-01",2019
"19-Feb",경기,가평군,355,29469,656,30480,"2019-02-01",2019
"19-Feb",경기,고양시 덕양구,662,161935,3837,166434,"2019-02-01",2019
"19-Feb",경기,고양시 일산동구,278,119160,7129,126567,"2019-02-01",2019
"19-Feb",경기,고양시 일산서구,130,109910,3993,114033,"2019-02-01",2019
"19-Feb",경기,과천시,705,20522,602,21829,"2019-02-01",2019
"19-Feb",경기,광명시,307,104268,4105,108680,"2019-02-01",2019
"19-Feb",경기,광주시,374,177093,8146,185613,"2019-02-01",2019
"19-Feb",경기,구리시,237,70081,2576,72894,"2019-02-01",2019
"19-Feb",경기,군포시,292,95751,5080,101123,"2019-02-01",2019
"19-Feb",경기,김포시,460,195879,7244,203583,"2019-02-01",2019
"19-Feb",경기,남양주시,652,272673,7537,280862,"2019-02-01",2019
"19-Feb",경기,동두천시,210,36928,1316,38454,"2019-02-01",2019
"19-Feb",경기,부천시,727,293132,12700,306559,"2019-02-01",2019
"19-Feb",경기,성남시 분당구,346,183797,7011,191154,"2019-02-01",2019
"19-Feb",경기,성남시 수정구,345,70561,2539,73445,"2019-02-01",2019
"19-Feb",경기,성남시 중원구,324,71445,4122,75891,"2019-02-01",2019
"19-Feb",경기,수원시 권선구,368,173928,7906,182202,"2019-02-01",2019
"19-Feb",경기,수원시 영통구,223,137396,3095,140714,"2019-02-01",2019
"19-Feb",경기,수원시 장안구,592,103956,3938,108486,"2019-02-01",2019
"19-Feb",경기,수원시 팔달구,483,68800,3167,72450,"2019-02-01",2019
"19-Feb",경기,시흥시,454,215490,7639,223583,"2019-02-01",2019
"19-Feb",경기,안산시 단원구,564,147644,8234,156442,"2019-02-01",2019
"19-Feb",경기,안산시 상록구,182,136439,4805,141426,"2019-02-01",2019
"19-Feb",경기,안성시,378,95731,5010,101119,"2019-02-01",2019
"19-Feb",경기,안양시 동안구,398,115851,6434,122683,"2019-02-01",2019
"19-Feb",경기,안양시 만안구,157,84250,3897,88304,"2019-02-01",2019
"19-Feb",경기,양주시,377,97064,3158,100599,"2019-02-01",2019
"19-Feb",경기,양평군,540,56492,1746,58778,"2019-02-01",2019
"19-Feb",경기,여주시,409,59843,7224,67476,"2019-02-01",2019
"19-Feb",경기,연천군,292,23056,5330,28678,"2019-02-01",2019
"19-Feb",경기,오산시,213,96651,3265,100129,"2019-02-01",2019
"19-Feb",경기,용인시 기흥구,117,178857,8339,187313,"2019-02-01",2019
"19-Feb",경기,용인시 수지구,45,133944,2233,136222,"2019-02-01",2019
"19-Feb",경기,용인시 처인구,694,122024,7135,129853,"2019-02-01",2019
"19-Feb",경기,의왕시,293,57859,3193,61345,"2019-02-01",2019
"19-Feb",경기,의정부시,620,150990,4947,156557,"2019-02-01",2019
"19-Feb",경기,이천시,406,106171,5765,112342,"2019-02-01",2019
"19-Feb",경기,파주시,480,198484,9605,208569,"2019-02-01",2019
"19-Feb",경기,평택시,693,248622,11673,260988,"2019-02-01",2019
"19-Feb",경기,포천시,355,82393,9544,92292,"2019-02-01",2019
"19-Feb",경기,하남시,368,103781,2509,106658,"2019-02-01",2019
"19-Feb",경기,화성시,847,387634,11559,400040,"2019-02-01",2019
"19-Feb",경기,계,16952,5395954,229943,5642849,"2019-02-01",2019
"19-Feb",강원,강릉시,503,102423,4542,107468,"2019-02-01",2019
"19-Feb",강원,고성군,179,13729,227,14135,"2019-02-01",2019
"19-Feb",강원,동해시,295,42953,1361,44609,"2019-02-01",2019
"19-Feb",강원,삼척시,362,31222,699,32283,"2019-02-01",2019
"19-Feb",강원,속초시,281,35519,1383,37183,"2019-02-01",2019
"19-Feb",강원,양구군,146,11687,122,11955,"2019-02-01",2019
"19-Feb",강원,양양군,178,14790,222,15190,"2019-02-01",2019
"19-Feb",강원,영월군,334,20244,364,20942,"2019-02-01",2019
"19-Feb",강원,원주시,540,161063,5912,167515,"2019-02-01",2019
"19-Feb",강원,인제군,202,17319,236,17757,"2019-02-01",2019
"19-Feb",강원,정선군,315,19932,451,20698,"2019-02-01",2019
"19-Feb",강원,철원군,216,23416,305,23937,"2019-02-01",2019
"19-Feb",강원,춘천시,772,125595,5824,132191,"2019-02-01",2019
"19-Feb",강원,태백시,213,20061,801,21075,"2019-02-01",2019
"19-Feb",강원,평창군,279,24991,461,25731,"2019-02-01",2019
"19-Feb",강원,홍천군,388,37129,1096,38613,"2019-02-01",2019
"19-Feb",강원,화천군,196,12332,198,12726,"2019-02-01",2019
"19-Feb",강원,횡성군,224,25000,683,25907,"2019-02-01",2019
"19-Feb",강원,계,5623,739405,24887,769915,"2019-02-01",2019
"19-Feb",충북,괴산군,190,21756,370,22316,"2019-02-01",2019
"19-Feb",충북,단양군,206,15454,788,16448,"2019-02-01",2019
"19-Feb",충북,보은군,204,17465,962,18631,"2019-02-01",2019
"19-Feb",충북,영동군,231,24431,381,25043,"2019-02-01",2019
"19-Feb",충북,옥천군,197,25840,1109,27146,"2019-02-01",2019
"19-Feb",충북,음성군,217,56255,1811,58283,"2019-02-01",2019
"19-Feb",충북,제천시,311,65070,3550,68931,"2019-02-01",2019
"19-Feb",충북,증평군,94,18198,733,19025,"2019-02-01",2019
"19-Feb",충북,진천군,209,44883,1267,46359,"2019-02-01",2019
"19-Feb",충북,청원군,1,19,0,20,"2019-02-01",2019
"19-Feb",충북,청주시 상당구,495,80238,2405,83138,"2019-02-01",2019
"19-Feb",충북,청주시 서원구,236,90843,5194,96273,"2019-02-01",2019
"19-Feb",충북,청주시 청원구,341,99503,4105,103949,"2019-02-01",2019
"19-Feb",충북,청주시 흥덕구,351,117864,7140,125355,"2019-02-01",2019
"19-Feb",충북,충주시,569,104249,4428,109246,"2019-02-01",2019
"19-Feb",충북,계,3852,782068,34243,820163,"2019-02-01",2019
"19-Feb",충남,계룡시,152,20999,528,21679,"2019-02-01",2019
"19-Feb",충남,공주시,533,52254,2101,54888,"2019-02-01",2019
"19-Feb",충남,금산군,181,27705,1985,29871,"2019-02-01",2019
"19-Feb",충남,논산시,366,59433,2282,62081,"2019-02-01",2019
"19-Feb",충남,당진시,372,90560,3784,94716,"2019-02-01",2019
"19-Feb",충남,보령시,388,50446,1298,52132,"2019-02-01",2019
"19-Feb",충남,부여군,270,33464,1300,35034,"2019-02-01",2019
"19-Feb",충남,서산시,391,89297,3504,93192,"2019-02-01",2019
"19-Feb",충남,서천군,230,26587,892,27709,"2019-02-01",2019
"19-Feb",충남,아산시,473,157033,6230,163736,"2019-02-01",2019
"19-Feb",충남,예산군,371,41785,1433,43589,"2019-02-01",2019
"19-Feb",충남,천안시 동남구,263,124714,4717,129694,"2019-02-01",2019
"19-Feb",충남,천안시 서북구,544,181396,5850,187790,"2019-02-01",2019
"19-Feb",충남,청양군,245,16438,866,17549,"2019-02-01",2019
"19-Feb",충남,태안군,282,32780,510,33572,"2019-02-01",2019
"19-Feb",충남,홍성군,408,50499,1420,52327,"2019-02-01",2019
"19-Feb",충남,계,5469,1055390,38700,1099559,"2019-02-01",2019
"19-Feb",전북,고창군,259,29799,596,30654,"2019-02-01",2019
"19-Feb",전북,군산시,510,126266,6695,133471,"2019-02-01",2019
"19-Feb",전북,김제시,294,43957,1972,46223,"2019-02-01",2019
"19-Feb",전북,남원시,415,39502,4002,43919,"2019-02-01",2019
"19-Feb",전북,무주군,188,12315,368,12871,"2019-02-01",2019
"19-Feb",전북,부안군,257,26915,621,27793,"2019-02-01",2019
"19-Feb",전북,순창군,206,14240,189,14635,"2019-02-01",2019
"19-Feb",전북,완주군,351,49902,3341,53594,"2019-02-01",2019
"19-Feb",전북,익산시,489,134719,6344,141552,"2019-02-01",2019
"19-Feb",전북,임실군,203,14273,425,14901,"2019-02-01",2019
"19-Feb",전북,장수군,223,11806,180,12209,"2019-02-01",2019
"19-Feb",전북,전주시 덕진구,404,158478,7460,166342,"2019-02-01",2019
"19-Feb",전북,전주시 완산구,589,146303,4051,150943,"2019-02-01",2019
"19-Feb",전북,정읍시,333,52743,3785,56861,"2019-02-01",2019
"19-Feb",전북,진안군,243,13592,201,14036,"2019-02-01",2019
"19-Feb",전북,계,4964,874810,40230,920004,"2019-02-01",2019
"19-Feb",전남,강진군,211,18020,1089,19320,"2019-02-01",2019
"19-Feb",전남,고흥군,294,30201,667,31162,"2019-02-01",2019
"19-Feb",전남,곡성군,148,14278,744,15170,"2019-02-01",2019
"19-Feb",전남,광양시,240,78277,5919,84436,"2019-02-01",2019
"19-Feb",전남,구례군,128,12935,620,13683,"2019-02-01",2019
"19-Feb",전남,나주시,448,60206,3324,63978,"2019-02-01",2019
"19-Feb",전남,담양군,197,25467,1539,27203,"2019-02-01",2019
"19-Feb",전남,목포시,452,93698,5884,100034,"2019-02-01",2019
"19-Feb",전남,무안군,529,41063,971,42563,"2019-02-01",2019
"19-Feb",전남,보성군,204,21001,62742,83947,"2019-02-01",2019
"19-Feb",전남,순천시,469,131259,5122,136850,"2019-02-01",2019
"19-Feb",전남,신안군,223,20294,858,21375,"2019-02-01",2019
"19-Feb",전남,여수시,538,124705,6886,132129,"2019-02-01",2019
"19-Feb",전남,영광군,214,26378,727,27319,"2019-02-01",2019
"19-Feb",전남,영암군,240,31657,13427,45324,"2019-02-01",2019
"19-Feb",전남,완도군,225,24187,501,24913,"2019-02-01",2019
"19-Feb",전남,장성군,168,25449,1091,26708,"2019-02-01",2019
"19-Feb",전남,장흥군,197,19374,448,20019,"2019-02-01",2019
"19-Feb",전남,진도군,151,16018,304,16473,"2019-02-01",2019
"19-Feb",전남,함평군,190,17496,13174,30860,"2019-02-01",2019
"19-Feb",전남,해남군,327,37668,588,38583,"2019-02-01",2019
"19-Feb",전남,화순군,219,31079,2020,33318,"2019-02-01",2019
"19-Feb",전남,계,6012,900710,128645,1035367,"2019-02-01",2019
"19-Feb",경북,경산시,319,131743,4357,136419,"2019-02-01",2019
"19-Feb",경북,경주시,575,136310,4631,141516,"2019-02-01",2019
"19-Feb",경북,고령군,157,20167,528,20852,"2019-02-01",2019
"19-Feb",경북,구미시,524,205458,7294,213276,"2019-02-01",2019
"19-Feb",경북,군위군,121,14246,278,14645,"2019-02-01",2019
"19-Feb",경북,김천시,375,70738,1839,72952,"2019-02-01",2019
"19-Feb",경북,문경시,306,34819,803,35928,"2019-02-01",2019
"19-Feb",경북,봉화군,193,17205,202,17600,"2019-02-01",2019
"19-Feb",경북,상주시,376,51327,1881,53584,"2019-02-01",2019
"19-Feb",경북,성주군,193,29301,1439,30933,"2019-02-01",2019
"19-Feb",경북,안동시,701,79288,2602,82591,"2019-02-01",2019
"19-Feb",경북,영덕군,249,18407,307,18963,"2019-02-01",2019
"19-Feb",경북,영양군,145,9239,102,9486,"2019-02-01",2019
"19-Feb",경북,영주시,350,54275,1515,56140,"2019-02-01",2019
"19-Feb",경북,영천시,283,56848,2690,59821,"2019-02-01",2019
"19-Feb",경북,예천군,222,27078,456,27756,"2019-02-01",2019
"19-Feb",경북,울릉군,146,5119,401,5666,"2019-02-01",2019
"19-Feb",경북,울진군,286,25116,362,25764,"2019-02-01",2019
"19-Feb",경북,의성군,302,29229,969,30500,"2019-02-01",2019
"19-Feb",경북,청도군,195,23995,658,24848,"2019-02-01",2019
"19-Feb",경북,청송군,198,14899,196,15293,"2019-02-01",2019
"19-Feb",경북,칠곡군,341,67299,2278,69918,"2019-02-01",2019
"19-Feb",경북,포항시 남구,395,119003,8795,128193,"2019-02-01",2019
"19-Feb",경북,포항시 북구,336,131061,3896,135293,"2019-02-01",2019
"19-Feb",경북,계,7288,1372170,48479,1427937,"2019-02-01",2019
"19-Feb",경남,거제시,346,102731,2203,105280,"2019-02-01",2019
"19-Feb",경남,거창군,253,30845,803,31901,"2019-02-01",2019
"19-Feb",경남,고성군,208,26069,636,26913,"2019-02-01",2019
"19-Feb",경남,김해시,640,258466,6976,266082,"2019-02-01",2019
"19-Feb",경남,남해군,251,18883,487,19621,"2019-02-01",2019
"19-Feb",경남,밀양시,307,53623,4034,57964,"2019-02-01",2019
"19-Feb",경남,사천시,313,54356,1518,56187,"2019-02-01",2019
"19-Feb",경남,산청군,226,19310,775,20311,"2019-02-01",2019
"19-Feb",경남,양산시,398,156882,9712,166992,"2019-02-01",2019
"19-Feb",경남,의령군,188,13825,675,14688,"2019-02-01",2019
"19-Feb",경남,진주시,598,157468,6652,164718,"2019-02-01",2019
"19-Feb",경남,창녕군,232,34582,950,35764,"2019-02-01",2019
"19-Feb",경남,창원시 마산합포구,330,98513,2986,101829,"2019-02-01",2019
"19-Feb",경남,창원시 마산회원구,170,93953,5278,99401,"2019-02-01",2019
"19-Feb",경남,창원시 성산구,146,117413,14871,132430,"2019-02-01",2019
"19-Feb",경남,창원시 의창구,895,128089,6246,135230,"2019-02-01",2019
"19-Feb",경남,창원시 진해구,205,87043,1657,88905,"2019-02-01",2019
"19-Feb",경남,통영시,311,51857,1527,53695,"2019-02-01",2019
"19-Feb",경남,하동군,217,23994,457,24668,"2019-02-01",2019
"19-Feb",경남,함안군,196,40518,11627,52341,"2019-02-01",2019
"19-Feb",경남,함양군,192,18654,393,19239,"2019-02-01",2019
"19-Feb",경남,합천군,250,22433,650,23333,"2019-02-01",2019
"19-Feb",경남,계,6872,1609507,81113,1697492,"2019-02-01",2019
"19-Feb",제주,서귀포시,751,101258,2050,104059,"2019-02-01",2019
"19-Feb",제주,제주시,1533,267420,186863,455816,"2019-02-01",2019
"19-Feb",제주,계,2284,368678,188913,559875,"2019-02-01",2019
"19-Mar",서울,강남구,375,215188,19063,234626,"2019-03-01",2019
"19-Mar",서울,강동구,265,126213,8857,135335,"2019-03-01",2019
"19-Mar",서울,강북구,310,72075,4720,77105,"2019-03-01",2019
"19-Mar",서울,강서구,324,185362,18051,203737,"2019-03-01",2019
"19-Mar",서울,관악구,304,115071,5593,120968,"2019-03-01",2019
"19-Mar",서울,광진구,283,94191,5528,100002,"2019-03-01",2019
"19-Mar",서울,구로구,287,129817,14628,144732,"2019-03-01",2019
"19-Mar",서울,금천구,128,81332,5876,87336,"2019-03-01",2019
"19-Mar",서울,노원구,304,144042,9244,153590,"2019-03-01",2019
"19-Mar",서울,도봉구,259,89399,7581,97239,"2019-03-01",2019
"19-Mar",서울,동대문구,314,92519,5370,98203,"2019-03-01",2019
"19-Mar",서울,동작구,312,103206,2794,106312,"2019-03-01",2019
"19-Mar",서울,마포구,330,110511,6958,117799,"2019-03-01",2019
"19-Mar",서울,서대문구,449,81356,5733,87538,"2019-03-01",2019
"19-Mar",서울,서초구,560,168089,13522,182171,"2019-03-01",2019
"19-Mar",서울,성동구,313,94960,9860,105133,"2019-03-01",2019
"19-Mar",서울,성북구,293,111614,5486,117393,"2019-03-01",2019
"19-Mar",서울,송파구,382,226969,13207,240558,"2019-03-01",2019
"19-Mar",서울,양천구,319,141532,8534,150385,"2019-03-01",2019
"19-Mar",서울,영등포구,368,133495,9286,143149,"2019-03-01",2019
"19-Mar",서울,용산구,359,74775,2183,77317,"2019-03-01",2019
"19-Mar",서울,은평구,280,123181,7014,130475,"2019-03-01",2019
"19-Mar",서울,종로구,3681,44971,1680,50332,"2019-03-01",2019
"19-Mar",서울,중구,1155,45872,4749,51776,"2019-03-01",2019
"19-Mar",서울,중랑구,218,104085,9722,114025,"2019-03-01",2019
"19-Mar",서울,계,12172,2909825,205239,3127236,"2019-03-01",2019
"19-Mar",부산,강서구,321,69524,3825,73670,"2019-03-01",2019
"19-Mar",부산,금정구,278,81510,7405,89193,"2019-03-01",2019
"19-Mar",부산,기장군,255,71299,2234,73788,"2019-03-01",2019
"19-Mar",부산,남구,227,91374,8499,100100,"2019-03-01",2019
"19-Mar",부산,동구,233,46183,4557,50973,"2019-03-01",2019
"19-Mar",부산,동래구,178,88612,4252,93042,"2019-03-01",2019
"19-Mar",부산,부산진구,354,119313,13223,132890,"2019-03-01",2019
"19-Mar",부산,북구,241,100316,3303,103860,"2019-03-01",2019
"19-Mar",부산,사상구,282,84412,6003,90697,"2019-03-01",2019
"19-Mar",부산,사하구,263,108183,7097,115543,"2019-03-01",2019
"19-Mar",부산,서구,135,28385,1360,29880,"2019-03-01",2019
"19-Mar",부산,수영구,164,67655,22968,90787,"2019-03-01",2019
"19-Mar",부산,연제구,815,81389,7919,90123,"2019-03-01",2019
"19-Mar",부산,영도구,231,31476,2098,33805,"2019-03-01",2019
"19-Mar",부산,중구,310,23543,7203,31056,"2019-03-01",2019
"19-Mar",부산,해운대구,306,168048,11290,179644,"2019-03-01",2019
"19-Mar",부산,계,4593,1261222,113236,1379051,"2019-03-01",2019
"19-Mar",대구,남구,343,55960,1763,58066,"2019-03-01",2019
"19-Mar",대구,달서구,572,262387,12194,275153,"2019-03-01",2019
"19-Mar",대구,달성군,497,126288,4790,131575,"2019-03-01",2019
"19-Mar",대구,동구,351,151113,10562,162026,"2019-03-01",2019
"19-Mar",대구,북구,498,194010,7913,202421,"2019-03-01",2019
"19-Mar",대구,서구,237,72106,4197,76540,"2019-03-01",2019
"19-Mar",대구,수성구,561,211883,5331,217775,"2019-03-01",2019
"19-Mar",대구,중구,291,55779,1851,57921,"2019-03-01",2019
"19-Mar",대구,계,3350,1129526,48601,1181477,"2019-03-01",2019
"19-Mar",인천,강화군,314,33028,1247,34589,"2019-03-01",2019
"19-Mar",인천,계양구,279,121634,171680,293593,"2019-03-01",2019
"19-Mar",인천,남동구,830,252593,42488,295911,"2019-03-01",2019
"19-Mar",인천,동구,90,26392,2924,29406,"2019-03-01",2019
"19-Mar",인천,미추홀구,407,150371,54034,204812,"2019-03-01",2019
"19-Mar",인천,부평구,333,215035,11320,226688,"2019-03-01",2019
"19-Mar",인천,서구,392,229901,10912,241205,"2019-03-01",2019
"19-Mar",인천,연수구,382,168898,7706,176986,"2019-03-01",2019
"19-Mar",인천,옹진군,189,11701,218,12108,"2019-03-01",2019
"19-Mar",인천,중구,632,58135,18049,76816,"2019-03-01",2019
"19-Mar",인천,계,3848,1267688,320578,1592114,"2019-03-01",2019
"19-Mar",광주,광산구,505,184619,11892,197016,"2019-03-01",2019
"19-Mar",광주,남구,216,87153,2657,90026,"2019-03-01",2019
"19-Mar",광주,동구,240,36329,1119,37688,"2019-03-01",2019
"19-Mar",광주,북구,481,184388,10160,195029,"2019-03-01",2019
"19-Mar",광주,서구,720,140533,7115,148368,"2019-03-01",2019
"19-Mar",광주,계,2162,633022,32943,668127,"2019-03-01",2019
"19-Mar",대전,대덕구,232,84917,6772,91921,"2019-03-01",2019
"19-Mar",대전,동구,245,88920,4189,93354,"2019-03-01",2019
"19-Mar",대전,서구,778,202254,7481,210513,"2019-03-01",2019
"19-Mar",대전,유성구,373,167294,5013,172680,"2019-03-01",2019
"19-Mar",대전,중구,231,96357,5914,102502,"2019-03-01",2019
"19-Mar",대전,계,1859,639742,29369,670970,"2019-03-01",2019
"19-Mar",울산,남구,704,152233,7246,160183,"2019-03-01",2019
"19-Mar",울산,동구,194,61903,956,63053,"2019-03-01",2019
"19-Mar",울산,북구,178,103514,3828,107520,"2019-03-01",2019
"19-Mar",울산,울주군,371,118022,6468,124861,"2019-03-01",2019
"19-Mar",울산,중구,345,101795,2679,104819,"2019-03-01",2019
"19-Mar",울산,계,1792,537467,21177,560436,"2019-03-01",2019
"19-Mar",세종,세종특별자치시,719,149600,2722,153041,"2019-03-01",2019
"19-Mar",세종,계,719,149600,2722,153041,"2019-03-01",2019
"19-Mar",경기,가평군,361,29574,662,30597,"2019-03-01",2019
"19-Mar",경기,고양시 덕양구,662,161953,3847,166462,"2019-03-01",2019
"19-Mar",경기,고양시 일산동구,277,118915,7015,126207,"2019-03-01",2019
"19-Mar",경기,고양시 일산서구,135,110147,3983,114265,"2019-03-01",2019
"19-Mar",경기,과천시,722,20523,598,21843,"2019-03-01",2019
"19-Mar",경기,광명시,319,103833,4124,108276,"2019-03-01",2019
"19-Mar",경기,광주시,369,177437,8080,185886,"2019-03-01",2019
"19-Mar",경기,구리시,239,70090,2592,72921,"2019-03-01",2019
"19-Mar",경기,군포시,286,95431,5083,100800,"2019-03-01",2019
"19-Mar",경기,김포시,455,195674,7227,203356,"2019-03-01",2019
"19-Mar",경기,남양주시,652,273278,7543,281473,"2019-03-01",2019
"19-Mar",경기,동두천시,212,36735,1309,38256,"2019-03-01",2019
"19-Mar",경기,부천시,717,292023,12830,305570,"2019-03-01",2019
"19-Mar",경기,성남시 분당구,344,183509,7176,191029,"2019-03-01",2019
"19-Mar",경기,성남시 수정구,341,70477,2432,73250,"2019-03-01",2019
"19-Mar",경기,성남시 중원구,319,71376,4101,75796,"2019-03-01",2019
"19-Mar",경기,수원시 권선구,360,172431,7896,180687,"2019-03-01",2019
"19-Mar",경기,수원시 영통구,215,137891,3106,141212,"2019-03-01",2019
"19-Mar",경기,수원시 장안구,585,103503,3841,107929,"2019-03-01",2019
"19-Mar",경기,수원시 팔달구,485,68337,3128,71950,"2019-03-01",2019
"19-Mar",경기,시흥시,452,216761,7631,224844,"2019-03-01",2019
"19-Mar",경기,안산시 단원구,555,147624,8280,156459,"2019-03-01",2019
"19-Mar",경기,안산시 상록구,175,136456,4787,141418,"2019-03-01",2019
"19-Mar",경기,안성시,376,95869,5014,101259,"2019-03-01",2019
"19-Mar",경기,안양시 동안구,394,115706,6426,122526,"2019-03-01",2019
"19-Mar",경기,안양시 만안구,151,84138,3895,88184,"2019-03-01",2019
"19-Mar",경기,양주시,378,97504,3115,100997,"2019-03-01",2019
"19-Mar",경기,양평군,539,56591,1743,58873,"2019-03-01",2019
"19-Mar",경기,여주시,397,59834,7291,67522,"2019-03-01",2019
"19-Mar",경기,연천군,292,23099,5342,28733,"2019-03-01",2019
"19-Mar",경기,오산시,206,96818,3268,100292,"2019-03-01",2019
"19-Mar",경기,용인시 기흥구,114,178562,8439,187115,"2019-03-01",2019
"19-Mar",경기,용인시 수지구,45,133941,2239,136225,"2019-03-01",2019
"19-Mar",경기,용인시 처인구,702,122175,7127,130004,"2019-03-01",2019
"19-Mar",경기,의왕시,294,58557,3179,62030,"2019-03-01",2019
"19-Mar",경기,의정부시,621,151306,4938,156865,"2019-03-01",2019
"19-Mar",경기,이천시,403,106188,5756,112347,"2019-03-01",2019
"19-Mar",경기,파주시,489,198962,9511,208962,"2019-03-01",2019
"19-Mar",경기,평택시,692,249841,11665,262198,"2019-03-01",2019
"19-Mar",경기,포천시,356,81949,10374,92679,"2019-03-01",2019
"19-Mar",경기,하남시,373,104807,2525,107705,"2019-03-01",2019
"19-Mar",경기,화성시,850,391213,11567,403630,"2019-03-01",2019
"19-Mar",경기,계,16909,5401038,230685,5648632,"2019-03-01",2019
"19-Mar",강원,강릉시,506,102311,4569,107386,"2019-03-01",2019
"19-Mar",강원,고성군,182,13708,228,14118,"2019-03-01",2019
"19-Mar",강원,동해시,293,42899,1361,44553,"2019-03-01",2019
"19-Mar",강원,삼척시,369,31260,707,32336,"2019-03-01",2019
"19-Mar",강원,속초시,287,35583,1373,37243,"2019-03-01",2019
"19-Mar",강원,양구군,146,11748,123,12017,"2019-03-01",2019
"19-Mar",강원,양양군,175,14731,221,15127,"2019-03-01",2019
"19-Mar",강원,영월군,335,20298,367,21000,"2019-03-01",2019
"19-Mar",강원,원주시,536,161135,5899,167570,"2019-03-01",2019
"19-Mar",강원,인제군,204,17338,236,17778,"2019-03-01",2019
"19-Mar",강원,정선군,315,20015,452,20782,"2019-03-01",2019
"19-Mar",강원,철원군,216,23394,308,23918,"2019-03-01",2019
"19-Mar",강원,춘천시,778,125538,5815,132131,"2019-03-01",2019
"19-Mar",강원,태백시,217,20034,792,21043,"2019-03-01",2019
"19-Mar",강원,평창군,282,24979,461,25722,"2019-03-01",2019
"19-Mar",강원,홍천군,389,37214,1095,38698,"2019-03-01",2019
"19-Mar",강원,화천군,197,12351,198,12746,"2019-03-01",2019
"19-Mar",강원,횡성군,239,25073,670,25982,"2019-03-01",2019
"19-Mar",강원,계,5666,739609,24875,770150,"2019-03-01",2019
"19-Mar",충북,괴산군,191,21658,376,22225,"2019-03-01",2019
"19-Mar",충북,단양군,206,15479,786,16471,"2019-03-01",2019
"19-Mar",충북,보은군,202,17532,966,18700,"2019-03-01",2019
"19-Mar",충북,영동군,226,24384,382,24992,"2019-03-01",2019
"19-Mar",충북,옥천군,199,25808,1110,27117,"2019-03-01",2019
"19-Mar",충북,음성군,218,56363,1809,58390,"2019-03-01",2019
"19-Mar",충북,제천시,316,64983,3551,68850,"2019-03-01",2019
"19-Mar",충북,증평군,92,18182,736,19010,"2019-03-01",2019
"19-Mar",충북,진천군,210,45220,1275,46705,"2019-03-01",2019
"19-Mar",충북,청원군,1,19,0,20,"2019-03-01",2019
"19-Mar",충북,청주시 상당구,497,80430,2424,83351,"2019-03-01",2019
"19-Mar",충북,청주시 서원구,235,90739,5174,96148,"2019-03-01",2019
"19-Mar",충북,청주시 청원구,343,99610,4128,104081,"2019-03-01",2019
"19-Mar",충북,청주시 흥덕구,351,118072,7174,125597,"2019-03-01",2019
"19-Mar",충북,충주시,571,104033,4608,109212,"2019-03-01",2019
"19-Mar",충북,계,3858,782512,34499,820869,"2019-03-01",2019
"19-Mar",충남,계룡시,152,21098,535,21785,"2019-03-01",2019
"19-Mar",충남,공주시,547,52235,2141,54923,"2019-03-01",2019
"19-Mar",충남,금산군,182,27760,2003,29945,"2019-03-01",2019
"19-Mar",충남,논산시,365,59503,2286,62154,"2019-03-01",2019
"19-Mar",충남,당진시,375,90851,3812,95038,"2019-03-01",2019
"19-Mar",충남,보령시,391,50594,1300,52285,"2019-03-01",2019
"19-Mar",충남,부여군,273,33543,1298,35114,"2019-03-01",2019
"19-Mar",충남,서산시,399,89393,3497,93289,"2019-03-01",2019
"19-Mar",충남,서천군,232,26530,898,27660,"2019-03-01",2019
"19-Mar",충남,아산시,475,157418,6222,164115,"2019-03-01",2019
"19-Mar",충남,예산군,374,41717,1434,43525,"2019-03-01",2019
"19-Mar",충남,천안시 동남구,263,124835,4718,129816,"2019-03-01",2019
"19-Mar",충남,천안시 서북구,543,181998,5845,188386,"2019-03-01",2019
"19-Mar",충남,청양군,251,16441,854,17546,"2019-03-01",2019
"19-Mar",충남,태안군,280,32809,509,33598,"2019-03-01",2019
"19-Mar",충남,홍성군,414,50582,1424,52420,"2019-03-01",2019
"19-Mar",충남,계,5516,1057307,38776,1101599,"2019-03-01",2019
"19-Mar",전북,고창군,260,29643,588,30491,"2019-03-01",2019
"19-Mar",전북,군산시,513,126229,6663,133405,"2019-03-01",2019
"19-Mar",전북,김제시,293,43921,1981,46195,"2019-03-01",2019
"19-Mar",전북,남원시,415,39597,4705,44717,"2019-03-01",2019
"19-Mar",전북,무주군,192,12356,372,12920,"2019-03-01",2019
"19-Mar",전북,부안군,258,27011,614,27883,"2019-03-01",2019
"19-Mar",전북,순창군,208,14229,192,14629,"2019-03-01",2019
"19-Mar",전북,완주군,351,49741,3333,53425,"2019-03-01",2019
"19-Mar",전북,익산시,492,134564,6358,141414,"2019-03-01",2019
"19-Mar",전북,임실군,200,14152,424,14776,"2019-03-01",2019
"19-Mar",전북,장수군,222,11766,179,12167,"2019-03-01",2019
"19-Mar",전북,전주시 덕진구,399,159276,7481,167156,"2019-03-01",2019
"19-Mar",전북,전주시 완산구,588,145881,4072,150541,"2019-03-01",2019
"19-Mar",전북,정읍시,338,52667,3742,56747,"2019-03-01",2019
"19-Mar",전북,진안군,238,13679,201,14118,"2019-03-01",2019
"19-Mar",전북,계,4967,874712,40905,920584,"2019-03-01",2019
"19-Mar",전남,강진군,212,17995,1091,19298,"2019-03-01",2019
"19-Mar",전남,고흥군,296,30254,663,31213,"2019-03-01",2019
"19-Mar",전남,곡성군,147,14282,738,15167,"2019-03-01",2019
"19-Mar",전남,광양시,246,78082,5900,84228,"2019-03-01",2019
"19-Mar",전남,구례군,131,12932,629,13692,"2019-03-01",2019
"19-Mar",전남,나주시,452,60476,3314,64242,"2019-03-01",2019
"19-Mar",전남,담양군,207,25546,1543,27296,"2019-03-01",2019
"19-Mar",전남,목포시,447,93761,5853,100061,"2019-03-01",2019
"19-Mar",전남,무안군,537,41194,965,42696,"2019-03-01",2019
"19-Mar",전남,보성군,203,20934,61179,82316,"2019-03-01",2019
"19-Mar",전남,순천시,473,131410,5128,137011,"2019-03-01",2019
"19-Mar",전남,신안군,224,20196,851,21271,"2019-03-01",2019
"19-Mar",전남,여수시,546,124990,6883,132419,"2019-03-01",2019
"19-Mar",전남,영광군,214,26454,731,27399,"2019-03-01",2019
"19-Mar",전남,영암군,242,31667,13188,45097,"2019-03-01",2019
"19-Mar",전남,완도군,229,24281,504,25014,"2019-03-01",2019
"19-Mar",전남,장성군,172,25438,1098,26708,"2019-03-01",2019
"19-Mar",전남,장흥군,195,19435,452,20082,"2019-03-01",2019
"19-Mar",전남,진도군,152,15992,303,16447,"2019-03-01",2019
"19-Mar",전남,함평군,189,17490,15787,33466,"2019-03-01",2019
"19-Mar",전남,해남군,331,37724,586,38641,"2019-03-01",2019
"19-Mar",전남,화순군,220,31055,2034,33309,"2019-03-01",2019
"19-Mar",전남,계,6065,901588,129420,1037073,"2019-03-01",2019
"19-Mar",경북,경산시,315,131707,4376,136398,"2019-03-01",2019
"19-Mar",경북,경주시,569,136309,4626,141504,"2019-03-01",2019
"19-Mar",경북,고령군,157,20185,530,20872,"2019-03-01",2019
"19-Mar",경북,구미시,515,205826,7267,213608,"2019-03-01",2019
"19-Mar",경북,군위군,119,14255,279,14653,"2019-03-01",2019
"19-Mar",경북,김천시,374,70966,1839,73179,"2019-03-01",2019
"19-Mar",경북,문경시,307,34877,805,35989,"2019-03-01",2019
"19-Mar",경북,봉화군,193,17254,205,17652,"2019-03-01",2019
"19-Mar",경북,상주시,370,51377,1881,53628,"2019-03-01",2019
"19-Mar",경북,성주군,193,29247,1439,30879,"2019-03-01",2019
"19-Mar",경북,안동시,697,79151,2592,82440,"2019-03-01",2019
"19-Mar",경북,영덕군,245,18384,302,18931,"2019-03-01",2019
"19-Mar",경북,영양군,144,9241,102,9487,"2019-03-01",2019
"19-Mar",경북,영주시,348,54228,1512,56088,"2019-03-01",2019
"19-Mar",경북,영천시,281,57000,2678,59959,"2019-03-01",2019
"19-Mar",경북,예천군,225,27304,458,27987,"2019-03-01",2019
"19-Mar",경북,울릉군,145,5130,459,5734,"2019-03-01",2019
"19-Mar",경북,울진군,287,25153,355,25795,"2019-03-01",2019
"19-Mar",경북,의성군,295,29330,964,30589,"2019-03-01",2019
"19-Mar",경북,청도군,197,23962,658,24817,"2019-03-01",2019
"19-Mar",경북,청송군,198,14843,196,15237,"2019-03-01",2019
"19-Mar",경북,칠곡군,331,67409,2289,70029,"2019-03-01",2019
"19-Mar",경북,포항시 남구,384,119333,8778,128495,"2019-03-01",2019
"19-Mar",경북,포항시 북구,328,131492,3900,135720,"2019-03-01",2019
"19-Mar",경북,계,7217,1373963,48490,1429670,"2019-03-01",2019
"19-Mar",경남,거제시,347,102707,2165,105219,"2019-03-01",2019
"19-Mar",경남,거창군,253,30821,804,31878,"2019-03-01",2019
"19-Mar",경남,고성군,210,26057,630,26897,"2019-03-01",2019
"19-Mar",경남,김해시,641,259237,7014,266892,"2019-03-01",2019
"19-Mar",경남,남해군,259,18916,489,19664,"2019-03-01",2019
"19-Mar",경남,밀양시,311,53663,3999,57973,"2019-03-01",2019
"19-Mar",경남,사천시,311,54378,1528,56217,"2019-03-01",2019
"19-Mar",경남,산청군,231,19315,776,20322,"2019-03-01",2019
"19-Mar",경남,양산시,397,157072,9743,167212,"2019-03-01",2019
"19-Mar",경남,의령군,189,13826,675,14690,"2019-03-01",2019
"19-Mar",경남,진주시,596,157896,6678,165170,"2019-03-01",2019
"19-Mar",경남,창녕군,232,34572,947,35751,"2019-03-01",2019
"19-Mar",경남,창원시 마산합포구,331,98285,2974,101590,"2019-03-01",2019
"19-Mar",경남,창원시 마산회원구,173,93668,5278,99119,"2019-03-01",2019
"19-Mar",경남,창원시 성산구,145,117125,14579,131849,"2019-03-01",2019
"19-Mar",경남,창원시 의창구,899,128052,6130,135081,"2019-03-01",2019
"19-Mar",경남,창원시 진해구,205,87140,1656,89001,"2019-03-01",2019
"19-Mar",경남,통영시,312,51840,1526,53678,"2019-03-01",2019
"19-Mar",경남,하동군,219,23920,456,24595,"2019-03-01",2019
"19-Mar",경남,함안군,197,40426,11748,52371,"2019-03-01",2019
"19-Mar",경남,함양군,193,18655,426,19274,"2019-03-01",2019
"19-Mar",경남,합천군,251,22433,649,23333,"2019-03-01",2019
"19-Mar",경남,계,6902,1610004,80870,1697776,"2019-03-01",2019
"19-Mar",제주,서귀포시,756,101660,2046,104462,"2019-03-01",2019
"19-Mar",제주,제주시,1556,267418,190033,459007,"2019-03-01",2019
"19-Mar",제주,계,2312,369078,192079,563469,"2019-03-01",2019
"19-Apr",서울,강남구,373,215134,18819,234326,"2019-04-01",2019
"19-Apr",서울,강동구,266,125906,8846,135018,"2019-04-01",2019
"19-Apr",서울,강북구,311,71819,4719,76849,"2019-04-01",2019
"19-Apr",서울,강서구,331,185036,18070,203437,"2019-04-01",2019
"19-Apr",서울,관악구,301,114888,5608,120797,"2019-04-01",2019
"19-Apr",서울,광진구,282,93977,5501,99760,"2019-04-01",2019
"19-Apr",서울,구로구,285,129685,14431,144401,"2019-04-01",2019
"19-Apr",서울,금천구,128,81447,5872,87447,"2019-04-01",2019
"19-Apr",서울,노원구,306,143547,9244,153097,"2019-04-01",2019
"19-Apr",서울,도봉구,261,89241,7592,97094,"2019-04-01",2019
"19-Apr",서울,동대문구,313,92331,5390,98034,"2019-04-01",2019
"19-Apr",서울,동작구,311,103149,2794,106254,"2019-04-01",2019
"19-Apr",서울,마포구,331,110386,6948,117665,"2019-04-01",2019
"19-Apr",서울,서대문구,448,81245,5928,87621,"2019-04-01",2019
"19-Apr",서울,서초구,561,168123,13488,182172,"2019-04-01",2019
"19-Apr",서울,성동구,317,94722,10382,105421,"2019-04-01",2019
"19-Apr",서울,성북구,293,111991,5483,117767,"2019-04-01",2019
"19-Apr",서울,송파구,386,227382,13200,240968,"2019-04-01",2019
"19-Apr",서울,양천구,320,141393,8616,150329,"2019-04-01",2019
"19-Apr",서울,영등포구,366,133115,9252,142733,"2019-04-01",2019
"19-Apr",서울,용산구,360,74626,2154,77140,"2019-04-01",2019
"19-Apr",서울,은평구,285,123097,7104,130486,"2019-04-01",2019
"19-Apr",서울,종로구,3676,44843,1667,50186,"2019-04-01",2019
"19-Apr",서울,중구,1159,45786,4758,51703,"2019-04-01",2019
"19-Apr",서울,중랑구,223,103705,9656,113584,"2019-04-01",2019
"19-Apr",서울,계,12193,2906574,205522,3124289,"2019-04-01",2019
"19-Apr",부산,강서구,317,69792,3846,73955,"2019-04-01",2019
"19-Apr",부산,금정구,282,81461,7420,89163,"2019-04-01",2019
"19-Apr",부산,기장군,255,71403,2229,73887,"2019-04-01",2019
"19-Apr",부산,남구,228,91304,8484,100016,"2019-04-01",2019
"19-Apr",부산,동구,235,44807,4495,49537,"2019-04-01",2019
"19-Apr",부산,동래구,179,88825,4251,93255,"2019-04-01",2019
"19-Apr",부산,부산진구,364,119114,13726,133204,"2019-04-01",2019
"19-Apr",부산,북구,240,100204,3296,103740,"2019-04-01",2019
"19-Apr",부산,사상구,284,84218,5991,90493,"2019-04-01",2019
"19-Apr",부산,사하구,265,107981,7088,115334,"2019-04-01",2019
"19-Apr",부산,서구,135,28336,1364,29835,"2019-04-01",2019
"19-Apr",부산,수영구,169,67492,23770,91431,"2019-04-01",2019
"19-Apr",부산,연제구,821,87047,8055,95923,"2019-04-01",2019
"19-Apr",부산,영도구,229,31380,2100,33709,"2019-04-01",2019
"19-Apr",부산,중구,309,23796,7219,31324,"2019-04-01",2019
"19-Apr",부산,해운대구,314,162722,11643,174679,"2019-04-01",2019
"19-Apr",부산,계,4626,1259882,114977,1379485,"2019-04-01",2019
"19-Apr",대구,남구,341,55811,1748,57900,"2019-04-01",2019
"19-Apr",대구,달서구,485,262491,12143,275119,"2019-04-01",2019
"19-Apr",대구,달성군,496,126505,4792,131793,"2019-04-01",2019
"19-Apr",대구,동구,345,150853,10589,161787,"2019-04-01",2019
"19-Apr",대구,북구,494,193922,7888,202304,"2019-04-01",2019
"19-Apr",대구,서구,231,71756,4235,76222,"2019-04-01",2019
"19-Apr",대구,수성구,559,211804,5267,217630,"2019-04-01",2019
"19-Apr",대구,중구,288,54022,1843,56153,"2019-04-01",2019
"19-Apr",대구,계,3239,1127164,48505,1178908,"2019-04-01",2019
"19-Apr",인천,강화군,320,33054,1265,34639,"2019-04-01",2019
"19-Apr",인천,계양구,282,121321,173351,294954,"2019-04-01",2019
"19-Apr",인천,남동구,833,252300,42651,295784,"2019-04-01",2019
"19-Apr",인천,동구,89,26404,3001,29494,"2019-04-01",2019
"19-Apr",인천,미추홀구,411,150708,54085,205204,"2019-04-01",2019
"19-Apr",인천,부평구,333,214905,11710,226948,"2019-04-01",2019
"19-Apr",인천,서구,389,230223,10956,241568,"2019-04-01",2019
"19-Apr",인천,연수구,393,170067,7563,178023,"2019-04-01",2019
"19-Apr",인천,옹진군,192,11699,216,12107,"2019-04-01",2019
"19-Apr",인천,중구,629,58572,18181,77382,"2019-04-01",2019
"19-Apr",인천,계,3871,1269253,322979,1596103,"2019-04-01",2019
"19-Apr",광주,광산구,510,185151,11859,197520,"2019-04-01",2019
"19-Apr",광주,남구,218,87344,2583,90145,"2019-04-01",2019
"19-Apr",광주,동구,239,36605,1135,37979,"2019-04-01",2019
"19-Apr",광주,북구,600,184193,10045,194838,"2019-04-01",2019
"19-Apr",광주,서구,605,140340,7137,148082,"2019-04-01",2019
"19-Apr",광주,계,2172,633633,32759,668564,"2019-04-01",2019
"19-Apr",대전,대덕구,230,84782,6849,91861,"2019-04-01",2019
"19-Apr",대전,동구,248,89073,4207,93528,"2019-04-01",2019
"19-Apr",대전,서구,789,202146,7316,210251,"2019-04-01",2019
"19-Apr",대전,유성구,371,167489,5137,172997,"2019-04-01",2019
"19-Apr",대전,중구,232,96416,5887,102535,"2019-04-01",2019
"19-Apr",대전,계,1870,639906,29396,671172,"2019-04-01",2019
"19-Apr",울산,남구,708,152055,7228,159991,"2019-04-01",2019
"19-Apr",울산,동구,194,61826,962,62982,"2019-04-01",2019
"19-Apr",울산,북구,178,104505,3811,108494,"2019-04-01",2019
"19-Apr",울산,울주군,370,118364,6527,125261,"2019-04-01",2019
"19-Apr",울산,중구,346,101465,2689,104500,"2019-04-01",2019
"19-Apr",울산,계,1796,538215,21217,561228,"2019-04-01",2019
"19-Apr",세종,세종특별자치시,722,150593,2722,154037,"2019-04-01",2019
"19-Apr",세종,계,722,150593,2722,154037,"2019-04-01",2019
"19-Apr",경기,가평군,361,29566,668,30595,"2019-04-01",2019
"19-Apr",경기,고양시 덕양구,674,162443,3852,166969,"2019-04-01",2019
"19-Apr",경기,고양시 일산동구,277,118319,6845,125441,"2019-04-01",2019
"19-Apr",경기,고양시 일산서구,136,110831,4006,114973,"2019-04-01",2019
"19-Apr",경기,과천시,726,20549,597,21872,"2019-04-01",2019
"19-Apr",경기,광명시,311,103585,4137,108033,"2019-04-01",2019
"19-Apr",경기,광주시,369,178198,8119,186686,"2019-04-01",2019
"19-Apr",경기,구리시,240,70055,2569,72864,"2019-04-01",2019
"19-Apr",경기,군포시,288,95266,5064,100618,"2019-04-01",2019
"19-Apr",경기,김포시,462,196415,7082,203959,"2019-04-01",2019
"19-Apr",경기,남양주시,661,274391,7609,282661,"2019-04-01",2019
"19-Apr",경기,동두천시,211,36622,1303,38136,"2019-04-01",2019
"19-Apr",경기,부천시,716,291738,12832,305286,"2019-04-01",2019
"19-Apr",경기,성남시 분당구,340,183209,7063,190612,"2019-04-01",2019
"19-Apr",경기,성남시 수정구,343,70436,2364,73143,"2019-04-01",2019
"19-Apr",경기,성남시 중원구,318,71185,4167,75670,"2019-04-01",2019
"19-Apr",경기,수원시 권선구,362,172051,7894,180307,"2019-04-01",2019
"19-Apr",경기,수원시 영통구,213,138630,3104,141947,"2019-04-01",2019
"19-Apr",경기,수원시 장안구,582,103163,3858,107603,"2019-04-01",2019
"19-Apr",경기,수원시 팔달구,482,68176,3079,71737,"2019-04-01",2019
"19-Apr",경기,시흥시,459,217772,7653,225884,"2019-04-01",2019
"19-Apr",경기,안산시 단원구,555,147445,8183,156183,"2019-04-01",2019
"19-Apr",경기,안산시 상록구,177,136168,4805,141150,"2019-04-01",2019
"19-Apr",경기,안성시,378,95945,5021,101344,"2019-04-01",2019
"19-Apr",경기,안양시 동안구,394,115747,6434,122575,"2019-04-01",2019
"19-Apr",경기,안양시 만안구,151,84055,3900,88106,"2019-04-01",2019
"19-Apr",경기,양주시,372,97899,3096,101367,"2019-04-01",2019
"19-Apr",경기,양평군,541,56799,1744,59084,"2019-04-01",2019
"19-Apr",경기,여주시,403,60025,7309,67737,"2019-04-01",2019
"19-Apr",경기,연천군,299,23119,5330,28748,"2019-04-01",2019
"19-Apr",경기,오산시,205,96568,3289,100062,"2019-04-01",2019
"19-Apr",경기,용인시 기흥구,114,179208,8347,187669,"2019-04-01",2019
"19-Apr",경기,용인시 수지구,45,134168,2270,136483,"2019-04-01",2019
"19-Apr",경기,용인시 처인구,703,122740,7069,130512,"2019-04-01",2019
"19-Apr",경기,의왕시,296,58975,3161,62432,"2019-04-01",2019
"19-Apr",경기,의정부시,632,151455,4912,156999,"2019-04-01",2019
"19-Apr",경기,이천시,400,106398,5772,112570,"2019-04-01",2019
"19-Apr",경기,파주시,498,199420,9462,209380,"2019-04-01",2019
"19-Apr",경기,평택시,699,250552,11746,262997,"2019-04-01",2019
"19-Apr",경기,포천시,365,81792,10159,92316,"2019-04-01",2019
"19-Apr",경기,하남시,381,105417,2536,108334,"2019-04-01",2019
"19-Apr",경기,화성시,866,393868,11626,406360,"2019-04-01",2019
"19-Apr",경기,계,17005,5410363,230036,5657404,"2019-04-01",2019
"19-Apr",강원,강릉시,506,102530,4621,107657,"2019-04-01",2019
"19-Apr",강원,고성군,180,13735,228,14143,"2019-04-01",2019
"19-Apr",강원,동해시,299,43002,1357,44658,"2019-04-01",2019
"19-Apr",강원,삼척시,373,31334,696,32403,"2019-04-01",2019
"19-Apr",강원,속초시,293,35661,1377,37331,"2019-04-01",2019
"19-Apr",강원,양구군,147,11762,123,12032,"2019-04-01",2019
"19-Apr",강원,양양군,173,14765,223,15161,"2019-04-01",2019
"19-Apr",강원,영월군,330,20330,368,21028,"2019-04-01",2019
"19-Apr",강원,원주시,536,161448,5894,167878,"2019-04-01",2019
"19-Apr",강원,인제군,203,17411,299,17913,"2019-04-01",2019
"19-Apr",강원,정선군,321,19974,448,20743,"2019-04-01",2019
"19-Apr",강원,철원군,219,23407,309,23935,"2019-04-01",2019
"19-Apr",강원,춘천시,790,125623,5839,132252,"2019-04-01",2019
"19-Apr",강원,태백시,224,20018,780,21022,"2019-04-01",2019
"19-Apr",강원,평창군,285,25055,462,25802,"2019-04-01",2019
"19-Apr",강원,홍천군,389,37162,1099,38650,"2019-04-01",2019
"19-Apr",강원,화천군,197,12411,198,12806,"2019-04-01",2019
"19-Apr",강원,횡성군,241,25099,670,26010,"2019-04-01",2019
"19-Apr",강원,계,5706,740727,24991,771424,"2019-04-01",2019
"19-Apr",충북,괴산군,195,21669,375,22239,"2019-04-01",2019
"19-Apr",충북,단양군,207,15498,777,16482,"2019-04-01",2019
"19-Apr",충북,보은군,206,17482,900,18588,"2019-04-01",2019
"19-Apr",충북,영동군,233,24405,382,25020,"2019-04-01",2019
"19-Apr",충북,옥천군,201,25833,1120,27154,"2019-04-01",2019
"19-Apr",충북,음성군,220,56324,1808,58352,"2019-04-01",2019
"19-Apr",충북,제천시,317,65110,3546,68973,"2019-04-01",2019
"19-Apr",충북,증평군,94,18378,737,19209,"2019-04-01",2019
"19-Apr",충북,진천군,210,45380,1303,46893,"2019-04-01",2019
"19-Apr",충북,청원군,1,19,0,20,"2019-04-01",2019
"19-Apr",충북,청주시 상당구,500,80761,2427,83688,"2019-04-01",2019
"19-Apr",충북,청주시 서원구,228,93717,5167,99112,"2019-04-01",2019
"19-Apr",충북,청주시 청원구,350,99645,4082,104077,"2019-04-01",2019
"19-Apr",충북,청주시 흥덕구,356,118245,7196,125797,"2019-04-01",2019
"19-Apr",충북,충주시,572,104305,4860,109737,"2019-04-01",2019
"19-Apr",충북,계,3890,786771,34680,825341,"2019-04-01",2019
"19-Apr",충남,계룡시,153,21070,533,21756,"2019-04-01",2019
"19-Apr",충남,공주시,541,52360,2166,55067,"2019-04-01",2019
"19-Apr",충남,금산군,183,27721,2017,29921,"2019-04-01",2019
"19-Apr",충남,논산시,370,59652,2288,62310,"2019-04-01",2019
"19-Apr",충남,당진시,375,91000,3818,95193,"2019-04-01",2019
"19-Apr",충남,보령시,389,50500,1299,52188,"2019-04-01",2019
"19-Apr",충남,부여군,273,33465,1278,35016,"2019-04-01",2019
"19-Apr",충남,서산시,399,89598,3485,93482,"2019-04-01",2019
"19-Apr",충남,서천군,229,26552,895,27676,"2019-04-01",2019
"19-Apr",충남,아산시,471,157675,6175,164321,"2019-04-01",2019
"19-Apr",충남,예산군,384,41860,1440,43684,"2019-04-01",2019
"19-Apr",충남,천안시 동남구,261,125009,4734,130004,"2019-04-01",2019
"19-Apr",충남,천안시 서북구,536,182352,5805,188693,"2019-04-01",2019
"19-Apr",충남,청양군,254,16415,847,17516,"2019-04-01",2019
"19-Apr",충남,태안군,280,32872,505,33657,"2019-04-01",2019
"19-Apr",충남,홍성군,410,50670,1421,52501,"2019-04-01",2019
"19-Apr",충남,계,5508,1058771,38706,1102985,"2019-04-01",2019
"19-Apr",전북,고창군,263,29686,589,30538,"2019-04-01",2019
"19-Apr",전북,군산시,516,126504,6628,133648,"2019-04-01",2019
"19-Apr",전북,김제시,292,44017,1967,46276,"2019-04-01",2019
"19-Apr",전북,남원시,414,39588,4576,44578,"2019-04-01",2019
"19-Apr",전북,무주군,190,12370,373,12933,"2019-04-01",2019
"19-Apr",전북,부안군,260,26961,617,27838,"2019-04-01",2019
"19-Apr",전북,순창군,204,14239,196,14639,"2019-04-01",2019
"19-Apr",전북,완주군,350,49778,3328,53456,"2019-04-01",2019
"19-Apr",전북,익산시,486,134629,6284,141399,"2019-04-01",2019
"19-Apr",전북,임실군,202,14141,423,14766,"2019-04-01",2019
"19-Apr",전북,장수군,225,11757,176,12158,"2019-04-01",2019
"19-Apr",전북,전주시 덕진구,392,160220,7571,168183,"2019-04-01",2019
"19-Apr",전북,전주시 완산구,584,145675,4062,150321,"2019-04-01",2019
"19-Apr",전북,정읍시,332,52708,3782,56822,"2019-04-01",2019
"19-Apr",전북,진안군,231,13610,200,14041,"2019-04-01",2019
"19-Apr",전북,계,4941,875883,40772,921596,"2019-04-01",2019
"19-Apr",전남,강진군,214,18001,1095,19310,"2019-04-01",2019
"19-Apr",전남,고흥군,301,30347,664,31312,"2019-04-01",2019
"19-Apr",전남,곡성군,154,14317,747,15218,"2019-04-01",2019
"19-Apr",전남,광양시,248,78147,5910,84305,"2019-04-01",2019
"19-Apr",전남,구례군,132,12979,632,13743,"2019-04-01",2019
"19-Apr",전남,나주시,451,60721,3287,64459,"2019-04-01",2019
"19-Apr",전남,담양군,208,25611,1539,27358,"2019-04-01",2019
"19-Apr",전남,목포시,442,93815,5873,100130,"2019-04-01",2019
"19-Apr",전남,무안군,551,41150,975,42676,"2019-04-01",2019
"19-Apr",전남,보성군,203,20920,59700,80823,"2019-04-01",2019
"19-Apr",전남,순천시,483,131635,5129,137247,"2019-04-01",2019
"19-Apr",전남,신안군,234,20262,850,21346,"2019-04-01",2019
"19-Apr",전남,여수시,549,125331,6920,132800,"2019-04-01",2019
"19-Apr",전남,영광군,211,26471,724,27406,"2019-04-01",2019
"19-Apr",전남,영암군,245,31707,13056,45008,"2019-04-01",2019
"19-Apr",전남,완도군,230,24343,509,25082,"2019-04-01",2019
"19-Apr",전남,장성군,174,25567,1112,26853,"2019-04-01",2019
"19-Apr",전남,장흥군,198,19459,449,20106,"2019-04-01",2019
"19-Apr",전남,진도군,155,16014,304,16473,"2019-04-01",2019
"19-Apr",전남,함평군,191,17452,17923,35566,"2019-04-01",2019
"19-Apr",전남,해남군,332,37786,583,38701,"2019-04-01",2019
"19-Apr",전남,화순군,219,31092,2033,33344,"2019-04-01",2019
"19-Apr",전남,계,6125,903127,130014,1039266,"2019-04-01",2019
"19-Apr",경북,경산시,314,131805,4423,136542,"2019-04-01",2019
"19-Apr",경북,경주시,571,136520,4668,141759,"2019-04-01",2019
"19-Apr",경북,고령군,157,20182,528,20867,"2019-04-01",2019
"19-Apr",경북,구미시,526,205854,7257,213637,"2019-04-01",2019
"19-Apr",경북,군위군,119,14274,275,14668,"2019-04-01",2019
"19-Apr",경북,김천시,375,71113,1846,73334,"2019-04-01",2019
"19-Apr",경북,문경시,312,34950,802,36064,"2019-04-01",2019
"19-Apr",경북,봉화군,196,17281,207,17684,"2019-04-01",2019
"19-Apr",경북,상주시,369,51398,1878,53645,"2019-04-01",2019
"19-Apr",경북,성주군,195,29347,1434,30976,"2019-04-01",2019
"19-Apr",경북,안동시,703,79195,2598,82496,"2019-04-01",2019
"19-Apr",경북,영덕군,248,18389,296,18933,"2019-04-01",2019
"19-Apr",경북,영양군,146,9281,102,9529,"2019-04-01",2019
"19-Apr",경북,영주시,345,54257,1505,56107,"2019-04-01",2019
"19-Apr",경북,영천시,291,57054,2680,60025,"2019-04-01",2019
"19-Apr",경북,예천군,228,27500,455,28183,"2019-04-01",2019
"19-Apr",경북,울릉군,146,5179,515,5840,"2019-04-01",2019
"19-Apr",경북,울진군,294,25115,350,25759,"2019-04-01",2019
"19-Apr",경북,의성군,296,29278,952,30526,"2019-04-01",2019
"19-Apr",경북,청도군,200,24071,656,24927,"2019-04-01",2019
"19-Apr",경북,청송군,199,14890,198,15287,"2019-04-01",2019
"19-Apr",경북,칠곡군,334,67389,2294,70017,"2019-04-01",2019
"19-Apr",경북,포항시 남구,388,119091,8745,128224,"2019-04-01",2019
"19-Apr",경북,포항시 북구,329,131527,3936,135792,"2019-04-01",2019
"19-Apr",경북,계,7281,1374940,48600,1430821,"2019-04-01",2019
"19-Apr",경남,거제시,349,102794,2158,105301,"2019-04-01",2019
"19-Apr",경남,거창군,252,30883,802,31937,"2019-04-01",2019
"19-Apr",경남,고성군,222,26060,631,26913,"2019-04-01",2019
"19-Apr",경남,김해시,646,260170,7013,267829,"2019-04-01",2019
"19-Apr",경남,남해군,256,18933,489,19678,"2019-04-01",2019
"19-Apr",경남,밀양시,312,53757,3902,57971,"2019-04-01",2019
"19-Apr",경남,사천시,307,54361,1543,56211,"2019-04-01",2019
"19-Apr",경남,산청군,233,19320,785,20338,"2019-04-01",2019
"19-Apr",경남,양산시,399,157190,9868,167457,"2019-04-01",2019
"19-Apr",경남,의령군,189,13854,674,14717,"2019-04-01",2019
"19-Apr",경남,진주시,602,158185,6673,165460,"2019-04-01",2019
"19-Apr",경남,창녕군,232,34570,955,35757,"2019-04-01",2019
"19-Apr",경남,창원시 마산합포구,335,98384,2980,101699,"2019-04-01",2019
"19-Apr",경남,창원시 마산회원구,172,93527,5248,98947,"2019-04-01",2019
"19-Apr",경남,창원시 성산구,146,116982,14220,131348,"2019-04-01",2019
"19-Apr",경남,창원시 의창구,913,128332,7220,136465,"2019-04-01",2019
"19-Apr",경남,창원시 진해구,209,87228,1659,89096,"2019-04-01",2019
"19-Apr",경남,통영시,316,51826,1531,53673,"2019-04-01",2019
"19-Apr",경남,하동군,219,23991,457,24667,"2019-04-01",2019
"19-Apr",경남,함안군,197,40324,11870,52391,"2019-04-01",2019
"19-Apr",경남,함양군,199,18700,445,19344,"2019-04-01",2019
"19-Apr",경남,합천군,257,22462,646,23365,"2019-04-01",2019
"19-Apr",경남,계,6962,1611833,81769,1700564,"2019-04-01",2019
"19-Apr",제주,서귀포시,762,101569,2030,104361,"2019-04-01",2019
"19-Apr",제주,제주시,1557,266592,193613,461762,"2019-04-01",2019
"19-Apr",제주,계,2319,368161,195643,566123,"2019-04-01",2019
"19-May",서울,강남구,374,215201,18638,234213,"2019-05-01",2019
"19-May",서울,강동구,268,125774,8988,135030,"2019-05-01",2019
"19-May",서울,강북구,316,71659,4718,76693,"2019-05-01",2019
"19-May",서울,강서구,337,185086,18277,203700,"2019-05-01",2019
"19-May",서울,관악구,303,114807,5615,120725,"2019-05-01",2019
"19-May",서울,광진구,289,93821,5477,99587,"2019-05-01",2019
"19-May",서울,구로구,287,129553,14112,143952,"2019-05-01",2019
"19-May",서울,금천구,129,81364,5854,87347,"2019-05-01",2019
"19-May",서울,노원구,318,143405,9152,152875,"2019-05-01",2019
"19-May",서울,도봉구,265,89229,7626,97120,"2019-05-01",2019
"19-May",서울,동대문구,317,92286,5377,97980,"2019-05-01",2019
"19-May",서울,동작구,315,103053,2792,106160,"2019-05-01",2019
"19-May",서울,마포구,334,110323,6999,117656,"2019-05-01",2019
"19-May",서울,서대문구,451,81182,5944,87577,"2019-05-01",2019
"19-May",서울,서초구,560,167451,13597,181608,"2019-05-01",2019
"19-May",서울,성동구,321,94639,10388,105348,"2019-05-01",2019
"19-May",서울,성북구,289,112118,5474,117881,"2019-05-01",2019
"19-May",서울,송파구,386,227321,13083,240790,"2019-05-01",2019
"19-May",서울,양천구,323,141067,8580,149970,"2019-05-01",2019
"19-May",서울,영등포구,366,133284,9122,142772,"2019-05-01",2019
"19-May",서울,용산구,363,74519,2162,77044,"2019-05-01",2019
"19-May",서울,은평구,289,122922,7115,130326,"2019-05-01",2019
"19-May",서울,종로구,3867,44704,1670,50241,"2019-05-01",2019
"19-May",서울,중구,1161,45745,4894,51800,"2019-05-01",2019
"19-May",서울,중랑구,232,103556,9624,113412,"2019-05-01",2019
"19-May",서울,계,12460,2904069,205278,3121807,"2019-05-01",2019
"19-May",부산,강서구,320,70073,3823,74216,"2019-05-01",2019
"19-May",부산,금정구,282,81435,7470,89187,"2019-05-01",2019
"19-May",부산,기장군,256,71555,2265,74076,"2019-05-01",2019
"19-May",부산,남구,236,91485,8498,100219,"2019-05-01",2019
"19-May",부산,동구,240,44908,4516,49664,"2019-05-01",2019
"19-May",부산,동래구,182,88818,4292,93292,"2019-05-01",2019
"19-May",부산,부산진구,374,119047,14054,133475,"2019-05-01",2019
"19-May",부산,북구,242,100155,3283,103680,"2019-05-01",2019
"19-May",부산,사상구,287,84333,6005,90625,"2019-05-01",2019
"19-May",부산,사하구,265,107896,7084,115245,"2019-05-01",2019
"19-May",부산,서구,141,28257,1360,29758,"2019-05-01",2019
"19-May",부산,수영구,170,67166,24459,91795,"2019-05-01",2019
"19-May",부산,연제구,832,87284,8178,96294,"2019-05-01",2019
"19-May",부산,영도구,231,31309,2087,33627,"2019-05-01",2019
"19-May",부산,중구,311,23924,7262,31497,"2019-05-01",2019
"19-May",부산,해운대구,325,162633,12077,175035,"2019-05-01",2019
"19-May",부산,계,4694,1260278,116713,1381685,"2019-05-01",2019
"19-May",대구,남구,346,55629,1755,57730,"2019-05-01",2019
"19-May",대구,달서구,489,262612,12245,275346,"2019-05-01",2019
"19-May",대구,달성군,505,126697,4784,131986,"2019-05-01",2019
"19-May",대구,동구,349,150874,10528,161751,"2019-05-01",2019
"19-May",대구,북구,502,194611,7843,202956,"2019-05-01",2019
"19-May",대구,서구,236,71545,4206,75987,"2019-05-01",2019
"19-May",대구,수성구,573,211792,5299,217664,"2019-05-01",2019
"19-May",대구,중구,291,54034,1849,56174,"2019-05-01",2019
"19-May",대구,계,3291,1127794,48509,1179594,"2019-05-01",2019
"19-May",인천,강화군,316,33130,45113,78559,"2019-05-01",2019
"19-May",인천,계양구,284,121047,177615,298946,"2019-05-01",2019
"19-May",인천,남동구,833,251644,42692,295169,"2019-05-01",2019
"19-May",인천,동구,89,26245,3089,29423,"2019-05-01",2019
"19-May",인천,미추홀구,410,151064,10682,162156,"2019-05-01",2019
"19-May",인천,부평구,337,214851,11950,227138,"2019-05-01",2019
"19-May",인천,서구,397,230797,10942,242136,"2019-05-01",2019
"19-May",인천,연수구,394,170978,7625,178997,"2019-05-01",2019
"19-May",인천,옹진군,196,11670,206,12072,"2019-05-01",2019
"19-May",인천,중구,665,59166,18238,78069,"2019-05-01",2019
"19-May",인천,계,3921,1270592,328152,1602665,"2019-05-01",2019
"19-May",광주,광산구,508,185875,11865,198248,"2019-05-01",2019
"19-May",광주,남구,217,87496,2577,90290,"2019-05-01",2019
"19-May",광주,동구,243,36849,1137,38229,"2019-05-01",2019
"19-May",광주,북구,600,184058,10009,194667,"2019-05-01",2019
"19-May",광주,서구,614,140286,7155,148055,"2019-05-01",2019
"19-May",광주,계,2182,634564,32743,669489,"2019-05-01",2019
"19-May",대전,대덕구,236,84621,6871,91728,"2019-05-01",2019
"19-May",대전,동구,249,88921,4288,93458,"2019-05-01",2019
"19-May",대전,서구,793,201911,7308,210012,"2019-05-01",2019
"19-May",대전,유성구,381,167571,5075,173027,"2019-05-01",2019
"19-May",대전,중구,239,96578,5887,102704,"2019-05-01",2019
"19-May",대전,계,1898,639602,29429,670929,"2019-05-01",2019
"19-May",울산,남구,710,151873,7279,159862,"2019-05-01",2019
"19-May",울산,동구,194,61784,957,62935,"2019-05-01",2019
"19-May",울산,북구,180,105087,3771,109038,"2019-05-01",2019
"19-May",울산,울주군,371,118472,6586,125429,"2019-05-01",2019
"19-May",울산,중구,345,101134,2675,104154,"2019-05-01",2019
"19-May",울산,계,1800,538350,21268,561418,"2019-05-01",2019
"19-May",세종,세종특별자치시,726,151475,2710,154911,"2019-05-01",2019
"19-May",세종,계,726,151475,2710,154911,"2019-05-01",2019
"19-May",경기,가평군,367,29705,665,30737,"2019-05-01",2019
"19-May",경기,고양시 덕양구,693,162933,3861,167487,"2019-05-01",2019
"19-May",경기,고양시 일산동구,279,118298,6718,125295,"2019-05-01",2019
"19-May",경기,고양시 일산서구,133,111569,4040,115742,"2019-05-01",2019
"19-May",경기,과천시,720,20551,596,21867,"2019-05-01",2019
"19-May",경기,광명시,310,103435,4111,107856,"2019-05-01",2019
"19-May",경기,광주시,363,178778,8106,187247,"2019-05-01",2019
"19-May",경기,구리시,238,70009,2567,72814,"2019-05-01",2019
"19-May",경기,군포시,293,95321,5068,100682,"2019-05-01",2019
"19-May",경기,김포시,468,197352,7084,204904,"2019-05-01",2019
"19-May",경기,남양주시,666,275452,7578,283696,"2019-05-01",2019
"19-May",경기,동두천시,208,36644,1307,38159,"2019-05-01",2019
"19-May",경기,부천시,720,292425,12930,306075,"2019-05-01",2019
"19-May",경기,성남시 분당구,341,183072,7023,190436,"2019-05-01",2019
"19-May",경기,성남시 수정구,342,70601,2394,73337,"2019-05-01",2019
"19-May",경기,성남시 중원구,318,71125,4164,75607,"2019-05-01",2019
"19-May",경기,수원시 권선구,360,172368,7877,180605,"2019-05-01",2019
"19-May",경기,수원시 영통구,212,139262,3164,142638,"2019-05-01",2019
"19-May",경기,수원시 장안구,586,103037,3817,107440,"2019-05-01",2019
"19-May",경기,수원시 팔달구,484,68316,3023,71823,"2019-05-01",2019
"19-May",경기,시흥시,455,219126,7675,227256,"2019-05-01",2019
"19-May",경기,안산시 단원구,558,147745,8119,156422,"2019-05-01",2019
"19-May",경기,안산시 상록구,174,136116,4791,141081,"2019-05-01",2019
"19-May",경기,안성시,382,96139,5019,101540,"2019-05-01",2019
"19-May",경기,안양시 동안구,393,115920,6360,122673,"2019-05-01",2019
"19-May",경기,안양시 만안구,149,83918,3960,88027,"2019-05-01",2019
"19-May",경기,양주시,375,98426,3089,101890,"2019-05-01",2019
"19-May",경기,양평군,546,57085,1754,59385,"2019-05-01",2019
"19-May",경기,여주시,418,60187,7320,67925,"2019-05-01",2019
"19-May",경기,연천군,302,23145,5311,28758,"2019-05-01",2019
"19-May",경기,오산시,203,96687,3291,100181,"2019-05-01",2019
"19-May",경기,용인시 기흥구,122,180719,8207,189048,"2019-05-01",2019
"19-May",경기,용인시 수지구,46,134371,2279,136696,"2019-05-01",2019
"19-May",경기,용인시 처인구,701,123242,7067,131010,"2019-05-01",2019
"19-May",경기,의왕시,300,59478,3134,62912,"2019-05-01",2019
"19-May",경기,의정부시,634,151739,4886,157259,"2019-05-01",2019
"19-May",경기,이천시,403,106626,5763,112792,"2019-05-01",2019
"19-May",경기,파주시,510,199956,9485,209951,"2019-05-01",2019
"19-May",경기,평택시,700,251587,11662,263949,"2019-05-01",2019
"19-May",경기,포천시,385,81884,9956,92225,"2019-05-01",2019
"19-May",경기,하남시,385,105980,2580,108945,"2019-05-01",2019
"19-May",경기,화성시,877,396650,11098,408625,"2019-05-01",2019
"19-May",경기,계,17119,5426979,228899,5672997,"2019-05-01",2019
"19-May",강원,강릉시,508,102740,4613,107861,"2019-05-01",2019
"19-May",강원,고성군,179,13676,230,14085,"2019-05-01",2019
"19-May",강원,동해시,298,43066,1366,44730,"2019-05-01",2019
"19-May",강원,삼척시,381,31389,690,32460,"2019-05-01",2019
"19-May",강원,속초시,293,35879,1366,37538,"2019-05-01",2019
"19-May",강원,양구군,152,11790,122,12064,"2019-05-01",2019
"19-May",강원,양양군,176,14863,223,15262,"2019-05-01",2019
"19-May",강원,영월군,330,20389,359,21078,"2019-05-01",2019
"19-May",강원,원주시,539,161975,5885,168399,"2019-05-01",2019
"19-May",강원,인제군,207,17437,300,17944,"2019-05-01",2019
"19-May",강원,정선군,325,19970,448,20743,"2019-05-01",2019
"19-May",강원,철원군,222,23448,307,23977,"2019-05-01",2019
"19-May",강원,춘천시,798,125877,5859,132534,"2019-05-01",2019
"19-May",강원,태백시,225,20008,781,21014,"2019-05-01",2019
"19-May",강원,평창군,282,25091,464,25837,"2019-05-01",2019
"19-May",강원,홍천군,391,37245,1098,38734,"2019-05-01",2019
"19-May",강원,화천군,200,12447,198,12845,"2019-05-01",2019
"19-May",강원,횡성군,246,25169,669,26084,"2019-05-01",2019
"19-May",강원,계,5752,742459,24978,773189,"2019-05-01",2019
"19-May",충북,괴산군,196,21691,374,22261,"2019-05-01",2019
"19-May",충북,단양군,211,15557,788,16556,"2019-05-01",2019
"19-May",충북,보은군,210,17511,892,18613,"2019-05-01",2019
"19-May",충북,영동군,232,24408,385,25025,"2019-05-01",2019
"19-May",충북,옥천군,204,25841,1119,27164,"2019-05-01",2019
"19-May",충북,음성군,221,56452,1819,58492,"2019-05-01",2019
"19-May",충북,제천시,321,65250,3523,69094,"2019-05-01",2019
"19-May",충북,증평군,95,18511,736,19342,"2019-05-01",2019
"19-May",충북,진천군,209,45580,1302,47091,"2019-05-01",2019
"19-May",충북,청원군,1,19,0,20,"2019-05-01",2019
"19-May",충북,청주시 상당구,506,80788,2443,83737,"2019-05-01",2019
"19-May",충북,청주시 서원구,226,93661,5151,99038,"2019-05-01",2019
"19-May",충북,청주시 청원구,349,99810,4058,104217,"2019-05-01",2019
"19-May",충북,청주시 흥덕구,358,118745,7198,126301,"2019-05-01",2019
"19-May",충북,충주시,577,104637,4865,110079,"2019-05-01",2019
"19-May",충북,계,3916,788461,34653,827030,"2019-05-01",2019
"19-May",충남,계룡시,152,21161,535,21848,"2019-05-01",2019
"19-May",충남,공주시,546,52467,2162,55175,"2019-05-01",2019
"19-May",충남,금산군,183,27669,2023,29875,"2019-05-01",2019
"19-May",충남,논산시,373,59697,2282,62352,"2019-05-01",2019
"19-May",충남,당진시,378,91120,3827,95325,"2019-05-01",2019
"19-May",충남,보령시,394,50546,1301,52241,"2019-05-01",2019
"19-May",충남,부여군,272,33502,1278,35052,"2019-05-01",2019
"19-May",충남,서산시,398,89848,3482,93728,"2019-05-01",2019
"19-May",충남,서천군,229,26607,892,27728,"2019-05-01",2019
"19-May",충남,아산시,478,158144,6129,164751,"2019-05-01",2019
"19-May",충남,예산군,389,41871,1443,43703,"2019-05-01",2019
"19-May",충남,천안시 동남구,259,125119,4735,130113,"2019-05-01",2019
"19-May",충남,천안시 서북구,537,182842,5841,189220,"2019-05-01",2019
"19-May",충남,청양군,257,16450,855,17562,"2019-05-01",2019
"19-May",충남,태안군,286,32911,502,33699,"2019-05-01",2019
"19-May",충남,홍성군,413,50837,1418,52668,"2019-05-01",2019
"19-May",충남,계,5544,1060791,38705,1105040,"2019-05-01",2019
"19-May",전북,고창군,260,29760,593,30613,"2019-05-01",2019
"19-May",전북,군산시,517,126585,6586,133688,"2019-05-01",2019
"19-May",전북,김제시,289,44143,1966,46398,"2019-05-01",2019
"19-May",전북,남원시,413,39559,5492,45464,"2019-05-01",2019
"19-May",전북,무주군,191,12382,376,12949,"2019-05-01",2019
"19-May",전북,부안군,261,26970,614,27845,"2019-05-01",2019
"19-May",전북,순창군,202,14234,195,14631,"2019-05-01",2019
"19-May",전북,완주군,346,49767,3306,53419,"2019-05-01",2019
"19-May",전북,익산시,496,134682,6277,141455,"2019-05-01",2019
"19-May",전북,임실군,201,14169,422,14792,"2019-05-01",2019
"19-May",전북,장수군,228,11786,178,12192,"2019-05-01",2019
"19-May",전북,전주시 덕진구,395,160984,7572,168951,"2019-05-01",2019
"19-May",전북,전주시 완산구,582,145687,4076,150345,"2019-05-01",2019
"19-May",전북,정읍시,337,52801,3800,56938,"2019-05-01",2019
"19-May",전북,진안군,231,13652,201,14084,"2019-05-01",2019
"19-May",전북,계,4949,877161,41654,923764,"2019-05-01",2019
"19-May",전남,강진군,215,17984,1108,19307,"2019-05-01",2019
"19-May",전남,고흥군,300,30484,663,31447,"2019-05-01",2019
"19-May",전남,곡성군,156,14333,744,15233,"2019-05-01",2019
"19-May",전남,광양시,251,78329,5929,84509,"2019-05-01",2019
"19-May",전남,구례군,137,12931,634,13702,"2019-05-01",2019
"19-May",전남,나주시,452,60859,3282,64593,"2019-05-01",2019
"19-May",전남,담양군,208,25574,1539,27321,"2019-05-01",2019
"19-May",전남,목포시,442,93954,5795,100191,"2019-05-01",2019
"19-May",전남,무안군,553,41176,978,42707,"2019-05-01",2019
"19-May",전남,보성군,201,20940,58342,79483,"2019-05-01",2019
"19-May",전남,순천시,484,131922,5148,137554,"2019-05-01",2019
"19-May",전남,신안군,243,20288,852,21383,"2019-05-01",2019
"19-May",전남,여수시,545,125753,6909,133207,"2019-05-01",2019
"19-May",전남,영광군,208,26546,722,27476,"2019-05-01",2019
"19-May",전남,영암군,247,31757,12906,44910,"2019-05-01",2019
"19-May",전남,완도군,230,24406,508,25144,"2019-05-01",2019
"19-May",전남,장성군,176,25573,1115,26864,"2019-05-01",2019
"19-May",전남,장흥군,200,19556,451,20207,"2019-05-01",2019
"19-May",전남,진도군,156,16044,302,16502,"2019-05-01",2019
"19-May",전남,함평군,192,17504,19431,37127,"2019-05-01",2019
"19-May",전남,해남군,333,37855,586,38774,"2019-05-01",2019
"19-May",전남,화순군,219,31151,2038,33408,"2019-05-01",2019
"19-May",전남,계,6148,904919,129982,1041049,"2019-05-01",2019
"19-May",경북,경산시,310,132121,4425,136856,"2019-05-01",2019
"19-May",경북,경주시,575,136678,4662,141915,"2019-05-01",2019
"19-May",경북,고령군,164,20179,529,20872,"2019-05-01",2019
"19-May",경북,구미시,528,206220,7271,214019,"2019-05-01",2019
"19-May",경북,군위군,121,14267,277,14665,"2019-05-01",2019
"19-May",경북,김천시,384,71302,1845,73531,"2019-05-01",2019
"19-May",경북,문경시,319,35028,803,36150,"2019-05-01",2019
"19-May",경북,봉화군,210,17255,208,17673,"2019-05-01",2019
"19-May",경북,상주시,374,51411,1869,53654,"2019-05-01",2019
"19-May",경북,성주군,195,29380,1419,30994,"2019-05-01",2019
"19-May",경북,안동시,710,79352,2598,82660,"2019-05-01",2019
"19-May",경북,영덕군,252,18410,286,18948,"2019-05-01",2019
"19-May",경북,영양군,143,9297,103,9543,"2019-05-01",2019
"19-May",경북,영주시,354,54234,1502,56090,"2019-05-01",2019
"19-May",경북,영천시,295,57312,2653,60260,"2019-05-01",2019
"19-May",경북,예천군,228,27634,461,28323,"2019-05-01",2019
"19-May",경북,울릉군,147,5220,521,5888,"2019-05-01",2019
"19-May",경북,울진군,295,25166,349,25810,"2019-05-01",2019
"19-May",경북,의성군,298,29299,950,30547,"2019-05-01",2019
"19-May",경북,청도군,200,24141,665,25006,"2019-05-01",2019
"19-May",경북,청송군,201,14947,201,15349,"2019-05-01",2019
"19-May",경북,칠곡군,333,67378,2291,70002,"2019-05-01",2019
"19-May",경북,포항시 남구,391,119158,8778,128327,"2019-05-01",2019
"19-May",경북,포항시 북구,325,131786,3913,136024,"2019-05-01",2019
"19-May",경북,계,7352,1377175,48579,1433106,"2019-05-01",2019
"19-May",경남,거제시,348,102880,2156,105384,"2019-05-01",2019
"19-May",경남,거창군,256,30948,795,31999,"2019-05-01",2019
"19-May",경남,고성군,224,26058,633,26915,"2019-05-01",2019
"19-May",경남,김해시,645,261091,7071,268807,"2019-05-01",2019
"19-May",경남,남해군,257,18998,485,19740,"2019-05-01",2019
"19-May",경남,밀양시,316,53844,3912,58072,"2019-05-01",2019
"19-May",경남,사천시,307,54448,1529,56284,"2019-05-01",2019
"19-May",경남,산청군,230,19370,790,20390,"2019-05-01",2019
"19-May",경남,양산시,400,157516,9783,167699,"2019-05-01",2019
"19-May",경남,의령군,190,13857,677,14724,"2019-05-01",2019
"19-May",경남,진주시,601,158583,6716,165900,"2019-05-01",2019
"19-May",경남,창녕군,235,34636,954,35825,"2019-05-01",2019
"19-May",경남,창원시 마산합포구,336,98403,2989,101728,"2019-05-01",2019
"19-May",경남,창원시 마산회원구,177,93431,5239,98847,"2019-05-01",2019
"19-May",경남,창원시 성산구,147,116762,13852,130761,"2019-05-01",2019
"19-May",경남,창원시 의창구,922,128498,8521,137941,"2019-05-01",2019
"19-May",경남,창원시 진해구,216,87558,1663,89437,"2019-05-01",2019
"19-May",경남,통영시,318,51811,1524,53653,"2019-05-01",2019
"19-May",경남,하동군,220,24068,454,24742,"2019-05-01",2019
"19-May",경남,함안군,191,40258,12045,52494,"2019-05-01",2019
"19-May",경남,함양군,200,18726,454,19380,"2019-05-01",2019
"19-May",경남,합천군,256,22479,643,23378,"2019-05-01",2019
"19-May",경남,계,6992,1614223,82885,1704100,"2019-05-01",2019
"19-May",제주,서귀포시,769,101744,2025,104538,"2019-05-01",2019
"19-May",제주,제주시,1558,267525,196227,465310,"2019-05-01",2019
"19-May",제주,계,2327,369269,198252,569848,"2019-05-01",2019
"19-Jun",서울,강남구,374,214756,18821,233951,"2019-06-01",2019
"19-Jun",서울,강동구,270,125668,9008,134946,"2019-06-01",2019
"19-Jun",서울,강북구,319,71503,4737,76559,"2019-06-01",2019
"19-Jun",서울,강서구,339,185016,18369,203724,"2019-06-01",2019
"19-Jun",서울,관악구,313,114610,5688,120611,"2019-06-01",2019
"19-Jun",서울,광진구,285,93758,5496,99539,"2019-06-01",2019
"19-Jun",서울,구로구,280,129484,14100,143864,"2019-06-01",2019
"19-Jun",서울,금천구,127,81370,5852,87349,"2019-06-01",2019
"19-Jun",서울,노원구,326,143210,9150,152686,"2019-06-01",2019
"19-Jun",서울,도봉구,266,89119,7488,96873,"2019-06-01",2019
"19-Jun",서울,동대문구,314,92382,5305,98001,"2019-06-01",2019
"19-Jun",서울,동작구,316,103012,2705,106033,"2019-06-01",2019
"19-Jun",서울,마포구,335,110316,7013,117664,"2019-06-01",2019
"19-Jun",서울,서대문구,458,81135,5975,87568,"2019-06-01",2019
"19-Jun",서울,서초구,560,167382,13641,181583,"2019-06-01",2019
"19-Jun",서울,성동구,323,94692,11058,106073,"2019-06-01",2019
"19-Jun",서울,성북구,291,112305,5467,118063,"2019-06-01",2019
"19-Jun",서울,송파구,380,227018,13043,240441,"2019-06-01",2019
"19-Jun",서울,양천구,324,140997,8619,149940,"2019-06-01",2019
"19-Jun",서울,영등포구,364,132837,9105,142306,"2019-06-01",2019
"19-Jun",서울,용산구,363,74411,2219,76993,"2019-06-01",2019
"19-Jun",서울,은평구,288,122845,7127,130260,"2019-06-01",2019
"19-Jun",서울,종로구,3892,44703,1668,50263,"2019-06-01",2019
"19-Jun",서울,중구,1161,45700,4886,51747,"2019-06-01",2019
"19-Jun",서울,중랑구,234,103428,9633,113295,"2019-06-01",2019
"19-Jun",서울,계,12502,2901657,206173,3120332,"2019-06-01",2019
"19-Jun",부산,강서구,320,70264,3735,74319,"2019-06-01",2019
"19-Jun",부산,금정구,283,81476,7427,89186,"2019-06-01",2019
"19-Jun",부산,기장군,255,71634,2272,74161,"2019-06-01",2019
"19-Jun",부산,남구,238,91541,8483,100262,"2019-06-01",2019
"19-Jun",부산,동구,240,44994,4563,49797,"2019-06-01",2019
"19-Jun",부산,동래구,182,88944,4364,93490,"2019-06-01",2019
"19-Jun",부산,부산진구,377,119189,14162,133728,"2019-06-01",2019
"19-Jun",부산,북구,240,100040,3358,103638,"2019-06-01",2019
"19-Jun",부산,사상구,284,84197,6032,90513,"2019-06-01",2019
"19-Jun",부산,사하구,263,107935,7052,115250,"2019-06-01",2019
"19-Jun",부산,서구,140,28209,1364,29713,"2019-06-01",2019
"19-Jun",부산,수영구,166,67338,24976,92480,"2019-06-01",2019
"19-Jun",부산,연제구,883,87371,8255,96509,"2019-06-01",2019
"19-Jun",부산,영도구,233,31333,2081,33647,"2019-06-01",2019
"19-Jun",부산,중구,312,24207,7289,31808,"2019-06-01",2019
"19-Jun",부산,해운대구,323,162744,12519,175586,"2019-06-01",2019
"19-Jun",부산,계,4739,1261416,117932,1384087,"2019-06-01",2019
"19-Jun",대구,남구,348,55488,1762,57598,"2019-06-01",2019
"19-Jun",대구,달서구,488,263048,12263,275799,"2019-06-01",2019
"19-Jun",대구,달성군,503,126927,4803,132233,"2019-06-01",2019
"19-Jun",대구,동구,350,150895,10535,161780,"2019-06-01",2019
"19-Jun",대구,북구,503,195241,7879,203623,"2019-06-01",2019
"19-Jun",대구,서구,235,71217,4179,75631,"2019-06-01",2019
"19-Jun",대구,수성구,576,212138,5299,218013,"2019-06-01",2019
"19-Jun",대구,중구,292,54138,1848,56278,"2019-06-01",2019
"19-Jun",대구,계,3295,1129092,48568,1180955,"2019-06-01",2019
"19-Jun",인천,강화군,316,33178,47128,80622,"2019-06-01",2019
"19-Jun",인천,계양구,283,121014,180817,302114,"2019-06-01",2019
"19-Jun",인천,남동구,855,251681,42691,295227,"2019-06-01",2019
"19-Jun",인천,동구,90,26233,3152,29475,"2019-06-01",2019
"19-Jun",인천,미추홀구,408,151469,9437,161314,"2019-06-01",2019
"19-Jun",인천,부평구,340,214944,12198,227482,"2019-06-01",2019
"19-Jun",인천,서구,399,231439,10969,242807,"2019-06-01",2019
"19-Jun",인천,연수구,399,171721,7707,179827,"2019-06-01",2019
"19-Jun",인천,옹진군,200,11635,204,12039,"2019-06-01",2019
"19-Jun",인천,중구,659,59564,18268,78491,"2019-06-01",2019
"19-Jun",인천,계,3949,1272878,332571,1609398,"2019-06-01",2019
"19-Jun",광주,광산구,502,186191,11873,198566,"2019-06-01",2019
"19-Jun",광주,남구,216,87690,2583,90489,"2019-06-01",2019
"19-Jun",광주,동구,241,37187,1120,38548,"2019-06-01",2019
"19-Jun",광주,북구,598,184107,10017,194722,"2019-06-01",2019
"19-Jun",광주,서구,638,140330,7219,148187,"2019-06-01",2019
"19-Jun",광주,계,2195,635505,32812,670512,"2019-06-01",2019
"19-Jun",대전,대덕구,234,84363,6848,91445,"2019-06-01",2019
"19-Jun",대전,동구,248,88866,4292,93406,"2019-06-01",2019
"19-Jun",대전,서구,797,201934,7278,210009,"2019-06-01",2019
"19-Jun",대전,유성구,380,167824,5148,173352,"2019-06-01",2019
"19-Jun",대전,중구,240,96664,5923,102827,"2019-06-01",2019
"19-Jun",대전,계,1899,639651,29489,671039,"2019-06-01",2019
"19-Jun",울산,남구,708,151686,7272,159666,"2019-06-01",2019
"19-Jun",울산,동구,193,61673,963,62829,"2019-06-01",2019
"19-Jun",울산,북구,180,105856,3765,109801,"2019-06-01",2019
"19-Jun",울산,울주군,367,118744,6620,125731,"2019-06-01",2019
"19-Jun",울산,중구,340,101078,2661,104079,"2019-06-01",2019
"19-Jun",울산,계,1788,539037,21281,562106,"2019-06-01",2019
"19-Jun",세종,세종특별자치시,724,152658,2700,156082,"2019-06-01",2019
"19-Jun",세종,계,724,152658,2700,156082,"2019-06-01",2019
"19-Jun",경기,가평군,369,29767,657,30793,"2019-06-01",2019
"19-Jun",경기,고양시 덕양구,704,163487,3849,168040,"2019-06-01",2019
"19-Jun",경기,고양시 일산동구,285,118349,6647,125281,"2019-06-01",2019
"19-Jun",경기,고양시 일산서구,139,112109,4020,116268,"2019-06-01",2019
"19-Jun",경기,과천시,715,20578,597,21890,"2019-06-01",2019
"19-Jun",경기,광명시,313,103379,4159,107851,"2019-06-01",2019
"19-Jun",경기,광주시,365,179074,8136,187575,"2019-06-01",2019
"19-Jun",경기,구리시,241,69975,2608,72824,"2019-06-01",2019
"19-Jun",경기,군포시,291,95421,5083,100795,"2019-06-01",2019
"19-Jun",경기,김포시,472,198301,7171,205944,"2019-06-01",2019
"19-Jun",경기,남양주시,671,276539,7606,284816,"2019-06-01",2019
"19-Jun",경기,동두천시,213,36667,1307,38187,"2019-06-01",2019
"19-Jun",경기,부천시,728,293081,12807,306616,"2019-06-01",2019
"19-Jun",경기,성남시 분당구,347,183008,7067,190422,"2019-06-01",2019
"19-Jun",경기,성남시 수정구,345,70792,2349,73486,"2019-06-01",2019
"19-Jun",경기,성남시 중원구,323,71092,4231,75646,"2019-06-01",2019
"19-Jun",경기,수원시 권선구,361,173327,7957,181645,"2019-06-01",2019
"19-Jun",경기,수원시 영통구,214,140083,3223,143520,"2019-06-01",2019
"19-Jun",경기,수원시 장안구,592,102964,3839,107395,"2019-06-01",2019
"19-Jun",경기,수원시 팔달구,486,68340,2989,71815,"2019-06-01",2019
"19-Jun",경기,시흥시,459,220553,7634,228646,"2019-06-01",2019
"19-Jun",경기,안산시 단원구,560,148406,8081,157047,"2019-06-01",2019
"19-Jun",경기,안산시 상록구,178,136077,4800,141055,"2019-06-01",2019
"19-Jun",경기,안성시,385,96652,5025,102062,"2019-06-01",2019
"19-Jun",경기,안양시 동안구,397,116098,6324,122819,"2019-06-01",2019
"19-Jun",경기,안양시 만안구,152,83872,3960,87984,"2019-06-01",2019
"19-Jun",경기,양주시,375,98858,3112,102345,"2019-06-01",2019
"19-Jun",경기,양평군,552,57205,1762,59519,"2019-06-01",2019
"19-Jun",경기,여주시,424,60264,7294,67982,"2019-06-01",2019
"19-Jun",경기,연천군,295,23178,5324,28797,"2019-06-01",2019
"19-Jun",경기,오산시,203,97156,3292,100651,"2019-06-01",2019
"19-Jun",경기,용인시 기흥구,127,182029,8162,190318,"2019-06-01",2019
"19-Jun",경기,용인시 수지구,46,134790,2285,137121,"2019-06-01",2019
"19-Jun",경기,용인시 처인구,708,123635,7089,131432,"2019-06-01",2019
"19-Jun",경기,의왕시,304,59888,3134,63326,"2019-06-01",2019
"19-Jun",경기,의정부시,645,152136,4945,157726,"2019-06-01",2019
"19-Jun",경기,이천시,397,106929,5754,113080,"2019-06-01",2019
"19-Jun",경기,파주시,507,200503,9482,210492,"2019-06-01",2019
"19-Jun",경기,평택시,698,252530,11684,264912,"2019-06-01",2019
"19-Jun",경기,포천시,384,82205,9813,92402,"2019-06-01",2019
"19-Jun",경기,하남시,389,106625,2600,109614,"2019-06-01",2019
"19-Jun",경기,화성시,886,399486,11108,411480,"2019-06-01",2019
"19-Jun",경기,계,17245,5445408,228966,5691619,"2019-06-01",2019
"19-Jun",강원,강릉시,516,102986,4630,108132,"2019-06-01",2019
"19-Jun",강원,고성군,184,13722,235,14141,"2019-06-01",2019
"19-Jun",강원,동해시,299,43161,1377,44837,"2019-06-01",2019
"19-Jun",강원,삼척시,394,31418,697,32509,"2019-06-01",2019
"19-Jun",강원,속초시,293,35976,1382,37651,"2019-06-01",2019
"19-Jun",강원,양구군,174,11887,124,12185,"2019-06-01",2019
"19-Jun",강원,양양군,180,14945,225,15350,"2019-06-01",2019
"19-Jun",강원,영월군,327,20427,359,21113,"2019-06-01",2019
"19-Jun",강원,원주시,542,162642,5921,169105,"2019-06-01",2019
"19-Jun",강원,인제군,212,17501,296,18009,"2019-06-01",2019
"19-Jun",강원,정선군,332,20009,468,20809,"2019-06-01",2019
"19-Jun",강원,철원군,223,23469,308,24000,"2019-06-01",2019
"19-Jun",강원,춘천시,789,126053,5885,132727,"2019-06-01",2019
"19-Jun",강원,태백시,230,20035,788,21053,"2019-06-01",2019
"19-Jun",강원,평창군,287,25151,457,25895,"2019-06-01",2019
"19-Jun",강원,홍천군,396,37283,1099,38778,"2019-06-01",2019
"19-Jun",강원,화천군,200,12484,201,12885,"2019-06-01",2019
"19-Jun",강원,횡성군,250,25231,680,26161,"2019-06-01",2019
"19-Jun",강원,계,5828,744380,25132,775340,"2019-06-01",2019
"19-Jun",충북,괴산군,198,21727,375,22300,"2019-06-01",2019
"19-Jun",충북,단양군,213,15614,788,16615,"2019-06-01",2019
"19-Jun",충북,보은군,214,17525,895,18634,"2019-06-01",2019
"19-Jun",충북,영동군,237,24439,382,25058,"2019-06-01",2019
"19-Jun",충북,옥천군,202,25895,1104,27201,"2019-06-01",2019
"19-Jun",충북,음성군,220,56482,1806,58508,"2019-06-01",2019
"19-Jun",충북,제천시,320,65353,3538,69211,"2019-06-01",2019
"19-Jun",충북,증평군,93,18620,739,19452,"2019-06-01",2019
"19-Jun",충북,진천군,209,45782,1293,47284,"2019-06-01",2019
"19-Jun",충북,청원군,1,19,0,20,"2019-06-01",2019
"19-Jun",충북,청주시 상당구,510,80935,2461,83906,"2019-06-01",2019
"19-Jun",충북,청주시 서원구,230,93660,5145,99035,"2019-06-01",2019
"19-Jun",충북,청주시 청원구,349,100044,4087,104480,"2019-06-01",2019
"19-Jun",충북,청주시 흥덕구,353,119197,7231,126781,"2019-06-01",2019
"19-Jun",충북,충주시,584,104853,4940,110377,"2019-06-01",2019
"19-Jun",충북,계,3933,790145,34784,828862,"2019-06-01",2019
"19-Jun",충남,계룡시,151,21164,538,21853,"2019-06-01",2019
"19-Jun",충남,공주시,552,52561,2146,55259,"2019-06-01",2019
"19-Jun",충남,금산군,187,27724,2030,29941,"2019-06-01",2019
"19-Jun",충남,논산시,375,59705,2285,62365,"2019-06-01",2019
"19-Jun",충남,당진시,374,91235,3820,95429,"2019-06-01",2019
"19-Jun",충남,보령시,397,50624,1302,52323,"2019-06-01",2019
"19-Jun",충남,부여군,272,33541,1271,35084,"2019-06-01",2019
"19-Jun",충남,서산시,398,90052,3483,93933,"2019-06-01",2019
"19-Jun",충남,서천군,230,26608,894,27732,"2019-06-01",2019
"19-Jun",충남,아산시,487,158548,6091,165126,"2019-06-01",2019
"19-Jun",충남,예산군,392,42004,1445,43841,"2019-06-01",2019
"19-Jun",충남,천안시 동남구,260,125532,4729,130521,"2019-06-01",2019
"19-Jun",충남,천안시 서북구,535,183305,5833,189673,"2019-06-01",2019
"19-Jun",충남,청양군,258,16459,858,17575,"2019-06-01",2019
"19-Jun",충남,태안군,285,32988,505,33778,"2019-06-01",2019
"19-Jun",충남,홍성군,410,50949,1414,52773,"2019-06-01",2019
"19-Jun",충남,계,5563,1062999,38644,1107206,"2019-06-01",2019
"19-Jun",전북,고창군,271,29781,597,30649,"2019-06-01",2019
"19-Jun",전북,군산시,520,126885,6581,133986,"2019-06-01",2019
"19-Jun",전북,김제시,289,44242,1963,46494,"2019-06-01",2019
"19-Jun",전북,남원시,414,39568,5525,45507,"2019-06-01",2019
"19-Jun",전북,무주군,190,12396,373,12959,"2019-06-01",2019
"19-Jun",전북,부안군,262,26991,618,27871,"2019-06-01",2019
"19-Jun",전북,순창군,206,14298,188,14692,"2019-06-01",2019
"19-Jun",전북,완주군,346,49888,3310,53544,"2019-06-01",2019
"19-Jun",전북,익산시,497,134807,6276,141580,"2019-06-01",2019
"19-Jun",전북,임실군,203,14168,426,14797,"2019-06-01",2019
"19-Jun",전북,장수군,232,11801,173,12206,"2019-06-01",2019
"19-Jun",전북,전주시 덕진구,390,161854,7564,169808,"2019-06-01",2019
"19-Jun",전북,전주시 완산구,593,145684,4069,150346,"2019-06-01",2019
"19-Jun",전북,정읍시,336,52907,3773,57016,"2019-06-01",2019
"19-Jun",전북,진안군,237,13678,204,14119,"2019-06-01",2019
"19-Jun",전북,계,4986,878948,41640,925574,"2019-06-01",2019
"19-Jun",전남,강진군,218,18009,1104,19331,"2019-06-01",2019
"19-Jun",전남,고흥군,298,30530,650,31478,"2019-06-01",2019
"19-Jun",전남,곡성군,149,14360,740,15249,"2019-06-01",2019
"19-Jun",전남,광양시,253,78403,5946,84602,"2019-06-01",2019
"19-Jun",전남,구례군,139,12911,627,13677,"2019-06-01",2019
"19-Jun",전남,나주시,461,60873,3323,64657,"2019-06-01",2019
"19-Jun",전남,담양군,209,25546,1537,27292,"2019-06-01",2019
"19-Jun",전남,목포시,443,94195,5791,100429,"2019-06-01",2019
"19-Jun",전남,무안군,559,41219,973,42751,"2019-06-01",2019
"19-Jun",전남,보성군,201,20993,57069,78263,"2019-06-01",2019
"19-Jun",전남,순천시,501,132592,5172,138265,"2019-06-01",2019
"19-Jun",전남,신안군,246,20314,848,21408,"2019-06-01",2019
"19-Jun",전남,여수시,550,125930,6930,133410,"2019-06-01",2019
"19-Jun",전남,영광군,207,26638,721,27566,"2019-06-01",2019
"19-Jun",전남,영암군,249,31836,12753,44838,"2019-06-01",2019
"19-Jun",전남,완도군,231,24428,507,25166,"2019-06-01",2019
"19-Jun",전남,장성군,183,25755,1109,27047,"2019-06-01",2019
"19-Jun",전남,장흥군,200,19615,453,20268,"2019-06-01",2019
"19-Jun",전남,진도군,156,16089,302,16547,"2019-06-01",2019
"19-Jun",전남,함평군,192,17496,21496,39184,"2019-06-01",2019
"19-Jun",전남,해남군,333,37949,587,38869,"2019-06-01",2019
"19-Jun",전남,화순군,218,31133,2035,33386,"2019-06-01",2019
"19-Jun",전남,계,6196,906814,130673,1043683,"2019-06-01",2019
"19-Jun",경북,경산시,313,132570,4426,137309,"2019-06-01",2019
"19-Jun",경북,경주시,579,136855,4636,142070,"2019-06-01",2019
"19-Jun",경북,고령군,160,20173,535,20868,"2019-06-01",2019
"19-Jun",경북,구미시,535,206678,7288,214501,"2019-06-01",2019
"19-Jun",경북,군위군,121,14266,280,14667,"2019-06-01",2019
"19-Jun",경북,김천시,379,71297,1851,73527,"2019-06-01",2019
"19-Jun",경북,문경시,282,35237,803,36322,"2019-06-01",2019
"19-Jun",경북,봉화군,214,17269,207,17690,"2019-06-01",2019
"19-Jun",경북,상주시,379,51461,1854,53694,"2019-06-01",2019
"19-Jun",경북,성주군,198,29416,1411,31025,"2019-06-01",2019
"19-Jun",경북,안동시,715,79425,2608,82748,"2019-06-01",2019
"19-Jun",경북,영덕군,255,18454,285,18994,"2019-06-01",2019
"19-Jun",경북,영양군,143,9315,105,9563,"2019-06-01",2019
"19-Jun",경북,영주시,384,54206,1502,56092,"2019-06-01",2019
"19-Jun",경북,영천시,296,57429,2659,60384,"2019-06-01",2019
"19-Jun",경북,예천군,269,27723,464,28456,"2019-06-01",2019
"19-Jun",경북,울릉군,147,5248,531,5926,"2019-06-01",2019
"19-Jun",경북,울진군,300,25197,348,25845,"2019-06-01",2019
"19-Jun",경북,의성군,303,29360,950,30613,"2019-06-01",2019
"19-Jun",경북,청도군,200,24219,684,25103,"2019-06-01",2019
"19-Jun",경북,청송군,198,14991,201,15390,"2019-06-01",2019
"19-Jun",경북,칠곡군,331,67371,2292,69994,"2019-06-01",2019
"19-Jun",경북,포항시 남구,402,119129,8769,128300,"2019-06-01",2019
"19-Jun",경북,포항시 북구,329,132144,3904,136377,"2019-06-01",2019
"19-Jun",경북,계,7432,1379433,48593,1435458,"2019-06-01",2019
"19-Jun",경남,거제시,344,103113,2174,105631,"2019-06-01",2019
"19-Jun",경남,거창군,257,31009,796,32062,"2019-06-01",2019
"19-Jun",경남,고성군,217,26074,636,26927,"2019-06-01",2019
"19-Jun",경남,김해시,651,261968,7102,269721,"2019-06-01",2019
"19-Jun",경남,남해군,253,19046,479,19778,"2019-06-01",2019
"19-Jun",경남,밀양시,316,53880,3915,58111,"2019-06-01",2019
"19-Jun",경남,사천시,295,54562,1517,56374,"2019-06-01",2019
"19-Jun",경남,산청군,230,19404,796,20430,"2019-06-01",2019
"19-Jun",경남,양산시,400,157693,9796,167889,"2019-06-01",2019
"19-Jun",경남,의령군,191,13885,682,14758,"2019-06-01",2019
"19-Jun",경남,진주시,606,158871,6725,166202,"2019-06-01",2019
"19-Jun",경남,창녕군,234,34610,958,35802,"2019-06-01",2019
"19-Jun",경남,창원시 마산합포구,334,98585,3007,101926,"2019-06-01",2019
"19-Jun",경남,창원시 마산회원구,179,93331,5241,98751,"2019-06-01",2019
"19-Jun",경남,창원시 성산구,144,116775,13395,130314,"2019-06-01",2019
"19-Jun",경남,창원시 의창구,954,128724,9739,139417,"2019-06-01",2019
"19-Jun",경남,창원시 진해구,217,87676,1663,89556,"2019-06-01",2019
"19-Jun",경남,통영시,321,51845,1535,53701,"2019-06-01",2019
"19-Jun",경남,하동군,218,24082,450,24750,"2019-06-01",2019
"19-Jun",경남,함안군,189,40222,12136,52547,"2019-06-01",2019
"19-Jun",경남,함양군,203,18834,450,19487,"2019-06-01",2019
"19-Jun",경남,합천군,257,22514,646,23417,"2019-06-01",2019
"19-Jun",경남,계,7010,1616703,83838,1707551,"2019-06-01",2019
"19-Jun",제주,서귀포시,782,102106,2031,104919,"2019-06-01",2019
"19-Jun",제주,제주시,1571,267871,200000,469442,"2019-06-01",2019
"19-Jun",제주,계,2353,369977,202031,574361,"2019-06-01",2019
"19-Jul",서울,강남구,375,214811,18683,233869,"2019-07-01",2019
"19-Jul",서울,강동구,273,126159,9009,135441,"2019-07-01",2019
"19-Jul",서울,강북구,315,71526,4609,76450,"2019-07-01",2019
"19-Jul",서울,강서구,340,185014,18362,203716,"2019-07-01",2019
"19-Jul",서울,관악구,305,114633,5682,120620,"2019-07-01",2019
"19-Jul",서울,광진구,285,93686,5590,99561,"2019-07-01",2019
"19-Jul",서울,구로구,280,129568,14039,143887,"2019-07-01",2019
"19-Jul",서울,금천구,133,81439,5902,87474,"2019-07-01",2019
"19-Jul",서울,노원구,324,143089,9375,152788,"2019-07-01",2019
"19-Jul",서울,도봉구,263,89107,7486,96856,"2019-07-01",2019
"19-Jul",서울,동대문구,317,92448,5277,98042,"2019-07-01",2019
"19-Jul",서울,동작구,315,103026,2709,106050,"2019-07-01",2019
"19-Jul",서울,마포구,336,110222,7103,117661,"2019-07-01",2019
"19-Jul",서울,서대문구,454,80980,5995,87429,"2019-07-01",2019
"19-Jul",서울,서초구,555,167627,13557,181739,"2019-07-01",2019
"19-Jul",서울,성동구,326,94600,11050,105976,"2019-07-01",2019
"19-Jul",서울,성북구,284,112610,5465,118359,"2019-07-01",2019
"19-Jul",서울,송파구,381,226834,13074,240289,"2019-07-01",2019
"19-Jul",서울,양천구,323,141058,8651,150032,"2019-07-01",2019
"19-Jul",서울,영등포구,366,132867,9636,142869,"2019-07-01",2019
"19-Jul",서울,용산구,361,74288,2225,76874,"2019-07-01",2019
"19-Jul",서울,은평구,284,122734,7125,130143,"2019-07-01",2019
"19-Jul",서울,종로구,3906,44676,1670,50252,"2019-07-01",2019
"19-Jul",서울,중구,1129,45746,4829,51704,"2019-07-01",2019
"19-Jul",서울,중랑구,235,103294,9530,113059,"2019-07-01",2019
"19-Jul",서울,계,12465,2902042,206633,3121140,"2019-07-01",2019
"19-Jul",부산,강서구,321,70444,3740,74505,"2019-07-01",2019
"19-Jul",부산,금정구,280,81556,7414,89250,"2019-07-01",2019
"19-Jul",부산,기장군,254,71722,2280,74256,"2019-07-01",2019
"19-Jul",부산,남구,226,91639,8469,100334,"2019-07-01",2019
"19-Jul",부산,동구,235,45092,4567,49894,"2019-07-01",2019
"19-Jul",부산,동래구,180,89188,4263,93631,"2019-07-01",2019
"19-Jul",부산,부산진구,372,119363,14209,133944,"2019-07-01",2019
"19-Jul",부산,북구,240,100022,3349,103611,"2019-07-01",2019
"19-Jul",부산,사상구,285,84170,6032,90487,"2019-07-01",2019
"19-Jul",부산,사하구,259,108001,7044,115304,"2019-07-01",2019
"19-Jul",부산,서구,133,28227,1372,29732,"2019-07-01",2019
"19-Jul",부산,수영구,166,67431,25631,93228,"2019-07-01",2019
"19-Jul",부산,연제구,872,87380,8434,96686,"2019-07-01",2019
"19-Jul",부산,영도구,231,31334,2082,33647,"2019-07-01",2019
"19-Jul",부산,중구,312,24376,7325,32013,"2019-07-01",2019
"19-Jul",부산,해운대구,316,162875,11539,174730,"2019-07-01",2019
"19-Jul",부산,계,4682,1262820,117750,1385252,"2019-07-01",2019
"19-Jul",대구,남구,340,55417,1777,57534,"2019-07-01",2019
"19-Jul",대구,달서구,487,263889,12296,276672,"2019-07-01",2019
"19-Jul",대구,달성군,507,127393,4843,132743,"2019-07-01",2019
"19-Jul",대구,동구,349,150897,10640,161886,"2019-07-01",2019
"19-Jul",대구,북구,502,195697,7886,204085,"2019-07-01",2019
"19-Jul",대구,서구,238,70917,4093,75248,"2019-07-01",2019
"19-Jul",대구,수성구,577,212161,5315,218053,"2019-07-01",2019
"19-Jul",대구,중구,289,54014,1827,56130,"2019-07-01",2019
"19-Jul",대구,계,3289,1130385,48677,1182351,"2019-07-01",2019
"19-Jul",인천,강화군,317,33292,49693,83302,"2019-07-01",2019
"19-Jul",인천,계양구,284,120818,183520,304622,"2019-07-01",2019
"19-Jul",인천,남동구,857,251832,42964,295653,"2019-07-01",2019
"19-Jul",인천,동구,87,26279,3209,29575,"2019-07-01",2019
"19-Jul",인천,미추홀구,409,151840,9283,161532,"2019-07-01",2019
"19-Jul",인천,부평구,339,214668,12579,227586,"2019-07-01",2019
"19-Jul",인천,서구,398,232194,10995,243587,"2019-07-01",2019
"19-Jul",인천,연수구,399,172555,7682,180636,"2019-07-01",2019
"19-Jul",인천,옹진군,200,11653,204,12057,"2019-07-01",2019
"19-Jul",인천,중구,684,59996,18367,79047,"2019-07-01",2019
"19-Jul",인천,계,3974,1275127,338496,1617597,"2019-07-01",2019
"19-Jul",광주,광산구,501,186669,11949,199119,"2019-07-01",2019
"19-Jul",광주,남구,214,87936,2590,90740,"2019-07-01",2019
"19-Jul",광주,동구,240,37924,1141,39305,"2019-07-01",2019
"19-Jul",광주,북구,602,184270,9978,194850,"2019-07-01",2019
"19-Jul",광주,서구,640,140519,6993,148152,"2019-07-01",2019
"19-Jul",광주,계,2197,637318,32651,672166,"2019-07-01",2019
"19-Jul",대전,대덕구,231,84515,6781,91527,"2019-07-01",2019
"19-Jul",대전,동구,248,88934,4324,93506,"2019-07-01",2019
"19-Jul",대전,서구,793,202290,7313,210396,"2019-07-01",2019
"19-Jul",대전,유성구,377,167759,5301,173437,"2019-07-01",2019
"19-Jul",대전,중구,237,96780,5905,102922,"2019-07-01",2019
"19-Jul",대전,계,1886,640278,29624,671788,"2019-07-01",2019
"19-Jul",울산,남구,711,151643,7187,159541,"2019-07-01",2019
"19-Jul",울산,동구,193,61715,965,62873,"2019-07-01",2019
"19-Jul",울산,북구,180,106426,3756,110362,"2019-07-01",2019
"19-Jul",울산,울주군,373,119128,6721,126222,"2019-07-01",2019
"19-Jul",울산,중구,343,101033,2661,104037,"2019-07-01",2019
"19-Jul",울산,계,1800,539945,21290,563035,"2019-07-01",2019
"19-Jul",세종,세종특별자치시,737,154063,2698,157498,"2019-07-01",2019
"19-Jul",세종,계,737,154063,2698,157498,"2019-07-01",2019
"19-Jul",경기,가평군,367,29778,635,30780,"2019-07-01",2019
"19-Jul",경기,고양시 덕양구,701,164789,3900,169390,"2019-07-01",2019
"19-Jul",경기,고양시 일산동구,287,118264,6527,125078,"2019-07-01",2019
"19-Jul",경기,고양시 일산서구,137,112847,4042,117026,"2019-07-01",2019
"19-Jul",경기,과천시,715,20622,597,21934,"2019-07-01",2019
"19-Jul",경기,광명시,312,103500,4162,107974,"2019-07-01",2019
"19-Jul",경기,광주시,367,179640,8129,188136,"2019-07-01",2019
"19-Jul",경기,구리시,241,70039,2612,72892,"2019-07-01",2019
"19-Jul",경기,군포시,291,95539,5052,100882,"2019-07-01",2019
"19-Jul",경기,김포시,472,199117,7259,206848,"2019-07-01",2019
"19-Jul",경기,남양주시,671,278085,7611,286367,"2019-07-01",2019
"19-Jul",경기,동두천시,209,36702,1312,38223,"2019-07-01",2019
"19-Jul",경기,부천시,733,293506,12866,307105,"2019-07-01",2019
"19-Jul",경기,성남시 분당구,353,182869,6992,190214,"2019-07-01",2019
"19-Jul",경기,성남시 수정구,345,70936,2342,73623,"2019-07-01",2019
"19-Jul",경기,성남시 중원구,323,71111,4286,75720,"2019-07-01",2019
"19-Jul",경기,수원시 권선구,363,173809,8039,182211,"2019-07-01",2019
"19-Jul",경기,수원시 영통구,214,140830,3274,144318,"2019-07-01",2019
"19-Jul",경기,수원시 장안구,593,102936,3832,107361,"2019-07-01",2019
"19-Jul",경기,수원시 팔달구,481,68261,2984,71726,"2019-07-01",2019
"19-Jul",경기,시흥시,450,221697,7620,229767,"2019-07-01",2019
"19-Jul",경기,안산시 단원구,555,149616,8117,158288,"2019-07-01",2019
"19-Jul",경기,안산시 상록구,177,135899,4820,140896,"2019-07-01",2019
"19-Jul",경기,안성시,384,97389,5013,102786,"2019-07-01",2019
"19-Jul",경기,안양시 동안구,402,116356,6265,123023,"2019-07-01",2019
"19-Jul",경기,안양시 만안구,152,83848,3928,87928,"2019-07-01",2019
"19-Jul",경기,양주시,376,99258,3118,102752,"2019-07-01",2019
"19-Jul",경기,양평군,558,57290,1757,59605,"2019-07-01",2019
"19-Jul",경기,여주시,425,60480,7309,68214,"2019-07-01",2019
"19-Jul",경기,연천군,297,23221,5330,28848,"2019-07-01",2019
"19-Jul",경기,오산시,203,97434,3377,101014,"2019-07-01",2019
"19-Jul",경기,용인시 기흥구,123,182553,6113,188789,"2019-07-01",2019
"19-Jul",경기,용인시 수지구,49,135611,2305,137965,"2019-07-01",2019
"19-Jul",경기,용인시 처인구,706,124044,7100,131850,"2019-07-01",2019
"19-Jul",경기,의왕시,300,60328,3199,63827,"2019-07-01",2019
"19-Jul",경기,의정부시,643,152645,4964,158252,"2019-07-01",2019
"19-Jul",경기,이천시,398,107333,5784,113515,"2019-07-01",2019
"19-Jul",경기,파주시,511,201148,9434,211093,"2019-07-01",2019
"19-Jul",경기,평택시,697,254235,11720,266652,"2019-07-01",2019
"19-Jul",경기,포천시,374,82391,9638,92403,"2019-07-01",2019
"19-Jul",경기,하남시,386,107451,2618,110455,"2019-07-01",2019
"19-Jul",경기,화성시,866,402632,11127,414625,"2019-07-01",2019
"19-Jul",경기,계,17207,5466039,227109,5710355,"2019-07-01",2019
"19-Jul",강원,강릉시,520,103120,4651,108291,"2019-07-01",2019
"19-Jul",강원,고성군,179,13706,231,14116,"2019-07-01",2019
"19-Jul",강원,동해시,297,43248,1363,44908,"2019-07-01",2019
"19-Jul",강원,삼척시,390,31569,703,32662,"2019-07-01",2019
"19-Jul",강원,속초시,296,36104,1375,37775,"2019-07-01",2019
"19-Jul",강원,양구군,175,11901,124,12200,"2019-07-01",2019
"19-Jul",강원,양양군,181,15013,225,15419,"2019-07-01",2019
"19-Jul",강원,영월군,329,20480,367,21176,"2019-07-01",2019
"19-Jul",강원,원주시,535,163357,5891,169783,"2019-07-01",2019
"19-Jul",강원,인제군,214,17502,298,18014,"2019-07-01",2019
"19-Jul",강원,정선군,330,20080,469,20879,"2019-07-01",2019
"19-Jul",강원,철원군,224,23578,307,24109,"2019-07-01",2019
"19-Jul",강원,춘천시,783,126435,5913,133131,"2019-07-01",2019
"19-Jul",강원,태백시,228,20051,796,21075,"2019-07-01",2019
"19-Jul",강원,평창군,284,25179,518,25981,"2019-07-01",2019
"19-Jul",강원,홍천군,400,37369,1096,38865,"2019-07-01",2019
"19-Jul",강원,화천군,199,12522,202,12923,"2019-07-01",2019
"19-Jul",강원,횡성군,244,25318,689,26251,"2019-07-01",2019
"19-Jul",강원,계,5808,746532,25218,777558,"2019-07-01",2019
"19-Jul",충북,괴산군,197,21775,382,22354,"2019-07-01",2019
"19-Jul",충북,단양군,206,15633,782,16621,"2019-07-01",2019
"19-Jul",충북,보은군,215,17540,897,18652,"2019-07-01",2019
"19-Jul",충북,영동군,230,24506,383,25119,"2019-07-01",2019
"19-Jul",충북,옥천군,200,25971,1108,27279,"2019-07-01",2019
"19-Jul",충북,음성군,221,56583,1818,58622,"2019-07-01",2019
"19-Jul",충북,제천시,322,65571,3565,69458,"2019-07-01",2019
"19-Jul",충북,증평군,93,18672,754,19519,"2019-07-01",2019
"19-Jul",충북,진천군,207,46012,1308,47527,"2019-07-01",2019
"19-Jul",충북,청원군,1,19,0,20,"2019-07-01",2019
"19-Jul",충북,청주시 상당구,506,81185,2476,84167,"2019-07-01",2019
"19-Jul",충북,청주시 서원구,230,93679,5123,99032,"2019-07-01",2019
"19-Jul",충북,청주시 청원구,345,100351,4076,104772,"2019-07-01",2019
"19-Jul",충북,청주시 흥덕구,358,119502,7308,127168,"2019-07-01",2019
"19-Jul",충북,충주시,585,105207,5142,110934,"2019-07-01",2019
"19-Jul",충북,계,3916,792206,35122,831244,"2019-07-01",2019
"19-Jul",충남,계룡시,149,21151,540,21840,"2019-07-01",2019
"19-Jul",충남,공주시,579,52709,2215,55503,"2019-07-01",2019
"19-Jul",충남,금산군,186,27771,2035,29992,"2019-07-01",2019
"19-Jul",충남,논산시,377,59781,2301,62459,"2019-07-01",2019
"19-Jul",충남,당진시,371,91363,3833,95567,"2019-07-01",2019
"19-Jul",충남,보령시,397,50798,1299,52494,"2019-07-01",2019
"19-Jul",충남,부여군,275,33578,1273,35126,"2019-07-01",2019
"19-Jul",충남,서산시,395,90283,3475,94153,"2019-07-01",2019
"19-Jul",충남,서천군,230,26621,887,27738,"2019-07-01",2019
"19-Jul",충남,아산시,485,158917,6032,165434,"2019-07-01",2019
"19-Jul",충남,예산군,382,42068,1444,43894,"2019-07-01",2019
"19-Jul",충남,천안시 동남구,234,125795,4738,130767,"2019-07-01",2019
"19-Jul",충남,천안시 서북구,534,183916,5829,190279,"2019-07-01",2019
"19-Jul",충남,청양군,258,16490,842,17590,"2019-07-01",2019
"19-Jul",충남,태안군,283,33100,500,33883,"2019-07-01",2019
"19-Jul",충남,홍성군,409,51003,1421,52833,"2019-07-01",2019
"19-Jul",충남,계,5544,1065344,38664,1109552,"2019-07-01",2019
"19-Jul",전북,고창군,271,29833,595,30699,"2019-07-01",2019
"19-Jul",전북,군산시,522,126728,6535,133785,"2019-07-01",2019
"19-Jul",전북,김제시,286,44213,1939,46438,"2019-07-01",2019
"19-Jul",전북,남원시,407,39539,5454,45400,"2019-07-01",2019
"19-Jul",전북,무주군,190,12359,373,12922,"2019-07-01",2019
"19-Jul",전북,부안군,261,27047,611,27919,"2019-07-01",2019
"19-Jul",전북,순창군,209,14276,189,14674,"2019-07-01",2019
"19-Jul",전북,완주군,356,49797,3314,53467,"2019-07-01",2019
"19-Jul",전북,익산시,500,134938,6280,141718,"2019-07-01",2019
"19-Jul",전북,임실군,209,14127,424,14760,"2019-07-01",2019
"19-Jul",전북,장수군,236,11811,174,12221,"2019-07-01",2019
"19-Jul",전북,전주시 덕진구,388,162470,7531,170389,"2019-07-01",2019
"19-Jul",전북,전주시 완산구,595,146039,4078,150712,"2019-07-01",2019
"19-Jul",전북,정읍시,330,53074,3730,57134,"2019-07-01",2019
"19-Jul",전북,진안군,234,13748,202,14184,"2019-07-01",2019
"19-Jul",전북,계,4994,879999,41429,926422,"2019-07-01",2019
"19-Jul",전남,강진군,218,18063,1119,19400,"2019-07-01",2019
"19-Jul",전남,고흥군,296,30584,650,31530,"2019-07-01",2019
"19-Jul",전남,곡성군,149,14368,735,15252,"2019-07-01",2019
"19-Jul",전남,광양시,252,78715,5928,84895,"2019-07-01",2019
"19-Jul",전남,구례군,140,12904,637,13681,"2019-07-01",2019
"19-Jul",전남,나주시,455,60976,3318,64749,"2019-07-01",2019
"19-Jul",전남,담양군,206,25578,1559,27343,"2019-07-01",2019
"19-Jul",전남,목포시,444,94381,5824,100649,"2019-07-01",2019
"19-Jul",전남,무안군,553,41319,965,42837,"2019-07-01",2019
"19-Jul",전남,보성군,203,21040,55390,76633,"2019-07-01",2019
"19-Jul",전남,순천시,502,133241,5157,138900,"2019-07-01",2019
"19-Jul",전남,신안군,245,20401,840,21486,"2019-07-01",2019
"19-Jul",전남,여수시,549,126173,6961,133683,"2019-07-01",2019
"19-Jul",전남,영광군,209,26692,723,27624,"2019-07-01",2019
"19-Jul",전남,영암군,251,31926,12631,44808,"2019-07-01",2019
"19-Jul",전남,완도군,240,24502,511,25253,"2019-07-01",2019
"19-Jul",전남,장성군,183,25777,1125,27085,"2019-07-01",2019
"19-Jul",전남,장흥군,200,19664,452,20316,"2019-07-01",2019
"19-Jul",전남,진도군,157,16099,304,16560,"2019-07-01",2019
"19-Jul",전남,함평군,188,17558,23396,41142,"2019-07-01",2019
"19-Jul",전남,해남군,336,38018,585,38939,"2019-07-01",2019
"19-Jul",전남,화순군,217,31169,2059,33445,"2019-07-01",2019
"19-Jul",전남,계,6193,909148,130869,1046210,"2019-07-01",2019
"19-Jul",경북,경산시,316,132873,4451,137640,"2019-07-01",2019
"19-Jul",경북,경주시,584,136882,4605,142071,"2019-07-01",2019
"19-Jul",경북,고령군,161,20232,536,20929,"2019-07-01",2019
"19-Jul",경북,구미시,538,207070,7270,214878,"2019-07-01",2019
"19-Jul",경북,군위군,121,14311,281,14713,"2019-07-01",2019
"19-Jul",경북,김천시,378,71443,1848,73669,"2019-07-01",2019
"19-Jul",경북,문경시,280,35256,806,36342,"2019-07-01",2019
"19-Jul",경북,봉화군,212,17341,206,17759,"2019-07-01",2019
"19-Jul",경북,상주시,378,51552,1849,53779,"2019-07-01",2019
"19-Jul",경북,성주군,201,29460,1412,31073,"2019-07-01",2019
"19-Jul",경북,안동시,712,79534,2601,82847,"2019-07-01",2019
"19-Jul",경북,영덕군,254,18534,282,19070,"2019-07-01",2019
"19-Jul",경북,영양군,144,9347,104,9595,"2019-07-01",2019
"19-Jul",경북,영주시,376,54296,1500,56172,"2019-07-01",2019
"19-Jul",경북,영천시,297,57531,2643,60471,"2019-07-01",2019
"19-Jul",경북,예천군,272,27785,468,28525,"2019-07-01",2019
"19-Jul",경북,울릉군,147,5242,531,5920,"2019-07-01",2019
"19-Jul",경북,울진군,296,25270,343,25909,"2019-07-01",2019
"19-Jul",경북,의성군,303,29458,954,30715,"2019-07-01",2019
"19-Jul",경북,청도군,202,24245,693,25140,"2019-07-01",2019
"19-Jul",경북,청송군,197,15002,201,15400,"2019-07-01",2019
"19-Jul",경북,칠곡군,331,67419,2279,70029,"2019-07-01",2019
"19-Jul",경북,포항시 남구,440,119201,8732,128373,"2019-07-01",2019
"19-Jul",경북,포항시 북구,330,132541,3905,136776,"2019-07-01",2019
"19-Jul",경북,계,7470,1381825,48500,1437795,"2019-07-01",2019
"19-Jul",경남,거제시,343,103311,2167,105821,"2019-07-01",2019
"19-Jul",경남,거창군,258,31059,801,32118,"2019-07-01",2019
"19-Jul",경남,고성군,214,26038,645,26897,"2019-07-01",2019
"19-Jul",경남,김해시,649,262679,7228,270556,"2019-07-01",2019
"19-Jul",경남,남해군,256,19076,487,19819,"2019-07-01",2019
"19-Jul",경남,밀양시,314,53990,3949,58253,"2019-07-01",2019
"19-Jul",경남,사천시,297,54608,1509,56414,"2019-07-01",2019
"19-Jul",경남,산청군,229,19441,800,20470,"2019-07-01",2019
"19-Jul",경남,양산시,400,157922,9811,168133,"2019-07-01",2019
"19-Jul",경남,의령군,189,13902,681,14772,"2019-07-01",2019
"19-Jul",경남,진주시,599,159355,6725,166679,"2019-07-01",2019
"19-Jul",경남,창녕군,234,34583,959,35776,"2019-07-01",2019
"19-Jul",경남,창원시 마산합포구,335,98713,3019,102067,"2019-07-01",2019
"19-Jul",경남,창원시 마산회원구,178,92988,5098,98264,"2019-07-01",2019
"19-Jul",경남,창원시 성산구,144,116706,13074,129924,"2019-07-01",2019
"19-Jul",경남,창원시 의창구,945,129792,10902,141639,"2019-07-01",2019
"19-Jul",경남,창원시 진해구,215,87824,1662,89701,"2019-07-01",2019
"19-Jul",경남,통영시,321,51925,1489,53735,"2019-07-01",2019
"19-Jul",경남,하동군,219,24106,454,24779,"2019-07-01",2019
"19-Jul",경남,함안군,189,40237,12249,52675,"2019-07-01",2019
"19-Jul",경남,함양군,211,18864,449,19524,"2019-07-01",2019
"19-Jul",경남,합천군,259,22590,649,23498,"2019-07-01",2019
"19-Jul",경남,계,6998,1619709,84807,1711514,"2019-07-01",2019
"19-Jul",제주,서귀포시,779,102215,2033,105027,"2019-07-01",2019
"19-Jul",제주,제주시,1623,267410,205237,474270,"2019-07-01",2019
"19-Jul",제주,계,2402,369625,207270,579297,"2019-07-01",2019
"19-Aug",서울,강남구,374,214735,18841,233950,"2019-08-01",2019
"19-Aug",서울,강동구,271,126539,8904,135714,"2019-08-01",2019
"19-Aug",서울,강북구,321,71469,4561,76351,"2019-08-01",2019
"19-Aug",서울,강서구,337,184745,18340,203422,"2019-08-01",2019
"19-Aug",서울,관악구,302,114697,5687,120686,"2019-08-01",2019
"19-Aug",서울,광진구,285,93601,5542,99428,"2019-08-01",2019
"19-Aug",서울,구로구,283,129861,13903,144047,"2019-08-01",2019
"19-Aug",서울,금천구,139,81417,5956,87512,"2019-08-01",2019
"19-Aug",서울,노원구,330,142898,9374,152602,"2019-08-01",2019
"19-Aug",서울,도봉구,264,89125,7454,96843,"2019-08-01",2019
"19-Aug",서울,동대문구,319,92390,5339,98048,"2019-08-01",2019
"19-Aug",서울,동작구,315,102981,2716,106012,"2019-08-01",2019
"19-Aug",서울,마포구,338,110067,7035,117440,"2019-08-01",2019
"19-Aug",서울,서대문구,458,80915,6016,87389,"2019-08-01",2019
"19-Aug",서울,서초구,555,168333,13504,182392,"2019-08-01",2019
"19-Aug",서울,성동구,338,94622,11652,106612,"2019-08-01",2019
"19-Aug",서울,성북구,286,112701,5493,118480,"2019-08-01",2019
"19-Aug",서울,송파구,384,226595,13042,240021,"2019-08-01",2019
"19-Aug",서울,양천구,321,141047,8741,150109,"2019-08-01",2019
"19-Aug",서울,영등포구,368,132357,9545,142270,"2019-08-01",2019
"19-Aug",서울,용산구,364,74164,2245,76773,"2019-08-01",2019
"19-Aug",서울,은평구,285,122584,7094,129963,"2019-08-01",2019
"19-Aug",서울,종로구,3909,44621,1666,50196,"2019-08-01",2019
"19-Aug",서울,중구,1117,45775,4780,51672,"2019-08-01",2019
"19-Aug",서울,중랑구,235,103167,9558,112960,"2019-08-01",2019
"19-Aug",서울,계,12498,2901406,206988,3120892,"2019-08-01",2019
"19-Aug",부산,강서구,321,70640,3723,74684,"2019-08-01",2019
"19-Aug",부산,금정구,276,81553,7421,89250,"2019-08-01",2019
"19-Aug",부산,기장군,251,71874,2294,74419,"2019-08-01",2019
"19-Aug",부산,남구,226,91476,8434,100136,"2019-08-01",2019
"19-Aug",부산,동구,233,45515,4535,50283,"2019-08-01",2019
"19-Aug",부산,동래구,181,89628,4264,94073,"2019-08-01",2019
"19-Aug",부산,부산진구,372,119522,14185,134079,"2019-08-01",2019
"19-Aug",부산,북구,238,100047,3336,103621,"2019-08-01",2019
"19-Aug",부산,사상구,286,84023,6013,90322,"2019-08-01",2019
"19-Aug",부산,사하구,259,107870,7055,115184,"2019-08-01",2019
"19-Aug",부산,서구,134,28146,1377,29657,"2019-08-01",2019
"19-Aug",부산,수영구,165,67338,26127,93630,"2019-08-01",2019
"19-Aug",부산,연제구,877,87396,8715,96988,"2019-08-01",2019
"19-Aug",부산,영도구,231,31285,2085,33601,"2019-08-01",2019
"19-Aug",부산,중구,316,24533,7307,32156,"2019-08-01",2019
"19-Aug",부산,해운대구,316,163048,11796,175160,"2019-08-01",2019
"19-Aug",부산,계,4682,1263894,118667,1387243,"2019-08-01",2019
"19-Aug",대구,남구,338,55441,1767,57546,"2019-08-01",2019
"19-Aug",대구,달서구,485,264329,12277,277091,"2019-08-01",2019
"19-Aug",대구,달성군,503,127781,4855,133139,"2019-08-01",2019
"19-Aug",대구,동구,342,150723,10853,161918,"2019-08-01",2019
"19-Aug",대구,북구,487,195992,7897,204376,"2019-08-01",2019
"19-Aug",대구,서구,234,70695,4077,75006,"2019-08-01",2019
"19-Aug",대구,수성구,569,212720,5330,218619,"2019-08-01",2019
"19-Aug",대구,중구,285,54256,1827,56368,"2019-08-01",2019
"19-Aug",대구,계,3243,1131937,48883,1184063,"2019-08-01",2019
"19-Aug",인천,강화군,316,33328,49843,83487,"2019-08-01",2019
"19-Aug",인천,계양구,283,120543,184068,304894,"2019-08-01",2019
"19-Aug",인천,남동구,856,251155,42577,294588,"2019-08-01",2019
"19-Aug",인천,동구,86,26290,3268,29644,"2019-08-01",2019
"19-Aug",인천,미추홀구,410,152072,9232,161714,"2019-08-01",2019
"19-Aug",인천,부평구,335,214572,12898,227805,"2019-08-01",2019
"19-Aug",인천,서구,400,231839,11056,243295,"2019-08-01",2019
"19-Aug",인천,연수구,400,174006,7798,182204,"2019-08-01",2019
"19-Aug",인천,옹진군,198,11652,205,12055,"2019-08-01",2019
"19-Aug",인천,중구,677,60258,18200,79135,"2019-08-01",2019
"19-Aug",인천,계,3961,1275715,339145,1618821,"2019-08-01",2019
"19-Aug",광주,광산구,505,186948,11915,199368,"2019-08-01",2019
"19-Aug",광주,남구,214,88126,2631,90971,"2019-08-01",2019
"19-Aug",광주,동구,239,38486,1137,39862,"2019-08-01",2019
"19-Aug",광주,북구,602,184430,9972,195004,"2019-08-01",2019
"19-Aug",광주,서구,637,140584,6978,148199,"2019-08-01",2019
"19-Aug",광주,계,2197,638574,32633,673404,"2019-08-01",2019
"19-Aug",대전,대덕구,229,84300,6770,91299,"2019-08-01",2019
"19-Aug",대전,동구,247,89032,4324,93603,"2019-08-01",2019
"19-Aug",대전,서구,789,202285,7366,210440,"2019-08-01",2019
"19-Aug",대전,유성구,377,167948,5236,173561,"2019-08-01",2019
"19-Aug",대전,중구,235,96764,5969,102968,"2019-08-01",2019
"19-Aug",대전,계,1877,640329,29665,671871,"2019-08-01",2019
"19-Aug",울산,남구,710,151416,7182,159308,"2019-08-01",2019
"19-Aug",울산,동구,194,61726,968,62888,"2019-08-01",2019
"19-Aug",울산,북구,183,106854,3728,110765,"2019-08-01",2019
"19-Aug",울산,울주군,371,119701,6823,126895,"2019-08-01",2019
"19-Aug",울산,중구,344,100828,2656,103828,"2019-08-01",2019
"19-Aug",울산,계,1802,540525,21357,563684,"2019-08-01",2019
"19-Aug",세종,세종특별자치시,742,155205,2703,158650,"2019-08-01",2019
"19-Aug",세종,계,742,155205,2703,158650,"2019-08-01",2019
"19-Aug",경기,가평군,364,29832,637,30833,"2019-08-01",2019
"19-Aug",경기,고양시 덕양구,690,166878,3942,171510,"2019-08-01",2019
"19-Aug",경기,고양시 일산동구,280,118249,6477,125006,"2019-08-01",2019
"19-Aug",경기,고양시 일산서구,129,113315,4091,117535,"2019-08-01",2019
"19-Aug",경기,과천시,716,20659,604,21979,"2019-08-01",2019
"19-Aug",경기,광명시,313,103382,4164,107859,"2019-08-01",2019
"19-Aug",경기,광주시,371,180058,8191,188620,"2019-08-01",2019
"19-Aug",경기,구리시,242,69872,2611,72725,"2019-08-01",2019
"19-Aug",경기,군포시,290,95778,5084,101152,"2019-08-01",2019
"19-Aug",경기,김포시,469,199591,7355,207415,"2019-08-01",2019
"19-Aug",경기,남양주시,670,279456,7730,287856,"2019-08-01",2019
"19-Aug",경기,동두천시,208,36712,1325,38245,"2019-08-01",2019
"19-Aug",경기,부천시,729,293388,12935,307052,"2019-08-01",2019
"19-Aug",경기,성남시 분당구,348,182390,6991,189729,"2019-08-01",2019
"19-Aug",경기,성남시 수정구,346,71146,2341,73833,"2019-08-01",2019
"19-Aug",경기,성남시 중원구,320,70954,4371,75645,"2019-08-01",2019
"19-Aug",경기,수원시 권선구,354,173072,8111,181537,"2019-08-01",2019
"19-Aug",경기,수원시 영통구,214,141388,3267,144869,"2019-08-01",2019
"19-Aug",경기,수원시 장안구,581,102416,3827,106824,"2019-08-01",2019
"19-Aug",경기,수원시 팔달구,486,68072,3015,71573,"2019-08-01",2019
"19-Aug",경기,시흥시,452,222885,7663,231000,"2019-08-01",2019
"19-Aug",경기,안산시 단원구,558,149941,8091,158590,"2019-08-01",2019
"19-Aug",경기,안산시 상록구,181,135556,4800,140537,"2019-08-01",2019
"19-Aug",경기,안성시,381,97632,5037,103050,"2019-08-01",2019
"19-Aug",경기,안양시 동안구,404,116408,6285,123097,"2019-08-01",2019
"19-Aug",경기,안양시 만안구,148,83780,3928,87856,"2019-08-01",2019
"19-Aug",경기,양주시,376,99522,3112,103010,"2019-08-01",2019
"19-Aug",경기,양평군,556,57415,1756,59727,"2019-08-01",2019
"19-Aug",경기,여주시,430,60664,7334,68428,"2019-08-01",2019
"19-Aug",경기,연천군,298,23278,5337,28913,"2019-08-01",2019
"19-Aug",경기,오산시,202,98396,3365,101963,"2019-08-01",2019
"19-Aug",경기,용인시 기흥구,123,182734,5960,188817,"2019-08-01",2019
"19-Aug",경기,용인시 수지구,48,136376,2307,138731,"2019-08-01",2019
"19-Aug",경기,용인시 처인구,719,124411,7098,132228,"2019-08-01",2019
"19-Aug",경기,의왕시,300,60601,3200,64101,"2019-08-01",2019
"19-Aug",경기,의정부시,632,153038,5000,158670,"2019-08-01",2019
"19-Aug",경기,이천시,396,107347,5801,113544,"2019-08-01",2019
"19-Aug",경기,파주시,510,201600,9409,211519,"2019-08-01",2019
"19-Aug",경기,평택시,699,255920,11780,268399,"2019-08-01",2019
"19-Aug",경기,포천시,370,82469,9541,92380,"2019-08-01",2019
"19-Aug",경기,하남시,389,108442,2650,111481,"2019-08-01",2019
"19-Aug",경기,화성시,857,405232,11052,417141,"2019-08-01",2019
"19-Aug",경기,계,17149,5480255,227575,5724979,"2019-08-01",2019
"19-Aug",강원,강릉시,519,103364,4738,108621,"2019-08-01",2019
"19-Aug",강원,고성군,179,13736,232,14147,"2019-08-01",2019
"19-Aug",강원,동해시,299,43368,1373,45040,"2019-08-01",2019
"19-Aug",강원,삼척시,391,31632,702,32725,"2019-08-01",2019
"19-Aug",강원,속초시,296,36187,1370,37853,"2019-08-01",2019
"19-Aug",강원,양구군,175,11920,123,12218,"2019-08-01",2019
"19-Aug",강원,양양군,179,15058,233,15470,"2019-08-01",2019
"19-Aug",강원,영월군,328,20564,367,21259,"2019-08-01",2019
"19-Aug",강원,원주시,532,163930,5871,170333,"2019-08-01",2019
"19-Aug",강원,인제군,215,17534,294,18043,"2019-08-01",2019
"19-Aug",강원,정선군,335,20139,469,20943,"2019-08-01",2019
"19-Aug",강원,철원군,223,23636,306,24165,"2019-08-01",2019
"19-Aug",강원,춘천시,774,126765,5928,133467,"2019-08-01",2019
"19-Aug",강원,태백시,225,20072,791,21088,"2019-08-01",2019
"19-Aug",강원,평창군,284,25196,519,25999,"2019-08-01",2019
"19-Aug",강원,홍천군,405,37417,1095,38917,"2019-08-01",2019
"19-Aug",강원,화천군,220,12534,203,12957,"2019-08-01",2019
"19-Aug",강원,횡성군,242,25429,689,26360,"2019-08-01",2019
"19-Aug",강원,계,5821,748481,25303,779605,"2019-08-01",2019
"19-Aug",충북,괴산군,195,21822,382,22399,"2019-08-01",2019
"19-Aug",충북,단양군,206,15630,776,16612,"2019-08-01",2019
"19-Aug",충북,보은군,214,17589,890,18693,"2019-08-01",2019
"19-Aug",충북,영동군,230,24611,382,25223,"2019-08-01",2019
"19-Aug",충북,옥천군,200,26058,1106,27364,"2019-08-01",2019
"19-Aug",충북,음성군,217,56766,1824,58807,"2019-08-01",2019
"19-Aug",충북,제천시,323,65661,3566,69550,"2019-08-01",2019
"19-Aug",충북,증평군,93,18691,755,19539,"2019-08-01",2019
"19-Aug",충북,진천군,208,46161,1310,47679,"2019-08-01",2019
"19-Aug",충북,청원군,1,19,0,20,"2019-08-01",2019
"19-Aug",충북,청주시 상당구,505,81175,2475,84155,"2019-08-01",2019
"19-Aug",충북,청주시 서원구,230,93632,5224,99086,"2019-08-01",2019
"19-Aug",충북,청주시 청원구,347,100113,3993,104453,"2019-08-01",2019
"19-Aug",충북,청주시 흥덕구,357,120609,7323,128289,"2019-08-01",2019
"19-Aug",충북,충주시,580,105423,5310,111313,"2019-08-01",2019
"19-Aug",충북,계,3906,793960,35316,833182,"2019-08-01",2019
"19-Aug",충남,계룡시,148,21232,546,21926,"2019-08-01",2019
"19-Aug",충남,공주시,578,52793,2211,55582,"2019-08-01",2019
"19-Aug",충남,금산군,188,27815,2036,30039,"2019-08-01",2019
"19-Aug",충남,논산시,377,59820,2298,62495,"2019-08-01",2019
"19-Aug",충남,당진시,371,91531,3819,95721,"2019-08-01",2019
"19-Aug",충남,보령시,395,50920,1295,52610,"2019-08-01",2019
"19-Aug",충남,부여군,273,33637,1266,35176,"2019-08-01",2019
"19-Aug",충남,서산시,398,90540,3473,94411,"2019-08-01",2019
"19-Aug",충남,서천군,230,26611,883,27724,"2019-08-01",2019
"19-Aug",충남,아산시,484,159195,6028,165707,"2019-08-01",2019
"19-Aug",충남,예산군,384,42111,1446,43941,"2019-08-01",2019
"19-Aug",충남,천안시 동남구,226,126271,4742,131239,"2019-08-01",2019
"19-Aug",충남,천안시 서북구,528,184076,5760,190364,"2019-08-01",2019
"19-Aug",충남,청양군,245,16504,840,17589,"2019-08-01",2019
"19-Aug",충남,태안군,284,33193,501,33978,"2019-08-01",2019
"19-Aug",충남,홍성군,409,51165,1415,52989,"2019-08-01",2019
"19-Aug",충남,계,5518,1067414,38559,1111491,"2019-08-01",2019
"19-Aug",전북,고창군,272,29938,599,30809,"2019-08-01",2019
"19-Aug",전북,군산시,520,126805,6509,133834,"2019-08-01",2019
"19-Aug",전북,김제시,289,44198,1938,46425,"2019-08-01",2019
"19-Aug",전북,남원시,407,39602,5540,45549,"2019-08-01",2019
"19-Aug",전북,무주군,184,12387,370,12941,"2019-08-01",2019
"19-Aug",전북,부안군,257,27085,611,27953,"2019-08-01",2019
"19-Aug",전북,순창군,218,14306,186,14710,"2019-08-01",2019
"19-Aug",전북,완주군,357,49891,3303,53551,"2019-08-01",2019
"19-Aug",전북,익산시,493,135245,6282,142020,"2019-08-01",2019
"19-Aug",전북,임실군,207,14134,426,14767,"2019-08-01",2019
"19-Aug",전북,장수군,234,11848,174,12256,"2019-08-01",2019
"19-Aug",전북,전주시 덕진구,387,162879,7515,170781,"2019-08-01",2019
"19-Aug",전북,전주시 완산구,594,146438,4099,151131,"2019-08-01",2019
"19-Aug",전북,정읍시,328,53249,3686,57263,"2019-08-01",2019
"19-Aug",전북,진안군,238,13771,199,14208,"2019-08-01",2019
"19-Aug",전북,계,4985,881776,41437,928198,"2019-08-01",2019
"19-Aug",전남,강진군,216,18097,1121,19434,"2019-08-01",2019
"19-Aug",전남,고흥군,295,30659,650,31604,"2019-08-01",2019
"19-Aug",전남,곡성군,149,14375,737,15261,"2019-08-01",2019
"19-Aug",전남,광양시,250,78842,5964,85056,"2019-08-01",2019
"19-Aug",전남,구례군,139,12909,637,13685,"2019-08-01",2019
"19-Aug",전남,나주시,456,61173,3321,64950,"2019-08-01",2019
"19-Aug",전남,담양군,204,25628,1559,27391,"2019-08-01",2019
"19-Aug",전남,목포시,441,94403,5811,100655,"2019-08-01",2019
"19-Aug",전남,무안군,552,41390,968,42910,"2019-08-01",2019
"19-Aug",전남,보성군,201,21098,54098,75397,"2019-08-01",2019
"19-Aug",전남,순천시,503,133368,5142,139013,"2019-08-01",2019
"19-Aug",전남,신안군,241,20462,849,21552,"2019-08-01",2019
"19-Aug",전남,여수시,536,126387,6973,133896,"2019-08-01",2019
"19-Aug",전남,영광군,204,26711,723,27638,"2019-08-01",2019
"19-Aug",전남,영암군,246,32241,12555,45042,"2019-08-01",2019
"19-Aug",전남,완도군,239,24552,505,25296,"2019-08-01",2019
"19-Aug",전남,장성군,183,25795,1149,27127,"2019-08-01",2019
"19-Aug",전남,장흥군,200,19649,456,20305,"2019-08-01",2019
"19-Aug",전남,진도군,158,16125,304,16587,"2019-08-01",2019
"19-Aug",전남,함평군,188,17590,25173,42951,"2019-08-01",2019
"19-Aug",전남,해남군,336,38073,580,38989,"2019-08-01",2019
"19-Aug",전남,화순군,217,31157,2047,33421,"2019-08-01",2019
"19-Aug",전남,계,6154,910684,131322,1048160,"2019-08-01",2019
"19-Aug",경북,경산시,318,133187,4428,137933,"2019-08-01",2019
"19-Aug",경북,경주시,580,137143,4629,142352,"2019-08-01",2019
"19-Aug",경북,고령군,162,20244,534,20940,"2019-08-01",2019
"19-Aug",경북,구미시,537,207382,7268,215187,"2019-08-01",2019
"19-Aug",경북,군위군,121,14308,280,14709,"2019-08-01",2019
"19-Aug",경북,김천시,380,71576,1853,73809,"2019-08-01",2019
"19-Aug",경북,문경시,282,35324,810,36416,"2019-08-01",2019
"19-Aug",경북,봉화군,212,17349,207,17768,"2019-08-01",2019
"19-Aug",경북,상주시,381,51645,1852,53878,"2019-08-01",2019
"19-Aug",경북,성주군,199,29516,1397,31112,"2019-08-01",2019
"19-Aug",경북,안동시,713,79650,2604,82967,"2019-08-01",2019
"19-Aug",경북,영덕군,253,18602,283,19138,"2019-08-01",2019
"19-Aug",경북,영양군,146,9367,104,9617,"2019-08-01",2019
"19-Aug",경북,영주시,376,54331,1498,56205,"2019-08-01",2019
"19-Aug",경북,영천시,296,57642,2644,60582,"2019-08-01",2019
"19-Aug",경북,예천군,266,27894,468,28628,"2019-08-01",2019
"19-Aug",경북,울릉군,149,5230,532,5911,"2019-08-01",2019
"19-Aug",경북,울진군,301,25310,341,25952,"2019-08-01",2019
"19-Aug",경북,의성군,303,29548,945,30796,"2019-08-01",2019
"19-Aug",경북,청도군,203,24266,701,25170,"2019-08-01",2019
"19-Aug",경북,청송군,199,15042,203,15444,"2019-08-01",2019
"19-Aug",경북,칠곡군,331,67457,2275,70063,"2019-08-01",2019
"19-Aug",경북,포항시 남구,440,119384,8720,128544,"2019-08-01",2019
"19-Aug",경북,포항시 북구,332,132722,3912,136966,"2019-08-01",2019
"19-Aug",경북,계,7480,1384119,48488,1440087,"2019-08-01",2019
"19-Aug",경남,거제시,348,103404,2151,105903,"2019-08-01",2019
"19-Aug",경남,거창군,255,31057,800,32112,"2019-08-01",2019
"19-Aug",경남,고성군,212,26092,647,26951,"2019-08-01",2019
"19-Aug",경남,김해시,647,263557,7212,271416,"2019-08-01",2019
"19-Aug",경남,남해군,256,19112,485,19853,"2019-08-01",2019
"19-Aug",경남,밀양시,311,54022,3944,58277,"2019-08-01",2019
"19-Aug",경남,사천시,304,54681,1502,56487,"2019-08-01",2019
"19-Aug",경남,산청군,229,19465,792,20486,"2019-08-01",2019
"19-Aug",경남,양산시,400,158140,9833,168373,"2019-08-01",2019
"19-Aug",경남,의령군,190,13947,678,14815,"2019-08-01",2019
"19-Aug",경남,진주시,608,159721,6725,167054,"2019-08-01",2019
"19-Aug",경남,창녕군,233,34614,961,35808,"2019-08-01",2019
"19-Aug",경남,창원시 마산합포구,331,98645,2926,101902,"2019-08-01",2019
"19-Aug",경남,창원시 마산회원구,178,92866,5173,98217,"2019-08-01",2019
"19-Aug",경남,창원시 성산구,142,116419,12632,129193,"2019-08-01",2019
"19-Aug",경남,창원시 의창구,944,130368,11516,142828,"2019-08-01",2019
"19-Aug",경남,창원시 진해구,215,88049,1664,89928,"2019-08-01",2019
"19-Aug",경남,통영시,320,51960,1472,53752,"2019-08-01",2019
"19-Aug",경남,하동군,224,24133,458,24815,"2019-08-01",2019
"19-Aug",경남,함안군,189,40188,12357,52734,"2019-08-01",2019
"19-Aug",경남,함양군,212,18899,449,19560,"2019-08-01",2019
"19-Aug",경남,합천군,258,22616,648,23522,"2019-08-01",2019
"19-Aug",경남,계,7006,1621955,85025,1713986,"2019-08-01",2019
"19-Aug",제주,서귀포시,789,102377,2034,105200,"2019-08-01",2019
"19-Aug",제주,제주시,1624,267340,209058,478022,"2019-08-01",2019
"19-Aug",제주,계,2413,369717,211092,583222,"2019-08-01",2019
"19-Sep",서울,강남구,388,215217,18723,234328,"2019-09-01",2019
"19-Sep",서울,강동구,273,126664,8871,135808,"2019-09-01",2019
"19-Sep",서울,강북구,321,71466,4565,76352,"2019-09-01",2019
"19-Sep",서울,강서구,337,184760,18454,203551,"2019-09-01",2019
"19-Sep",서울,관악구,299,114849,5702,120850,"2019-09-01",2019
"19-Sep",서울,광진구,290,93536,5573,99399,"2019-09-01",2019
"19-Sep",서울,구로구,290,130076,13941,144307,"2019-09-01",2019
"19-Sep",서울,금천구,137,81347,6016,87500,"2019-09-01",2019
"19-Sep",서울,노원구,329,142815,9420,152564,"2019-09-01",2019
"19-Sep",서울,도봉구,269,89092,7439,96800,"2019-09-01",2019
"19-Sep",서울,동대문구,318,92443,5263,98024,"2019-09-01",2019
"19-Sep",서울,동작구,317,102954,2715,105986,"2019-09-01",2019
"19-Sep",서울,마포구,337,110332,7025,117694,"2019-09-01",2019
"19-Sep",서울,서대문구,462,80851,6019,87332,"2019-09-01",2019
"19-Sep",서울,서초구,550,167927,13401,181878,"2019-09-01",2019
"19-Sep",서울,성동구,335,94416,11841,106592,"2019-09-01",2019
"19-Sep",서울,성북구,285,112777,5482,118544,"2019-09-01",2019
"19-Sep",서울,송파구,385,226683,13100,240168,"2019-09-01",2019
"19-Sep",서울,양천구,326,140928,8707,149961,"2019-09-01",2019
"19-Sep",서울,영등포구,370,132244,9539,142153,"2019-09-01",2019
"19-Sep",서울,용산구,365,74057,2259,76681,"2019-09-01",2019
"19-Sep",서울,은평구,291,122748,7070,130109,"2019-09-01",2019
"19-Sep",서울,종로구,3942,44603,1663,50208,"2019-09-01",2019
"19-Sep",서울,중구,1098,46021,4753,51872,"2019-09-01",2019
"19-Sep",서울,중랑구,241,103250,9535,113026,"2019-09-01",2019
"19-Sep",서울,계,12555,2902056,207076,3121687,"2019-09-01",2019
"19-Sep",부산,강서구,322,70841,3685,74848,"2019-09-01",2019
"19-Sep",부산,금정구,277,81447,7365,89089,"2019-09-01",2019
"19-Sep",부산,기장군,251,71998,2298,74547,"2019-09-01",2019
"19-Sep",부산,남구,225,91464,8454,100143,"2019-09-01",2019
"19-Sep",부산,동구,236,45785,4511,50532,"2019-09-01",2019
"19-Sep",부산,동래구,183,90049,4271,94503,"2019-09-01",2019
"19-Sep",부산,부산진구,374,119654,14234,134262,"2019-09-01",2019
"19-Sep",부산,북구,236,100147,3336,103719,"2019-09-01",2019
"19-Sep",부산,사상구,287,83927,6009,90223,"2019-09-01",2019
"19-Sep",부산,사하구,264,107907,7060,115231,"2019-09-01",2019
"19-Sep",부산,서구,134,28098,1383,29615,"2019-09-01",2019
"19-Sep",부산,수영구,169,67314,26813,94296,"2019-09-01",2019
"19-Sep",부산,연제구,878,87375,8795,97048,"2019-09-01",2019
"19-Sep",부산,영도구,234,31209,2078,33521,"2019-09-01",2019
"19-Sep",부산,중구,316,24733,7319,32368,"2019-09-01",2019
"19-Sep",부산,해운대구,321,163270,12114,175705,"2019-09-01",2019
"19-Sep",부산,계,4707,1265218,119725,1389650,"2019-09-01",2019
"19-Sep",대구,남구,335,55513,1778,57626,"2019-09-01",2019
"19-Sep",대구,달서구,484,264892,12234,277610,"2019-09-01",2019
"19-Sep",대구,달성군,504,128111,4868,133483,"2019-09-01",2019
"19-Sep",대구,동구,345,150712,10828,161885,"2019-09-01",2019
"19-Sep",대구,북구,486,196221,7916,204623,"2019-09-01",2019
"19-Sep",대구,서구,234,70560,4129,74923,"2019-09-01",2019
"19-Sep",대구,수성구,564,212938,5351,218853,"2019-09-01",2019
"19-Sep",대구,중구,286,54538,1822,56646,"2019-09-01",2019
"19-Sep",대구,계,3238,1133485,48926,1185649,"2019-09-01",2019
"19-Sep",인천,강화군,319,33373,49902,83594,"2019-09-01",2019
"19-Sep",인천,계양구,284,120555,184359,305198,"2019-09-01",2019
"19-Sep",인천,남동구,829,251209,42343,294381,"2019-09-01",2019
"19-Sep",인천,동구,92,26316,3350,29758,"2019-09-01",2019
"19-Sep",인천,미추홀구,410,152518,9196,162124,"2019-09-01",2019
"19-Sep",인천,부평구,333,214556,13208,228097,"2019-09-01",2019
"19-Sep",인천,서구,403,231837,11112,243352,"2019-09-01",2019
"19-Sep",인천,연수구,399,175052,7361,182812,"2019-09-01",2019
"19-Sep",인천,옹진군,201,11655,205,12061,"2019-09-01",2019
"19-Sep",인천,중구,667,60501,18201,79369,"2019-09-01",2019
"19-Sep",인천,계,3937,1277572,339237,1620746,"2019-09-01",2019
"19-Sep",광주,광산구,510,187186,11928,199624,"2019-09-01",2019
"19-Sep",광주,남구,213,88237,2633,91083,"2019-09-01",2019
"19-Sep",광주,동구,242,38850,1156,40248,"2019-09-01",2019
"19-Sep",광주,북구,604,184817,9921,195342,"2019-09-01",2019
"19-Sep",광주,서구,638,140578,6957,148173,"2019-09-01",2019
"19-Sep",광주,계,2207,639668,32595,674470,"2019-09-01",2019
"19-Sep",대전,대덕구,231,84170,6779,91180,"2019-09-01",2019
"19-Sep",대전,동구,247,89145,4351,93743,"2019-09-01",2019
"19-Sep",대전,서구,795,202738,7365,210898,"2019-09-01",2019
"19-Sep",대전,유성구,376,168212,5232,173820,"2019-09-01",2019
"19-Sep",대전,중구,235,96639,5979,102853,"2019-09-01",2019
"19-Sep",대전,계,1884,640904,29706,672494,"2019-09-01",2019
"19-Sep",울산,남구,710,151374,7204,159288,"2019-09-01",2019
"19-Sep",울산,동구,192,61727,969,62888,"2019-09-01",2019
"19-Sep",울산,북구,184,107298,3723,111205,"2019-09-01",2019
"19-Sep",울산,울주군,372,119987,6819,127178,"2019-09-01",2019
"19-Sep",울산,중구,343,100802,2661,103806,"2019-09-01",2019
"19-Sep",울산,계,1801,541188,21376,564365,"2019-09-01",2019
"19-Sep",세종,세종특별자치시,745,156239,2707,159691,"2019-09-01",2019
"19-Sep",세종,계,745,156239,2707,159691,"2019-09-01",2019
"19-Sep",경기,가평군,367,29862,628,30857,"2019-09-01",2019
"19-Sep",경기,고양시 덕양구,670,167589,3950,172209,"2019-09-01",2019
"19-Sep",경기,고양시 일산동구,286,118554,6402,125242,"2019-09-01",2019
"19-Sep",경기,고양시 일산서구,129,113159,4122,117410,"2019-09-01",2019
"19-Sep",경기,과천시,720,20638,602,21960,"2019-09-01",2019
"19-Sep",경기,광명시,309,103131,4203,107643,"2019-09-01",2019
"19-Sep",경기,광주시,371,180833,8221,189425,"2019-09-01",2019
"19-Sep",경기,구리시,245,69676,2603,72524,"2019-09-01",2019
"19-Sep",경기,군포시,291,95730,5073,101094,"2019-09-01",2019
"19-Sep",경기,김포시,466,199753,7346,207565,"2019-09-01",2019
"19-Sep",경기,남양주시,677,280403,7795,288875,"2019-09-01",2019
"19-Sep",경기,동두천시,206,36748,1328,38282,"2019-09-01",2019
"19-Sep",경기,부천시,717,292641,12941,306299,"2019-09-01",2019
"19-Sep",경기,성남시 분당구,351,182195,6938,189484,"2019-09-01",2019
"19-Sep",경기,성남시 수정구,350,71417,2357,74124,"2019-09-01",2019
"19-Sep",경기,성남시 중원구,320,70940,4360,75620,"2019-09-01",2019
"19-Sep",경기,수원시 권선구,354,172912,8314,181580,"2019-09-01",2019
"19-Sep",경기,수원시 영통구,214,142144,3278,145636,"2019-09-01",2019
"19-Sep",경기,수원시 장안구,588,102299,3827,106714,"2019-09-01",2019
"19-Sep",경기,수원시 팔달구,487,67917,3009,71413,"2019-09-01",2019
"19-Sep",경기,시흥시,457,223237,7435,231129,"2019-09-01",2019
"19-Sep",경기,안산시 단원구,554,149552,8093,158199,"2019-09-01",2019
"19-Sep",경기,안산시 상록구,178,134774,4833,139785,"2019-09-01",2019
"19-Sep",경기,안성시,386,97562,5028,102976,"2019-09-01",2019
"19-Sep",경기,안양시 동안구,401,116369,6290,123060,"2019-09-01",2019
"19-Sep",경기,안양시 만안구,147,83613,3927,87687,"2019-09-01",2019
"19-Sep",경기,양주시,379,99500,3109,102988,"2019-09-01",2019
"19-Sep",경기,양평군,554,57525,1776,59855,"2019-09-01",2019
"19-Sep",경기,여주시,430,60478,7351,68259,"2019-09-01",2019
"19-Sep",경기,연천군,297,23281,5330,28908,"2019-09-01",2019
"19-Sep",경기,오산시,204,98979,3366,102549,"2019-09-01",2019
"19-Sep",경기,용인시 기흥구,125,182075,5997,188197,"2019-09-01",2019
"19-Sep",경기,용인시 수지구,48,136800,2301,139149,"2019-09-01",2019
"19-Sep",경기,용인시 처인구,738,124178,7136,132052,"2019-09-01",2019
"19-Sep",경기,의왕시,292,60781,3194,64267,"2019-09-01",2019
"19-Sep",경기,의정부시,637,152814,5018,158469,"2019-09-01",2019
"19-Sep",경기,이천시,400,107325,5823,113548,"2019-09-01",2019
"19-Sep",경기,파주시,510,201595,9395,211500,"2019-09-01",2019
"19-Sep",경기,평택시,700,256838,11777,269315,"2019-09-01",2019
"19-Sep",경기,포천시,374,82473,10472,93319,"2019-09-01",2019
"19-Sep",경기,하남시,386,109036,2656,112078,"2019-09-01",2019
"19-Sep",경기,화성시,863,406881,11167,418911,"2019-09-01",2019
"19-Sep",경기,계,17178,5484207,228771,5730156,"2019-09-01",2019
"19-Sep",강원,강릉시,514,103746,4710,108970,"2019-09-01",2019
"19-Sep",강원,고성군,178,13766,234,14178,"2019-09-01",2019
"19-Sep",강원,동해시,299,43522,1376,45197,"2019-09-01",2019
"19-Sep",강원,삼척시,385,31674,706,32765,"2019-09-01",2019
"19-Sep",강원,속초시,293,36236,1349,37878,"2019-09-01",2019
"19-Sep",강원,양구군,179,11908,123,12210,"2019-09-01",2019
"19-Sep",강원,양양군,181,15052,235,15468,"2019-09-01",2019
"19-Sep",강원,영월군,328,20494,358,21180,"2019-09-01",2019
"19-Sep",강원,원주시,529,164456,5887,170872,"2019-09-01",2019
"19-Sep",강원,인제군,212,17540,292,18044,"2019-09-01",2019
"19-Sep",강원,정선군,331,20155,468,20954,"2019-09-01",2019
"19-Sep",강원,철원군,224,23706,304,24234,"2019-09-01",2019
"19-Sep",강원,춘천시,791,126982,5920,133693,"2019-09-01",2019
"19-Sep",강원,태백시,224,20120,792,21136,"2019-09-01",2019
"19-Sep",강원,평창군,285,25181,522,25988,"2019-09-01",2019
"19-Sep",강원,홍천군,412,37460,1093,38965,"2019-09-01",2019
"19-Sep",강원,화천군,221,12485,204,12910,"2019-09-01",2019
"19-Sep",강원,횡성군,244,25489,697,26430,"2019-09-01",2019
"19-Sep",강원,계,5830,749972,25270,781072,"2019-09-01",2019
"19-Sep",충북,괴산군,198,21828,378,22404,"2019-09-01",2019
"19-Sep",충북,단양군,221,15628,771,16620,"2019-09-01",2019
"19-Sep",충북,보은군,216,17623,893,18732,"2019-09-01",2019
"19-Sep",충북,영동군,230,24708,384,25322,"2019-09-01",2019
"19-Sep",충북,옥천군,199,26081,1108,27388,"2019-09-01",2019
"19-Sep",충북,음성군,218,56784,1826,58828,"2019-09-01",2019
"19-Sep",충북,제천시,326,65786,3558,69670,"2019-09-01",2019
"19-Sep",충북,증평군,94,18762,757,19613,"2019-09-01",2019
"19-Sep",충북,진천군,209,46360,1302,47871,"2019-09-01",2019
"19-Sep",충북,청원군,1,19,0,20,"2019-09-01",2019
"19-Sep",충북,청주시 상당구,504,81475,2481,84460,"2019-09-01",2019
"19-Sep",충북,청주시 서원구,230,93726,5140,99096,"2019-09-01",2019
"19-Sep",충북,청주시 청원구,348,100309,4076,104733,"2019-09-01",2019
"19-Sep",충북,청주시 흥덕구,364,120849,7311,128524,"2019-09-01",2019
"19-Sep",충북,충주시,582,105840,5401,111823,"2019-09-01",2019
"19-Sep",충북,계,3940,795778,35386,835104,"2019-09-01",2019
"19-Sep",충남,계룡시,149,21289,548,21986,"2019-09-01",2019
"19-Sep",충남,공주시,575,52859,2216,55650,"2019-09-01",2019
"19-Sep",충남,금산군,185,27909,2107,30201,"2019-09-01",2019
"19-Sep",충남,논산시,374,60000,2313,62687,"2019-09-01",2019
"19-Sep",충남,당진시,372,91816,3827,96015,"2019-09-01",2019
"19-Sep",충남,보령시,392,51027,1300,52719,"2019-09-01",2019
"19-Sep",충남,부여군,276,33705,1264,35245,"2019-09-01",2019
"19-Sep",충남,서산시,400,90835,3476,94711,"2019-09-01",2019
"19-Sep",충남,서천군,229,26672,879,27780,"2019-09-01",2019
"19-Sep",충남,아산시,492,159648,6517,166657,"2019-09-01",2019
"19-Sep",충남,예산군,384,42184,1445,44013,"2019-09-01",2019
"19-Sep",충남,천안시 동남구,229,126513,4763,131505,"2019-09-01",2019
"19-Sep",충남,천안시 서북구,529,184342,5741,190612,"2019-09-01",2019
"19-Sep",충남,청양군,246,16560,832,17638,"2019-09-01",2019
"19-Sep",충남,태안군,282,33236,498,34016,"2019-09-01",2019
"19-Sep",충남,홍성군,410,51354,1421,53185,"2019-09-01",2019
"19-Sep",충남,계,5524,1069949,39147,1114620,"2019-09-01",2019
"19-Sep",전북,고창군,273,29786,598,30657,"2019-09-01",2019
"19-Sep",전북,군산시,520,126897,6506,133923,"2019-09-01",2019
"19-Sep",전북,김제시,289,44192,1939,46420,"2019-09-01",2019
"19-Sep",전북,남원시,408,39718,5481,45607,"2019-09-01",2019
"19-Sep",전북,무주군,182,12406,374,12962,"2019-09-01",2019
"19-Sep",전북,부안군,256,27184,623,28063,"2019-09-01",2019
"19-Sep",전북,순창군,218,14325,185,14728,"2019-09-01",2019
"19-Sep",전북,완주군,356,49919,3289,53564,"2019-09-01",2019
"19-Sep",전북,익산시,493,135104,6271,141868,"2019-09-01",2019
"19-Sep",전북,임실군,202,14149,425,14776,"2019-09-01",2019
"19-Sep",전북,장수군,236,11827,174,12237,"2019-09-01",2019
"19-Sep",전북,전주시 덕진구,392,163555,7477,171424,"2019-09-01",2019
"19-Sep",전북,전주시 완산구,596,146676,4136,151408,"2019-09-01",2019
"19-Sep",전북,정읍시,326,53144,3638,57108,"2019-09-01",2019
"19-Sep",전북,진안군,239,13683,201,14123,"2019-09-01",2019
"19-Sep",전북,계,4986,882565,41317,928868,"2019-09-01",2019
"19-Sep",전남,강진군,218,18153,1131,19502,"2019-09-01",2019
"19-Sep",전남,고흥군,295,30766,651,31712,"2019-09-01",2019
"19-Sep",전남,곡성군,149,14387,734,15270,"2019-09-01",2019
"19-Sep",전남,광양시,247,78912,5960,85119,"2019-09-01",2019
"19-Sep",전남,구례군,139,12932,638,13709,"2019-09-01",2019
"19-Sep",전남,나주시,457,61401,3313,65171,"2019-09-01",2019
"19-Sep",전남,담양군,201,25712,1551,27464,"2019-09-01",2019
"19-Sep",전남,목포시,440,94553,5814,100807,"2019-09-01",2019
"19-Sep",전남,무안군,551,41464,966,42981,"2019-09-01",2019
"19-Sep",전남,보성군,200,21129,52943,74272,"2019-09-01",2019
"19-Sep",전남,순천시,499,133757,5144,139400,"2019-09-01",2019
"19-Sep",전남,신안군,249,20501,852,21602,"2019-09-01",2019
"19-Sep",전남,여수시,539,126757,7006,134302,"2019-09-01",2019
"19-Sep",전남,영광군,206,26802,725,27733,"2019-09-01",2019
"19-Sep",전남,영암군,246,32421,12387,45054,"2019-09-01",2019
"19-Sep",전남,완도군,239,24592,510,25341,"2019-09-01",2019
"19-Sep",전남,장성군,184,26000,1153,27337,"2019-09-01",2019
"19-Sep",전남,장흥군,198,19708,455,20361,"2019-09-01",2019
"19-Sep",전남,진도군,159,16135,301,16595,"2019-09-01",2019
"19-Sep",전남,함평군,189,17640,26942,44771,"2019-09-01",2019
"19-Sep",전남,해남군,338,37945,588,38871,"2019-09-01",2019
"19-Sep",전남,화순군,216,31256,2064,33536,"2019-09-01",2019
"19-Sep",전남,계,6159,912923,131828,1050910,"2019-09-01",2019
"19-Sep",경북,경산시,323,133440,4403,138166,"2019-09-01",2019
"19-Sep",경북,경주시,580,137264,4596,142440,"2019-09-01",2019
"19-Sep",경북,고령군,162,20272,532,20966,"2019-09-01",2019
"19-Sep",경북,구미시,529,207860,7264,215653,"2019-09-01",2019
"19-Sep",경북,군위군,116,14372,281,14769,"2019-09-01",2019
"19-Sep",경북,김천시,384,71768,1859,74011,"2019-09-01",2019
"19-Sep",경북,문경시,279,35410,811,36500,"2019-09-01",2019
"19-Sep",경북,봉화군,205,17387,206,17798,"2019-09-01",2019
"19-Sep",경북,상주시,382,51797,1857,54036,"2019-09-01",2019
"19-Sep",경북,성주군,199,29539,1393,31131,"2019-09-01",2019
"19-Sep",경북,안동시,714,79622,2606,82942,"2019-09-01",2019
"19-Sep",경북,영덕군,252,18678,282,19212,"2019-09-01",2019
"19-Sep",경북,영양군,146,9376,103,9625,"2019-09-01",2019
"19-Sep",경북,영주시,372,54412,1503,56287,"2019-09-01",2019
"19-Sep",경북,영천시,298,57819,2637,60754,"2019-09-01",2019
"19-Sep",경북,예천군,259,28036,466,28761,"2019-09-01",2019
"19-Sep",경북,울릉군,149,5215,531,5895,"2019-09-01",2019
"19-Sep",경북,울진군,302,25350,346,25998,"2019-09-01",2019
"19-Sep",경북,의성군,300,29651,946,30897,"2019-09-01",2019
"19-Sep",경북,청도군,202,24331,703,25236,"2019-09-01",2019
"19-Sep",경북,청송군,199,15058,203,15460,"2019-09-01",2019
"19-Sep",경북,칠곡군,331,67509,2283,70123,"2019-09-01",2019
"19-Sep",경북,포항시 남구,441,119578,8695,128714,"2019-09-01",2019
"19-Sep",경북,포항시 북구,336,133007,3941,137284,"2019-09-01",2019
"19-Sep",경북,계,7460,1386751,48447,1442658,"2019-09-01",2019
"19-Sep",경남,거제시,349,103591,2154,106094,"2019-09-01",2019
"19-Sep",경남,거창군,256,31117,802,32175,"2019-09-01",2019
"19-Sep",경남,고성군,213,26130,636,26979,"2019-09-01",2019
"19-Sep",경남,김해시,666,264249,7258,272173,"2019-09-01",2019
"19-Sep",경남,남해군,257,19145,479,19881,"2019-09-01",2019
"19-Sep",경남,밀양시,315,54161,3953,58429,"2019-09-01",2019
"19-Sep",경남,사천시,307,54700,1503,56510,"2019-09-01",2019
"19-Sep",경남,산청군,233,19519,790,20542,"2019-09-01",2019
"19-Sep",경남,양산시,404,158517,9832,168753,"2019-09-01",2019
"19-Sep",경남,의령군,196,13978,641,14815,"2019-09-01",2019
"19-Sep",경남,진주시,614,160105,6723,167442,"2019-09-01",2019
"19-Sep",경남,창녕군,235,34654,949,35838,"2019-09-01",2019
"19-Sep",경남,창원시 마산합포구,333,98755,2922,102010,"2019-09-01",2019
"19-Sep",경남,창원시 마산회원구,179,93018,5095,98292,"2019-09-01",2019
"19-Sep",경남,창원시 성산구,142,116364,12343,128849,"2019-09-01",2019
"19-Sep",경남,창원시 의창구,947,130910,12355,144212,"2019-09-01",2019
"19-Sep",경남,창원시 진해구,212,88254,1673,90139,"2019-09-01",2019
"19-Sep",경남,통영시,334,52023,1457,53814,"2019-09-01",2019
"19-Sep",경남,하동군,226,24144,462,24832,"2019-09-01",2019
"19-Sep",경남,함안군,192,40214,12514,52920,"2019-09-01",2019
"19-Sep",경남,함양군,211,18950,449,19610,"2019-09-01",2019
"19-Sep",경남,합천군,262,22669,645,23576,"2019-09-01",2019
"19-Sep",경남,계,7083,1625167,85635,1717885,"2019-09-01",2019
"19-Sep",제주,서귀포시,798,102154,2038,104990,"2019-09-01",2019
"19-Sep",제주,제주시,1612,266605,212051,480268,"2019-09-01",2019
"19-Sep",제주,계,2410,368759,214089,585258,"2019-09-01",2019
"19-Oct",서울,강남구,385,215412,18676,234473,"2019-10-01",2019
"19-Oct",서울,강동구,272,128321,8942,137535,"2019-10-01",2019
"19-Oct",서울,강북구,322,71478,4543,76343,"2019-10-01",2019
"19-Oct",서울,강서구,331,184927,18571,203829,"2019-10-01",2019
"19-Oct",서울,관악구,305,114528,5702,120535,"2019-10-01",2019
"19-Oct",서울,광진구,288,93325,5542,99155,"2019-10-01",2019
"19-Oct",서울,구로구,288,130133,13898,144319,"2019-10-01",2019
"19-Oct",서울,금천구,133,81260,6016,87409,"2019-10-01",2019
"19-Oct",서울,노원구,326,142402,9398,152126,"2019-10-01",2019
"19-Oct",서울,도봉구,271,88920,7431,96622,"2019-10-01",2019
"19-Oct",서울,동대문구,312,92331,5184,97827,"2019-10-01",2019
"19-Oct",서울,동작구,316,102816,2713,105845,"2019-10-01",2019
"19-Oct",서울,마포구,333,110519,7030,117882,"2019-10-01",2019
"19-Oct",서울,서대문구,459,80755,6062,87276,"2019-10-01",2019
"19-Oct",서울,서초구,546,167655,13272,181473,"2019-10-01",2019
"19-Oct",서울,성동구,338,94254,11945,106537,"2019-10-01",2019
"19-Oct",서울,성북구,279,113295,5507,119081,"2019-10-01",2019
"19-Oct",서울,송파구,385,226665,13144,240194,"2019-10-01",2019
"19-Oct",서울,양천구,324,140809,8708,149841,"2019-10-01",2019
"19-Oct",서울,영등포구,377,131939,9589,141905,"2019-10-01",2019
"19-Oct",서울,용산구,366,73953,2270,76589,"2019-10-01",2019
"19-Oct",서울,은평구,290,122713,7066,130069,"2019-10-01",2019
"19-Oct",서울,종로구,3799,44545,1668,50012,"2019-10-01",2019
"19-Oct",서울,중구,1079,45940,4722,51741,"2019-10-01",2019
"19-Oct",서울,중랑구,242,102974,9582,112798,"2019-10-01",2019
"19-Oct",서울,계,12366,2901869,207181,3121416,"2019-10-01",2019
"19-Oct",부산,강서구,323,71171,3664,75158,"2019-10-01",2019
"19-Oct",부산,금정구,277,81216,7385,88878,"2019-10-01",2019
"19-Oct",부산,기장군,251,71953,2321,74525,"2019-10-01",2019
"19-Oct",부산,남구,226,91430,8407,100063,"2019-10-01",2019
"19-Oct",부산,동구,189,46099,4513,50801,"2019-10-01",2019
"19-Oct",부산,동래구,184,90361,4268,94813,"2019-10-01",2019
"19-Oct",부산,부산진구,422,119702,14191,134315,"2019-10-01",2019
"19-Oct",부산,북구,235,100004,3389,103628,"2019-10-01",2019
"19-Oct",부산,사상구,282,83777,6009,90068,"2019-10-01",2019
"19-Oct",부산,사하구,262,107654,6961,114877,"2019-10-01",2019
"19-Oct",부산,서구,134,28049,1387,29570,"2019-10-01",2019
"19-Oct",부산,수영구,169,67149,25431,92749,"2019-10-01",2019
"19-Oct",부산,연제구,878,87468,8853,97199,"2019-10-01",2019
"19-Oct",부산,영도구,231,31119,2082,33432,"2019-10-01",2019
"19-Oct",부산,중구,313,24916,7347,32576,"2019-10-01",2019
"19-Oct",부산,해운대구,318,163121,12517,175956,"2019-10-01",2019
"19-Oct",부산,계,4694,1265189,118725,1388608,"2019-10-01",2019
"19-Oct",대구,남구,352,55504,1778,57634,"2019-10-01",2019
"19-Oct",대구,달서구,491,265050,14831,280372,"2019-10-01",2019
"19-Oct",대구,달성군,503,128245,4881,133629,"2019-10-01",2019
"19-Oct",대구,동구,345,150580,10904,161829,"2019-10-01",2019
"19-Oct",대구,북구,490,196087,7913,204490,"2019-10-01",2019
"19-Oct",대구,서구,234,70316,4143,74693,"2019-10-01",2019
"19-Oct",대구,수성구,557,212592,5358,218507,"2019-10-01",2019
"19-Oct",대구,중구,288,54757,1801,56846,"2019-10-01",2019
"19-Oct",대구,계,3260,1133131,51609,1188000,"2019-10-01",2019
"19-Oct",인천,강화군,323,33411,49638,83372,"2019-10-01",2019
"19-Oct",인천,계양구,283,120259,185385,305927,"2019-10-01",2019
"19-Oct",인천,남동구,833,251099,39503,291435,"2019-10-01",2019
"19-Oct",인천,동구,91,26248,3482,29821,"2019-10-01",2019
"19-Oct",인천,미추홀구,412,153000,14384,167796,"2019-10-01",2019
"19-Oct",인천,부평구,337,214386,13612,228335,"2019-10-01",2019
"19-Oct",인천,서구,408,232290,11041,243739,"2019-10-01",2019
"19-Oct",인천,연수구,401,176144,7457,184002,"2019-10-01",2019
"19-Oct",인천,옹진군,205,11644,205,12054,"2019-10-01",2019
"19-Oct",인천,중구,652,61169,18061,79882,"2019-10-01",2019
"19-Oct",인천,계,3945,1279650,342768,1626363,"2019-10-01",2019
"19-Oct",광주,광산구,512,187373,11972,199857,"2019-10-01",2019
"19-Oct",광주,남구,211,88466,2659,91336,"2019-10-01",2019
"19-Oct",광주,동구,244,39081,1174,40499,"2019-10-01",2019
"19-Oct",광주,북구,604,184907,9877,195388,"2019-10-01",2019
"19-Oct",광주,서구,642,140480,6987,148109,"2019-10-01",2019
"19-Oct",광주,계,2213,640307,32669,675189,"2019-10-01",2019
"19-Oct",대전,대덕구,229,83860,6800,90889,"2019-10-01",2019
"19-Oct",대전,동구,252,89099,4334,93685,"2019-10-01",2019
"19-Oct",대전,서구,798,203249,7351,211398,"2019-10-01",2019
"19-Oct",대전,유성구,382,168411,5265,174058,"2019-10-01",2019
"19-Oct",대전,중구,240,96539,5963,102742,"2019-10-01",2019
"19-Oct",대전,계,1901,641158,29713,672772,"2019-10-01",2019
"19-Oct",울산,남구,711,151237,7209,159157,"2019-10-01",2019
"19-Oct",울산,동구,196,61538,971,62705,"2019-10-01",2019
"19-Oct",울산,북구,185,107760,3702,111647,"2019-10-01",2019
"19-Oct",울산,울주군,372,120010,6822,127204,"2019-10-01",2019
"19-Oct",울산,중구,342,100522,2655,103519,"2019-10-01",2019
"19-Oct",울산,계,1806,541067,21359,564232,"2019-10-01",2019
"19-Oct",세종,세종특별자치시,757,157711,2742,161210,"2019-10-01",2019
"19-Oct",세종,계,757,157711,2742,161210,"2019-10-01",2019
"19-Oct",경기,가평군,362,29827,617,30806,"2019-10-01",2019
"19-Oct",경기,고양시 덕양구,678,168006,3966,172650,"2019-10-01",2019
"19-Oct",경기,고양시 일산동구,290,119162,6450,125902,"2019-10-01",2019
"19-Oct",경기,고양시 일산서구,130,112933,4091,117154,"2019-10-01",2019
"19-Oct",경기,과천시,718,20584,603,21905,"2019-10-01",2019
"19-Oct",경기,광명시,308,102869,4200,107377,"2019-10-01",2019
"19-Oct",경기,광주시,374,181549,8181,190104,"2019-10-01",2019
"19-Oct",경기,구리시,248,69518,2590,72356,"2019-10-01",2019
"19-Oct",경기,군포시,294,95981,5082,101357,"2019-10-01",2019
"19-Oct",경기,김포시,468,199951,7276,207695,"2019-10-01",2019
"19-Oct",경기,남양주시,680,281170,7827,289677,"2019-10-01",2019
"19-Oct",경기,동두천시,206,36673,1325,38204,"2019-10-01",2019
"19-Oct",경기,부천시,712,292058,12948,305718,"2019-10-01",2019
"19-Oct",경기,성남시 분당구,356,181857,6849,189062,"2019-10-01",2019
"19-Oct",경기,성남시 수정구,352,71641,2306,74299,"2019-10-01",2019
"19-Oct",경기,성남시 중원구,334,70759,4376,75469,"2019-10-01",2019
"19-Oct",경기,수원시 권선구,383,172815,8330,181528,"2019-10-01",2019
"19-Oct",경기,수원시 영통구,214,142573,3278,146065,"2019-10-01",2019
"19-Oct",경기,수원시 장안구,557,102039,3841,106437,"2019-10-01",2019
"19-Oct",경기,수원시 팔달구,492,67744,3010,71246,"2019-10-01",2019
"19-Oct",경기,시흥시,462,224238,7486,232186,"2019-10-01",2019
"19-Oct",경기,안산시 단원구,557,149683,8118,158358,"2019-10-01",2019
"19-Oct",경기,안산시 상록구,174,134264,4844,139282,"2019-10-01",2019
"19-Oct",경기,안성시,390,97228,5007,102625,"2019-10-01",2019
"19-Oct",경기,안양시 동안구,405,116199,6293,122897,"2019-10-01",2019
"19-Oct",경기,안양시 만안구,147,83314,3928,87389,"2019-10-01",2019
"19-Oct",경기,양주시,383,99744,3115,103242,"2019-10-01",2019
"19-Oct",경기,양평군,555,57527,1783,59865,"2019-10-01",2019
"19-Oct",경기,여주시,430,60483,7400,68313,"2019-10-01",2019
"19-Oct",경기,연천군,297,23258,5352,28907,"2019-10-01",2019
"19-Oct",경기,오산시,206,99660,3363,103229,"2019-10-01",2019
"19-Oct",경기,용인시 기흥구,127,182414,6024,188565,"2019-10-01",2019
"19-Oct",경기,용인시 수지구,48,137488,2294,139830,"2019-10-01",2019
"19-Oct",경기,용인시 처인구,730,124271,7125,132126,"2019-10-01",2019
"19-Oct",경기,의왕시,292,60830,3201,64323,"2019-10-01",2019
"19-Oct",경기,의정부시,636,152978,5010,158624,"2019-10-01",2019
"19-Oct",경기,이천시,401,107509,5831,113741,"2019-10-01",2019
"19-Oct",경기,파주시,505,201429,9475,211409,"2019-10-01",2019
"19-Oct",경기,평택시,696,258071,11799,270566,"2019-10-01",2019
"19-Oct",경기,포천시,373,82478,10348,93199,"2019-10-01",2019
"19-Oct",경기,하남시,386,109461,2666,112513,"2019-10-01",2019
"19-Oct",경기,화성시,870,409236,11197,421303,"2019-10-01",2019
"19-Oct",경기,계,17226,5491472,228805,5737503,"2019-10-01",2019
"19-Oct",강원,강릉시,512,103739,4698,108949,"2019-10-01",2019
"19-Oct",강원,고성군,179,13779,234,14192,"2019-10-01",2019
"19-Oct",강원,동해시,298,43406,1379,45083,"2019-10-01",2019
"19-Oct",강원,삼척시,384,31540,718,32642,"2019-10-01",2019
"19-Oct",강원,속초시,296,36292,1355,37943,"2019-10-01",2019
"19-Oct",강원,양구군,180,11903,121,12204,"2019-10-01",2019
"19-Oct",강원,양양군,182,15090,234,15506,"2019-10-01",2019
"19-Oct",강원,영월군,329,20483,361,21173,"2019-10-01",2019
"19-Oct",강원,원주시,529,164303,5890,170722,"2019-10-01",2019
"19-Oct",강원,인제군,218,17560,293,18071,"2019-10-01",2019
"19-Oct",강원,정선군,330,20141,469,20940,"2019-10-01",2019
"19-Oct",강원,철원군,227,23596,304,24127,"2019-10-01",2019
"19-Oct",강원,춘천시,794,126941,5965,133700,"2019-10-01",2019
"19-Oct",강원,태백시,226,20062,792,21080,"2019-10-01",2019
"19-Oct",강원,평창군,286,25178,517,25981,"2019-10-01",2019
"19-Oct",강원,홍천군,415,37394,1100,38909,"2019-10-01",2019
"19-Oct",강원,화천군,223,12491,205,12919,"2019-10-01",2019
"19-Oct",강원,횡성군,244,25436,706,26386,"2019-10-01",2019
"19-Oct",강원,계,5852,749334,25341,780527,"2019-10-01",2019
"19-Oct",충북,괴산군,198,21921,384,22503,"2019-10-01",2019
"19-Oct",충북,단양군,221,15621,771,16613,"2019-10-01",2019
"19-Oct",충북,보은군,216,17564,886,18666,"2019-10-01",2019
"19-Oct",충북,영동군,227,24741,384,25352,"2019-10-01",2019
"19-Oct",충북,옥천군,196,26109,1097,27402,"2019-10-01",2019
"19-Oct",충북,음성군,219,56804,1827,58850,"2019-10-01",2019
"19-Oct",충북,제천시,329,65817,3543,69689,"2019-10-01",2019
"19-Oct",충북,증평군,91,18768,756,19615,"2019-10-01",2019
"19-Oct",충북,진천군,208,46404,1304,47916,"2019-10-01",2019
"19-Oct",충북,청원군,1,19,0,20,"2019-10-01",2019
"19-Oct",충북,청주시 상당구,503,81596,2498,84597,"2019-10-01",2019
"19-Oct",충북,청주시 서원구,231,93573,5068,98872,"2019-10-01",2019
"19-Oct",충북,청주시 청원구,362,100344,4086,104792,"2019-10-01",2019
"19-Oct",충북,청주시 흥덕구,356,121956,7420,129732,"2019-10-01",2019
"19-Oct",충북,충주시,583,105673,5492,111748,"2019-10-01",2019
"19-Oct",충북,계,3941,796910,35516,836367,"2019-10-01",2019
"19-Oct",충남,계룡시,148,21244,546,21938,"2019-10-01",2019
"19-Oct",충남,공주시,576,52697,2240,55513,"2019-10-01",2019
"19-Oct",충남,금산군,188,27899,2134,30221,"2019-10-01",2019
"19-Oct",충남,논산시,377,60036,2408,62821,"2019-10-01",2019
"19-Oct",충남,당진시,374,91930,3832,96136,"2019-10-01",2019
"19-Oct",충남,보령시,392,51015,1305,52712,"2019-10-01",2019
"19-Oct",충남,부여군,277,33664,1260,35201,"2019-10-01",2019
"19-Oct",충남,서산시,400,90689,3421,94510,"2019-10-01",2019
"19-Oct",충남,서천군,229,26727,878,27834,"2019-10-01",2019
"19-Oct",충남,아산시,495,160154,6456,167105,"2019-10-01",2019
"19-Oct",충남,예산군,382,42131,1411,43924,"2019-10-01",2019
"19-Oct",충남,천안시 동남구,231,126998,4735,131964,"2019-10-01",2019
"19-Oct",충남,천안시 서북구,536,184864,5754,191154,"2019-10-01",2019
"19-Oct",충남,청양군,248,16609,824,17681,"2019-10-01",2019
"19-Oct",충남,태안군,281,33264,502,34047,"2019-10-01",2019
"19-Oct",충남,홍성군,412,51310,1423,53145,"2019-10-01",2019
"19-Oct",충남,계,5546,1071231,39129,1115906,"2019-10-01",2019
"19-Oct",전북,고창군,273,29559,594,30426,"2019-10-01",2019
"19-Oct",전북,군산시,514,126993,6494,134001,"2019-10-01",2019
"19-Oct",전북,김제시,296,44263,1930,46489,"2019-10-01",2019
"19-Oct",전북,남원시,414,39817,5430,45661,"2019-10-01",2019
"19-Oct",전북,무주군,182,12383,372,12937,"2019-10-01",2019
"19-Oct",전북,부안군,255,27040,625,27920,"2019-10-01",2019
"19-Oct",전북,순창군,219,14297,185,14701,"2019-10-01",2019
"19-Oct",전북,완주군,356,49428,3277,53061,"2019-10-01",2019
"19-Oct",전북,익산시,498,134652,6248,141398,"2019-10-01",2019
"19-Oct",전북,임실군,205,14100,427,14732,"2019-10-01",2019
"19-Oct",전북,장수군,237,11806,174,12217,"2019-10-01",2019
"19-Oct",전북,전주시 덕진구,385,163273,7510,171168,"2019-10-01",2019
"19-Oct",전북,전주시 완산구,604,146109,4116,150829,"2019-10-01",2019
"19-Oct",전북,정읍시,329,53058,3621,57008,"2019-10-01",2019
"19-Oct",전북,진안군,249,13656,200,14105,"2019-10-01",2019
"19-Oct",전북,계,5016,880434,41203,926653,"2019-10-01",2019
"19-Oct",전남,강진군,219,18100,1137,19456,"2019-10-01",2019
"19-Oct",전남,고흥군,297,30767,622,31686,"2019-10-01",2019
"19-Oct",전남,곡성군,149,14355,734,15238,"2019-10-01",2019
"19-Oct",전남,광양시,248,78996,5944,85188,"2019-10-01",2019
"19-Oct",전남,구례군,140,12949,637,13726,"2019-10-01",2019
"19-Oct",전남,나주시,463,61516,3275,65254,"2019-10-01",2019
"19-Oct",전남,담양군,202,25678,1549,27429,"2019-10-01",2019
"19-Oct",전남,목포시,443,94820,5787,101050,"2019-10-01",2019
"19-Oct",전남,무안군,552,41531,959,43042,"2019-10-01",2019
"19-Oct",전남,보성군,200,21073,51721,72994,"2019-10-01",2019
"19-Oct",전남,순천시,499,134169,5163,139831,"2019-10-01",2019
"19-Oct",전남,신안군,248,20529,855,21632,"2019-10-01",2019
"19-Oct",전남,여수시,541,126821,7017,134379,"2019-10-01",2019
"19-Oct",전남,영광군,207,26871,724,27802,"2019-10-01",2019
"19-Oct",전남,영암군,249,32389,12256,44894,"2019-10-01",2019
"19-Oct",전남,완도군,245,24580,505,25330,"2019-10-01",2019
"19-Oct",전남,장성군,184,25955,1192,27331,"2019-10-01",2019
"19-Oct",전남,장흥군,196,19678,455,20329,"2019-10-01",2019
"19-Oct",전남,진도군,161,16144,301,16606,"2019-10-01",2019
"19-Oct",전남,함평군,189,17641,29379,47209,"2019-10-01",2019
"19-Oct",전남,해남군,342,37899,592,38833,"2019-10-01",2019
"19-Oct",전남,화순군,213,31285,2071,33569,"2019-10-01",2019
"19-Oct",전남,계,6187,913746,132875,1052808,"2019-10-01",2019
"19-Oct",경북,경산시,317,133578,4409,138304,"2019-10-01",2019
"19-Oct",경북,경주시,578,137311,4591,142480,"2019-10-01",2019
"19-Oct",경북,고령군,162,20214,535,20911,"2019-10-01",2019
"19-Oct",경북,구미시,520,207906,7268,215694,"2019-10-01",2019
"19-Oct",경북,군위군,114,14432,278,14824,"2019-10-01",2019
"19-Oct",경북,김천시,383,71927,1863,74173,"2019-10-01",2019
"19-Oct",경북,문경시,279,35427,821,36527,"2019-10-01",2019
"19-Oct",경북,봉화군,200,17431,206,17837,"2019-10-01",2019
"19-Oct",경북,상주시,380,51928,1866,54174,"2019-10-01",2019
"19-Oct",경북,성주군,200,29545,1390,31135,"2019-10-01",2019
"19-Oct",경북,안동시,704,79615,2618,82937,"2019-10-01",2019
"19-Oct",경북,영덕군,253,18591,282,19126,"2019-10-01",2019
"19-Oct",경북,영양군,141,9423,103,9667,"2019-10-01",2019
"19-Oct",경북,영주시,366,54327,1502,56195,"2019-10-01",2019
"19-Oct",경북,영천시,297,57814,2636,60747,"2019-10-01",2019
"19-Oct",경북,예천군,259,28087,469,28815,"2019-10-01",2019
"19-Oct",경북,울릉군,146,5211,530,5887,"2019-10-01",2019
"19-Oct",경북,울진군,301,25329,347,25977,"2019-10-01",2019
"19-Oct",경북,의성군,301,29612,953,30866,"2019-10-01",2019
"19-Oct",경북,청도군,204,24379,707,25290,"2019-10-01",2019
"19-Oct",경북,청송군,197,15040,201,15438,"2019-10-01",2019
"19-Oct",경북,칠곡군,329,67532,2282,70143,"2019-10-01",2019
"19-Oct",경북,포항시 남구,435,119394,8686,128515,"2019-10-01",2019
"19-Oct",경북,포항시 북구,337,132930,3912,137179,"2019-10-01",2019
"19-Oct",경북,계,7403,1386983,48455,1442841,"2019-10-01",2019
"19-Oct",경남,거제시,354,103546,2142,106042,"2019-10-01",2019
"19-Oct",경남,거창군,260,31192,799,32251,"2019-10-01",2019
"19-Oct",경남,고성군,218,26082,634,26934,"2019-10-01",2019
"19-Oct",경남,김해시,667,264698,7224,272589,"2019-10-01",2019
"19-Oct",경남,남해군,265,19178,476,19919,"2019-10-01",2019
"19-Oct",경남,밀양시,314,54029,3945,58288,"2019-10-01",2019
"19-Oct",경남,사천시,302,54600,1515,56417,"2019-10-01",2019
"19-Oct",경남,산청군,235,19462,789,20486,"2019-10-01",2019
"19-Oct",경남,양산시,403,158738,9857,168998,"2019-10-01",2019
"19-Oct",경남,의령군,191,13932,642,14765,"2019-10-01",2019
"19-Oct",경남,진주시,605,160191,6684,167480,"2019-10-01",2019
"19-Oct",경남,창녕군,239,34626,949,35814,"2019-10-01",2019
"19-Oct",경남,창원시 마산합포구,332,98396,2904,101632,"2019-10-01",2019
"19-Oct",경남,창원시 마산회원구,180,92815,5123,98118,"2019-10-01",2019
"19-Oct",경남,창원시 성산구,143,116068,6203,122414,"2019-10-01",2019
"19-Oct",경남,창원시 의창구,965,131148,16122,148235,"2019-10-01",2019
"19-Oct",경남,창원시 진해구,214,88287,1684,90185,"2019-10-01",2019
"19-Oct",경남,통영시,334,52021,1488,53843,"2019-10-01",2019
"19-Oct",경남,하동군,224,24114,466,24804,"2019-10-01",2019
"19-Oct",경남,함안군,191,40084,12708,52983,"2019-10-01",2019
"19-Oct",경남,함양군,210,18883,451,19544,"2019-10-01",2019
"19-Oct",경남,합천군,268,22655,650,23573,"2019-10-01",2019
"19-Oct",경남,계,7114,1624745,83455,1715314,"2019-10-01",2019
"19-Oct",제주,서귀포시,797,102133,2026,104956,"2019-10-01",2019
"19-Oct",제주,제주시,1618,265934,215797,483349,"2019-10-01",2019
"19-Oct",제주,계,2415,368067,217823,588305,"2019-10-01",2019
"19-Nov",서울,강남구,382,215820,18531,234733,"2019-11-01",2019
"19-Nov",서울,강동구,275,129398,8917,138590,"2019-11-01",2019
"19-Nov",서울,강북구,319,71576,4570,76465,"2019-11-01",2019
"19-Nov",서울,강서구,337,184977,18565,203879,"2019-11-01",2019
"19-Nov",서울,관악구,310,114307,5708,120325,"2019-11-01",2019
"19-Nov",서울,광진구,293,93328,5634,99255,"2019-11-01",2019
"19-Nov",서울,구로구,280,130302,13859,144441,"2019-11-01",2019
"19-Nov",서울,금천구,133,81226,5980,87339,"2019-11-01",2019
"19-Nov",서울,노원구,322,142379,9401,152102,"2019-11-01",2019
"19-Nov",서울,도봉구,270,88812,7443,96525,"2019-11-01",2019
"19-Nov",서울,동대문구,312,92457,5184,97953,"2019-11-01",2019
"19-Nov",서울,동작구,313,102593,2718,105624,"2019-11-01",2019
"19-Nov",서울,마포구,336,110561,7035,117932,"2019-11-01",2019
"19-Nov",서울,서대문구,448,80648,6075,87171,"2019-11-01",2019
"19-Nov",서울,서초구,556,167532,13282,181370,"2019-11-01",2019
"19-Nov",서울,성동구,340,94172,11841,106353,"2019-11-01",2019
"19-Nov",서울,성북구,282,113583,5493,119358,"2019-11-01",2019
"19-Nov",서울,송파구,383,226993,13097,240473,"2019-11-01",2019
"19-Nov",서울,양천구,322,140673,8732,149727,"2019-11-01",2019
"19-Nov",서울,영등포구,376,131814,9606,141796,"2019-11-01",2019
"19-Nov",서울,용산구,358,73893,2271,76522,"2019-11-01",2019
"19-Nov",서울,은평구,295,122624,7088,130007,"2019-11-01",2019
"19-Nov",서울,종로구,3860,44540,1676,50076,"2019-11-01",2019
"19-Nov",서울,중구,1072,45905,4723,51700,"2019-11-01",2019
"19-Nov",서울,중랑구,240,102890,9587,112717,"2019-11-01",2019
"19-Nov",서울,계,12414,2903003,207016,3122433,"2019-11-01",2019
"19-Nov",부산,강서구,327,71446,3693,75466,"2019-11-01",2019
"19-Nov",부산,금정구,283,81212,7416,88911,"2019-11-01",2019
"19-Nov",부산,기장군,255,72045,2344,74644,"2019-11-01",2019
"19-Nov",부산,남구,233,91343,8444,100020,"2019-11-01",2019
"19-Nov",부산,동구,189,46309,4701,51199,"2019-11-01",2019
"19-Nov",부산,동래구,187,90623,4308,95118,"2019-11-01",2019
"19-Nov",부산,부산진구,424,119605,14554,134583,"2019-11-01",2019
"19-Nov",부산,북구,242,100221,3397,103860,"2019-11-01",2019
"19-Nov",부산,사상구,286,83780,5948,90014,"2019-11-01",2019
"19-Nov",부산,사하구,262,107721,6936,114919,"2019-11-01",2019
"19-Nov",부산,서구,138,28021,1393,29552,"2019-11-01",2019
"19-Nov",부산,수영구,168,67024,25978,93170,"2019-11-01",2019
"19-Nov",부산,연제구,885,87769,8960,97614,"2019-11-01",2019
"19-Nov",부산,영도구,230,31074,2089,33393,"2019-11-01",2019
"19-Nov",부산,중구,319,25204,7331,32854,"2019-11-01",2019
"19-Nov",부산,해운대구,325,163528,12758,176611,"2019-11-01",2019
"19-Nov",부산,계,4753,1266925,120250,1391928,"2019-11-01",2019
"19-Nov",대구,남구,353,55622,1778,57753,"2019-11-01",2019
"19-Nov",대구,달서구,490,265542,14796,280828,"2019-11-01",2019
"19-Nov",대구,달성군,501,128717,4881,134099,"2019-11-01",2019
"19-Nov",대구,동구,346,150705,11523,162574,"2019-11-01",2019
"19-Nov",대구,북구,495,196119,7770,204384,"2019-11-01",2019
"19-Nov",대구,서구,239,70195,4125,74559,"2019-11-01",2019
"19-Nov",대구,수성구,591,212666,5462,218719,"2019-11-01",2019
"19-Nov",대구,중구,292,55385,1806,57483,"2019-11-01",2019
"19-Nov",대구,계,3307,1134951,52141,1190399,"2019-11-01",2019
"19-Nov",인천,강화군,325,33496,49699,83520,"2019-11-01",2019
"19-Nov",인천,계양구,288,119914,186065,306267,"2019-11-01",2019
"19-Nov",인천,남동구,831,251706,39331,291868,"2019-11-01",2019
"19-Nov",인천,동구,92,26315,3596,30003,"2019-11-01",2019
"19-Nov",인천,미추홀구,417,153424,14140,167981,"2019-11-01",2019
"19-Nov",인천,부평구,339,214435,14026,228800,"2019-11-01",2019
"19-Nov",인천,서구,409,232981,11088,244478,"2019-11-01",2019
"19-Nov",인천,연수구,401,176826,7511,184738,"2019-11-01",2019
"19-Nov",인천,옹진군,207,11626,203,12036,"2019-11-01",2019
"19-Nov",인천,중구,646,61630,18107,80383,"2019-11-01",2019
"19-Nov",인천,계,3955,1282353,343766,1630074,"2019-11-01",2019
"19-Nov",광주,광산구,518,187573,12097,200188,"2019-11-01",2019
"19-Nov",광주,남구,211,88775,2696,91682,"2019-11-01",2019
"19-Nov",광주,동구,244,39166,1181,40591,"2019-11-01",2019
"19-Nov",광주,북구,613,184966,9758,195337,"2019-11-01",2019
"19-Nov",광주,서구,641,140486,6969,148096,"2019-11-01",2019
"19-Nov",광주,계,2227,640966,32701,675894,"2019-11-01",2019
"19-Nov",대전,대덕구,232,83683,6783,90698,"2019-11-01",2019
"19-Nov",대전,동구,256,89001,4331,93588,"2019-11-01",2019
"19-Nov",대전,서구,802,202383,7375,210560,"2019-11-01",2019
"19-Nov",대전,유성구,385,170092,5248,175725,"2019-11-01",2019
"19-Nov",대전,중구,240,96451,5916,102607,"2019-11-01",2019
"19-Nov",대전,계,1915,641610,29653,673178,"2019-11-01",2019
"19-Nov",울산,남구,711,151293,7125,159129,"2019-11-01",2019
"19-Nov",울산,동구,196,61415,972,62583,"2019-11-01",2019
"19-Nov",울산,북구,187,108295,3937,112419,"2019-11-01",2019
"19-Nov",울산,울주군,374,120088,6827,127289,"2019-11-01",2019
"19-Nov",울산,중구,349,100400,2644,103393,"2019-11-01",2019
"19-Nov",울산,계,1817,541491,21505,564813,"2019-11-01",2019
"19-Nov",세종,세종특별자치시,764,158831,2759,162354,"2019-11-01",2019
"19-Nov",세종,계,764,158831,2759,162354,"2019-11-01",2019
"19-Nov",경기,가평군,365,29788,637,30790,"2019-11-01",2019
"19-Nov",경기,고양시 덕양구,675,168790,3986,173451,"2019-11-01",2019
"19-Nov",경기,고양시 일산동구,289,119770,6432,126491,"2019-11-01",2019
"19-Nov",경기,고양시 일산서구,133,113357,4177,117667,"2019-11-01",2019
"19-Nov",경기,과천시,709,20682,605,21996,"2019-11-01",2019
"19-Nov",경기,광명시,311,102455,4211,106977,"2019-11-01",2019
"19-Nov",경기,광주시,374,181882,8178,190434,"2019-11-01",2019
"19-Nov",경기,구리시,251,69524,2607,72382,"2019-11-01",2019
"19-Nov",경기,군포시,295,96198,5093,101586,"2019-11-01",2019
"19-Nov",경기,김포시,478,200444,7295,208217,"2019-11-01",2019
"19-Nov",경기,남양주시,687,281730,7866,290283,"2019-11-01",2019
"19-Nov",경기,동두천시,206,36625,1331,38162,"2019-11-01",2019
"19-Nov",경기,부천시,712,292016,12905,305633,"2019-11-01",2019
"19-Nov",경기,성남시 분당구,363,182025,6860,189248,"2019-11-01",2019
"19-Nov",경기,성남시 수정구,361,71616,2312,74289,"2019-11-01",2019
"19-Nov",경기,성남시 중원구,327,70753,4396,75476,"2019-11-01",2019
"19-Nov",경기,수원시 권선구,398,173278,8358,182034,"2019-11-01",2019
"19-Nov",경기,수원시 영통구,219,143060,3318,146597,"2019-11-01",2019
"19-Nov",경기,수원시 장안구,573,102046,3828,106447,"2019-11-01",2019
"19-Nov",경기,수원시 팔달구,498,67659,3000,71157,"2019-11-01",2019
"19-Nov",경기,시흥시,464,225499,7506,233469,"2019-11-01",2019
"19-Nov",경기,안산시 단원구,562,149911,8172,158645,"2019-11-01",2019
"19-Nov",경기,안산시 상록구,177,134091,4771,139039,"2019-11-01",2019
"19-Nov",경기,안성시,389,97489,4996,102874,"2019-11-01",2019
"19-Nov",경기,안양시 동안구,411,116298,6305,123014,"2019-11-01",2019
"19-Nov",경기,안양시 만안구,150,83217,3923,87290,"2019-11-01",2019
"19-Nov",경기,양주시,387,100082,3110,103579,"2019-11-01",2019
"19-Nov",경기,양평군,558,57603,1782,59943,"2019-11-01",2019
"19-Nov",경기,여주시,433,60646,7422,68501,"2019-11-01",2019
"19-Nov",경기,연천군,300,23296,5336,28932,"2019-11-01",2019
"19-Nov",경기,오산시,208,100659,3368,104235,"2019-11-01",2019
"19-Nov",경기,용인시 기흥구,132,183020,6026,189178,"2019-11-01",2019
"19-Nov",경기,용인시 수지구,49,138123,2306,140478,"2019-11-01",2019
"19-Nov",경기,용인시 처인구,731,124455,7164,132350,"2019-11-01",2019
"19-Nov",경기,의왕시,295,60945,3201,64441,"2019-11-01",2019
"19-Nov",경기,의정부시,635,153197,5011,158843,"2019-11-01",2019
"19-Nov",경기,이천시,405,107903,5846,114154,"2019-11-01",2019
"19-Nov",경기,파주시,512,201431,9421,211364,"2019-11-01",2019
"19-Nov",경기,평택시,699,259459,11811,271969,"2019-11-01",2019
"19-Nov",경기,포천시,383,82600,10195,93178,"2019-11-01",2019
"19-Nov",경기,하남시,385,110241,2693,113319,"2019-11-01",2019
"19-Nov",경기,화성시,874,411900,11204,423978,"2019-11-01",2019
"19-Nov",경기,계,17363,5505763,228964,5752090,"2019-11-01",2019
"19-Nov",강원,강릉시,519,103826,4714,109059,"2019-11-01",2019
"19-Nov",강원,고성군,181,13809,237,14227,"2019-11-01",2019
"19-Nov",강원,동해시,303,43473,1391,45167,"2019-11-01",2019
"19-Nov",강원,삼척시,381,31568,719,32668,"2019-11-01",2019
"19-Nov",강원,속초시,302,36353,1355,38010,"2019-11-01",2019
"19-Nov",강원,양구군,185,11870,121,12176,"2019-11-01",2019
"19-Nov",강원,양양군,186,15102,236,15524,"2019-11-01",2019
"19-Nov",강원,영월군,335,20478,363,21176,"2019-11-01",2019
"19-Nov",강원,원주시,538,164780,5857,171175,"2019-11-01",2019
"19-Nov",강원,인제군,220,17545,292,18057,"2019-11-01",2019
"19-Nov",강원,정선군,332,20148,477,20957,"2019-11-01",2019
"19-Nov",강원,철원군,227,23574,303,24104,"2019-11-01",2019
"19-Nov",강원,춘천시,802,127206,6000,134008,"2019-11-01",2019
"19-Nov",강원,태백시,233,20042,793,21068,"2019-11-01",2019
"19-Nov",강원,평창군,292,25161,518,25971,"2019-11-01",2019
"19-Nov",강원,홍천군,422,37375,1075,38872,"2019-11-01",2019
"19-Nov",강원,화천군,223,12558,203,12984,"2019-11-01",2019
"19-Nov",강원,횡성군,246,25459,712,26417,"2019-11-01",2019
"19-Nov",강원,계,5927,750327,25366,781620,"2019-11-01",2019
"19-Nov",충북,괴산군,200,22061,385,22646,"2019-11-01",2019
"19-Nov",충북,단양군,220,15566,764,16550,"2019-11-01",2019
"19-Nov",충북,보은군,219,17607,895,18721,"2019-11-01",2019
"19-Nov",충북,영동군,226,24706,381,25313,"2019-11-01",2019
"19-Nov",충북,옥천군,197,26128,1114,27439,"2019-11-01",2019
"19-Nov",충북,음성군,219,56899,1826,58944,"2019-11-01",2019
"19-Nov",충북,제천시,333,65615,3542,69490,"2019-11-01",2019
"19-Nov",충북,증평군,90,18718,756,19564,"2019-11-01",2019
"19-Nov",충북,진천군,211,46546,1305,48062,"2019-11-01",2019
"19-Nov",충북,청원군,1,19,0,20,"2019-11-01",2019
"19-Nov",충북,청주시 상당구,500,81664,2505,84669,"2019-11-01",2019
"19-Nov",충북,청주시 서원구,230,93580,5077,98887,"2019-11-01",2019
"19-Nov",충북,청주시 청원구,361,100375,4087,104823,"2019-11-01",2019
"19-Nov",충북,청주시 흥덕구,360,122524,7431,130315,"2019-11-01",2019
"19-Nov",충북,충주시,589,105695,5470,111754,"2019-11-01",2019
"19-Nov",충북,계,3956,797703,35538,837197,"2019-11-01",2019
"19-Nov",충남,계룡시,148,21235,547,21930,"2019-11-01",2019
"19-Nov",충남,공주시,576,52649,2261,55486,"2019-11-01",2019
"19-Nov",충남,금산군,190,27820,2159,30169,"2019-11-01",2019
"19-Nov",충남,논산시,380,60007,2422,62809,"2019-11-01",2019
"19-Nov",충남,당진시,376,91802,3830,96008,"2019-11-01",2019
"19-Nov",충남,보령시,393,51048,1307,52748,"2019-11-01",2019
"19-Nov",충남,부여군,280,33625,1262,35167,"2019-11-01",2019
"19-Nov",충남,서산시,409,90737,3412,94558,"2019-11-01",2019
"19-Nov",충남,서천군,229,26733,882,27844,"2019-11-01",2019
"19-Nov",충남,아산시,499,160412,6468,167379,"2019-11-01",2019
"19-Nov",충남,예산군,383,42150,1412,43945,"2019-11-01",2019
"19-Nov",충남,천안시 동남구,239,127073,4731,132043,"2019-11-01",2019
"19-Nov",충남,천안시 서북구,535,185178,5740,191453,"2019-11-01",2019
"19-Nov",충남,청양군,250,16678,833,17761,"2019-11-01",2019
"19-Nov",충남,태안군,286,33196,504,33986,"2019-11-01",2019
"19-Nov",충남,홍성군,417,51364,1423,53204,"2019-11-01",2019
"19-Nov",충남,계,5590,1071707,39193,1116490,"2019-11-01",2019
"19-Nov",전북,고창군,276,29672,590,30538,"2019-11-01",2019
"19-Nov",전북,군산시,524,126783,6458,133765,"2019-11-01",2019
"19-Nov",전북,김제시,305,44052,1934,46291,"2019-11-01",2019
"19-Nov",전북,남원시,414,39729,5378,45521,"2019-11-01",2019
"19-Nov",전북,무주군,183,12405,377,12965,"2019-11-01",2019
"19-Nov",전북,부안군,260,26975,628,27863,"2019-11-01",2019
"19-Nov",전북,순창군,226,14240,185,14651,"2019-11-01",2019
"19-Nov",전북,완주군,354,49669,3274,53297,"2019-11-01",2019
"19-Nov",전북,익산시,501,134406,6252,141159,"2019-11-01",2019
"19-Nov",전북,임실군,208,14227,430,14865,"2019-11-01",2019
"19-Nov",전북,장수군,242,11787,174,12203,"2019-11-01",2019
"19-Nov",전북,전주시 덕진구,383,164255,7483,172121,"2019-11-01",2019
"19-Nov",전북,전주시 완산구,619,146182,4091,150892,"2019-11-01",2019
"19-Nov",전북,정읍시,347,52961,3582,56890,"2019-11-01",2019
"19-Nov",전북,진안군,252,13657,199,14108,"2019-11-01",2019
"19-Nov",전북,계,5094,881000,41035,927129,"2019-11-01",2019
"19-Nov",전남,강진군,219,18064,1138,19421,"2019-11-01",2019
"19-Nov",전남,고흥군,297,30762,625,31684,"2019-11-01",2019
"19-Nov",전남,곡성군,151,14322,730,15203,"2019-11-01",2019
"19-Nov",전남,광양시,252,79524,5926,85702,"2019-11-01",2019
"19-Nov",전남,구례군,139,12928,651,13718,"2019-11-01",2019
"19-Nov",전남,나주시,468,61469,3285,65222,"2019-11-01",2019
"19-Nov",전남,담양군,213,25758,1556,27527,"2019-11-01",2019
"19-Nov",전남,목포시,446,94960,5775,101181,"2019-11-01",2019
"19-Nov",전남,무안군,558,41499,973,43030,"2019-11-01",2019
"19-Nov",전남,보성군,201,21082,50379,71662,"2019-11-01",2019
"19-Nov",전남,순천시,507,134411,5147,140065,"2019-11-01",2019
"19-Nov",전남,신안군,262,20401,932,21595,"2019-11-01",2019
"19-Nov",전남,여수시,547,127269,7008,134824,"2019-11-01",2019
"19-Nov",전남,영광군,210,26887,724,27821,"2019-11-01",2019
"19-Nov",전남,영암군,253,32432,16122,48807,"2019-11-01",2019
"19-Nov",전남,완도군,249,24598,503,25350,"2019-11-01",2019
"19-Nov",전남,장성군,187,26002,1180,27369,"2019-11-01",2019
"19-Nov",전남,장흥군,205,19674,460,20339,"2019-11-01",2019
"19-Nov",전남,진도군,162,16160,297,16619,"2019-11-01",2019
"19-Nov",전남,함평군,192,17628,26875,44695,"2019-11-01",2019
"19-Nov",전남,해남군,348,37978,599,38925,"2019-11-01",2019
"19-Nov",전남,화순군,215,31246,2070,33531,"2019-11-01",2019
"19-Nov",전남,계,6281,915054,132955,1054290,"2019-11-01",2019
"19-Nov",경북,경산시,322,133881,4472,138675,"2019-11-01",2019
"19-Nov",경북,경주시,581,137437,4614,142632,"2019-11-01",2019
"19-Nov",경북,고령군,164,20185,492,20841,"2019-11-01",2019
"19-Nov",경북,구미시,514,208129,7260,215903,"2019-11-01",2019
"19-Nov",경북,군위군,114,14463,281,14858,"2019-11-01",2019
"19-Nov",경북,김천시,382,71828,1861,74071,"2019-11-01",2019
"19-Nov",경북,문경시,281,35495,823,36599,"2019-11-01",2019
"19-Nov",경북,봉화군,203,17382,198,17783,"2019-11-01",2019
"19-Nov",경북,상주시,378,51946,1866,54190,"2019-11-01",2019
"19-Nov",경북,성주군,203,29492,1410,31105,"2019-11-01",2019
"19-Nov",경북,안동시,714,79727,2617,83058,"2019-11-01",2019
"19-Nov",경북,영덕군,256,18561,291,19108,"2019-11-01",2019
"19-Nov",경북,영양군,140,9397,104,9641,"2019-11-01",2019
"19-Nov",경북,영주시,365,54365,1509,56239,"2019-11-01",2019
"19-Nov",경북,영천시,290,57875,2648,60813,"2019-11-01",2019
"19-Nov",경북,예천군,261,28173,468,28902,"2019-11-01",2019
"19-Nov",경북,울릉군,145,5193,514,5852,"2019-11-01",2019
"19-Nov",경북,울진군,298,25302,351,25951,"2019-11-01",2019
"19-Nov",경북,의성군,302,29582,957,30841,"2019-11-01",2019
"19-Nov",경북,청도군,206,24319,703,25228,"2019-11-01",2019
"19-Nov",경북,청송군,198,15043,202,15443,"2019-11-01",2019
"19-Nov",경북,칠곡군,344,67457,2275,70076,"2019-11-01",2019
"19-Nov",경북,포항시 남구,437,119371,8673,128481,"2019-11-01",2019
"19-Nov",경북,포항시 북구,344,133377,3911,137632,"2019-11-01",2019
"19-Nov",경북,계,7442,1387980,48500,1443922,"2019-11-01",2019
"19-Nov",경남,거제시,353,103694,2136,106183,"2019-11-01",2019
"19-Nov",경남,거창군,262,31130,804,32196,"2019-11-01",2019
"19-Nov",경남,고성군,219,26050,635,26904,"2019-11-01",2019
"19-Nov",경남,김해시,659,265308,7219,273186,"2019-11-01",2019
"19-Nov",경남,남해군,264,19179,477,19920,"2019-11-01",2019
"19-Nov",경남,밀양시,315,54085,3938,58338,"2019-11-01",2019
"19-Nov",경남,사천시,306,54600,1509,56415,"2019-11-01",2019
"19-Nov",경남,산청군,236,19485,799,20520,"2019-11-01",2019
"19-Nov",경남,양산시,406,158995,9872,169273,"2019-11-01",2019
"19-Nov",경남,의령군,191,13913,669,14773,"2019-11-01",2019
"19-Nov",경남,진주시,605,160320,6668,167593,"2019-11-01",2019
"19-Nov",경남,창녕군,239,34657,948,35844,"2019-11-01",2019
"19-Nov",경남,창원시 마산합포구,333,98331,2896,101560,"2019-11-01",2019
"19-Nov",경남,창원시 마산회원구,183,92742,4979,97904,"2019-11-01",2019
"19-Nov",경남,창원시 성산구,144,115850,6034,122028,"2019-11-01",2019
"19-Nov",경남,창원시 의창구,964,131753,17359,150076,"2019-11-01",2019
"19-Nov",경남,창원시 진해구,215,88368,1688,90271,"2019-11-01",2019
"19-Nov",경남,통영시,330,52042,1421,53793,"2019-11-01",2019
"19-Nov",경남,하동군,223,24129,464,24816,"2019-11-01",2019
"19-Nov",경남,함안군,191,40058,12854,53103,"2019-11-01",2019
"19-Nov",경남,함양군,218,18795,452,19465,"2019-11-01",2019
"19-Nov",경남,합천군,274,22682,650,23606,"2019-11-01",2019
"19-Nov",경남,계,7130,1626166,84471,1717767,"2019-11-01",2019
"19-Nov",제주,서귀포시,805,102081,2048,104934,"2019-11-01",2019
"19-Nov",제주,제주시,1629,265803,220199,487631,"2019-11-01",2019
"19-Nov",제주,계,2434,367884,222247,592565,"2019-11-01",2019
"19-Dec",서울,강남구,383,216169,18863,235415,"2019-12-01",2019
"19-Dec",서울,강동구,270,130371,8908,139549,"2019-12-01",2019
"19-Dec",서울,강북구,314,71476,4574,76364,"2019-12-01",2019
"19-Dec",서울,강서구,333,185623,18719,204675,"2019-12-01",2019
"19-Dec",서울,관악구,307,114027,5716,120050,"2019-12-01",2019
"19-Dec",서울,광진구,291,93286,5722,99299,"2019-12-01",2019
"19-Dec",서울,구로구,281,130315,13869,144465,"2019-12-01",2019
"19-Dec",서울,금천구,133,81461,5987,87581,"2019-12-01",2019
"19-Dec",서울,노원구,319,142351,9401,152071,"2019-12-01",2019
"19-Dec",서울,도봉구,268,88703,7464,96435,"2019-12-01",2019
"19-Dec",서울,동대문구,310,92380,5220,97910,"2019-12-01",2019
"19-Dec",서울,동작구,312,102431,2729,105472,"2019-12-01",2019
"19-Dec",서울,마포구,332,110593,6982,117907,"2019-12-01",2019
"19-Dec",서울,서대문구,447,80612,6045,87104,"2019-12-01",2019
"19-Dec",서울,서초구,544,167477,13161,181182,"2019-12-01",2019
"19-Dec",서울,성동구,339,94221,11703,106263,"2019-12-01",2019
"19-Dec",서울,성북구,281,113559,5481,119321,"2019-12-01",2019
"19-Dec",서울,송파구,382,226975,13202,240559,"2019-12-01",2019
"19-Dec",서울,양천구,321,140614,8738,149673,"2019-12-01",2019
"19-Dec",서울,영등포구,374,132013,9623,142010,"2019-12-01",2019
"19-Dec",서울,용산구,357,73927,2237,76521,"2019-12-01",2019
"19-Dec",서울,은평구,296,122428,7096,129820,"2019-12-01",2019
"19-Dec",서울,종로구,3871,44483,1698,50052,"2019-12-01",2019
"19-Dec",서울,중구,1064,45797,4875,51736,"2019-12-01",2019
"19-Dec",서울,중랑구,240,102878,9605,112723,"2019-12-01",2019
"19-Dec",서울,계,12369,2904170,207618,3124157,"2019-12-01",2019
"19-Dec",부산,강서구,326,71945,3688,75959,"2019-12-01",2019
"19-Dec",부산,금정구,281,81163,7429,88873,"2019-12-01",2019
"19-Dec",부산,기장군,260,71999,2364,74623,"2019-12-01",2019
"19-Dec",부산,남구,234,91274,8418,99926,"2019-12-01",2019
"19-Dec",부산,동구,187,46747,4966,51900,"2019-12-01",2019
"19-Dec",부산,동래구,182,90812,4317,95311,"2019-12-01",2019
"19-Dec",부산,부산진구,418,119591,15253,135262,"2019-12-01",2019
"19-Dec",부산,북구,251,100317,3398,103966,"2019-12-01",2019
"19-Dec",부산,사상구,285,83682,5921,89888,"2019-12-01",2019
"19-Dec",부산,사하구,264,107527,6895,114686,"2019-12-01",2019
"19-Dec",부산,서구,138,28041,1422,29601,"2019-12-01",2019
"19-Dec",부산,수영구,166,67033,26405,93604,"2019-12-01",2019
"19-Dec",부산,연제구,873,88309,9129,98311,"2019-12-01",2019
"19-Dec",부산,영도구,229,31002,2093,33324,"2019-12-01",2019
"19-Dec",부산,중구,312,25617,7292,33221,"2019-12-01",2019
"19-Dec",부산,해운대구,322,163652,12754,176728,"2019-12-01",2019
"19-Dec",부산,계,4728,1268711,121744,1395183,"2019-12-01",2019
"19-Dec",대구,남구,351,55501,1765,57617,"2019-12-01",2019
"19-Dec",대구,달서구,485,265680,14748,280913,"2019-12-01",2019
"19-Dec",대구,달성군,497,128921,4883,134301,"2019-12-01",2019
"19-Dec",대구,동구,346,150670,11548,162564,"2019-12-01",2019
"19-Dec",대구,북구,490,195854,7764,204108,"2019-12-01",2019
"19-Dec",대구,서구,236,70006,4103,74345,"2019-12-01",2019
"19-Dec",대구,수성구,600,212861,5424,218885,"2019-12-01",2019
"19-Dec",대구,중구,299,55326,1796,57421,"2019-12-01",2019
"19-Dec",대구,계,3304,1134819,52031,1190154,"2019-12-01",2019
"19-Dec",인천,강화군,330,33470,49921,83721,"2019-12-01",2019
"19-Dec",인천,계양구,285,119742,188357,308384,"2019-12-01",2019
"19-Dec",인천,남동구,828,252845,38782,292455,"2019-12-01",2019
"19-Dec",인천,동구,91,26208,3722,30021,"2019-12-01",2019
"19-Dec",인천,미추홀구,412,154109,13752,168273,"2019-12-01",2019
"19-Dec",인천,부평구,333,214151,14382,228866,"2019-12-01",2019
"19-Dec",인천,서구,409,233904,11104,245417,"2019-12-01",2019
"19-Dec",인천,연수구,394,177444,7632,185470,"2019-12-01",2019
"19-Dec",인천,옹진군,206,11620,204,12030,"2019-12-01",2019
"19-Dec",인천,중구,688,62012,17986,80686,"2019-12-01",2019
"19-Dec",인천,계,3976,1285505,345842,1635323,"2019-12-01",2019
"19-Dec",광주,광산구,505,187724,12106,200335,"2019-12-01",2019
"19-Dec",광주,남구,212,88814,2679,91705,"2019-12-01",2019
"19-Dec",광주,동구,240,39249,1181,40670,"2019-12-01",2019
"19-Dec",광주,북구,648,184847,9725,195220,"2019-12-01",2019
"19-Dec",광주,서구,635,140770,6946,148351,"2019-12-01",2019
"19-Dec",광주,계,2240,641404,32637,676281,"2019-12-01",2019
"19-Dec",대전,대덕구,231,83655,6808,90694,"2019-12-01",2019
"19-Dec",대전,동구,252,88832,4347,93431,"2019-12-01",2019
"19-Dec",대전,서구,801,202484,7354,210639,"2019-12-01",2019
"19-Dec",대전,유성구,380,171005,5238,176623,"2019-12-01",2019
"19-Dec",대전,중구,236,96367,5909,102512,"2019-12-01",2019
"19-Dec",대전,계,1900,642343,29656,673899,"2019-12-01",2019
"19-Dec",울산,남구,707,151391,7096,159194,"2019-12-01",2019
"19-Dec",울산,동구,195,61265,1008,62468,"2019-12-01",2019
"19-Dec",울산,북구,184,109131,3940,113255,"2019-12-01",2019
"19-Dec",울산,울주군,369,120301,6807,127477,"2019-12-01",2019
"19-Dec",울산,중구,342,100259,2644,103245,"2019-12-01",2019
"19-Dec",울산,계,1797,542347,21495,565639,"2019-12-01",2019
"19-Dec",세종,세종특별자치시,761,159803,2775,163339,"2019-12-01",2019
"19-Dec",세종,계,761,159803,2775,163339,"2019-12-01",2019
"19-Dec",경기,가평군,367,29752,640,30759,"2019-12-01",2019
"19-Dec",경기,고양시 덕양구,672,169454,4030,174156,"2019-12-01",2019
"19-Dec",경기,고양시 일산동구,284,120078,6326,126688,"2019-12-01",2019
"19-Dec",경기,고양시 일산서구,131,113542,4222,117895,"2019-12-01",2019
"19-Dec",경기,과천시,716,20789,604,22109,"2019-12-01",2019
"19-Dec",경기,광명시,310,102475,4199,106984,"2019-12-01",2019
"19-Dec",경기,광주시,379,182635,8162,191176,"2019-12-01",2019
"19-Dec",경기,구리시,251,69535,2586,72372,"2019-12-01",2019
"19-Dec",경기,군포시,297,96355,5097,101749,"2019-12-01",2019
"19-Dec",경기,김포시,482,200960,7360,208802,"2019-12-01",2019
"19-Dec",경기,남양주시,678,282197,7931,290806,"2019-12-01",2019
"19-Dec",경기,동두천시,207,36689,1334,38230,"2019-12-01",2019
"19-Dec",경기,부천시,699,292315,12953,305967,"2019-12-01",2019
"19-Dec",경기,성남시 분당구,360,182155,6883,189398,"2019-12-01",2019
"19-Dec",경기,성남시 수정구,360,71694,2370,74424,"2019-12-01",2019
"19-Dec",경기,성남시 중원구,324,70605,4317,75246,"2019-12-01",2019
"19-Dec",경기,수원시 권선구,403,174278,8418,183099,"2019-12-01",2019
"19-Dec",경기,수원시 영통구,224,143478,3266,146968,"2019-12-01",2019
"19-Dec",경기,수원시 장안구,572,102297,3841,106710,"2019-12-01",2019
"19-Dec",경기,수원시 팔달구,493,67626,3043,71162,"2019-12-01",2019
"19-Dec",경기,시흥시,459,225931,7556,233946,"2019-12-01",2019
"19-Dec",경기,안산시 단원구,573,150219,8139,158931,"2019-12-01",2019
"19-Dec",경기,안산시 상록구,174,133898,4768,138840,"2019-12-01",2019
"19-Dec",경기,안성시,382,97625,5024,103031,"2019-12-01",2019
"19-Dec",경기,안양시 동안구,409,116048,6293,122750,"2019-12-01",2019
"19-Dec",경기,안양시 만안구,149,82967,3934,87050,"2019-12-01",2019
"19-Dec",경기,양주시,375,100357,3135,103867,"2019-12-01",2019
"19-Dec",경기,양평군,553,57661,1778,59992,"2019-12-01",2019
"19-Dec",경기,여주시,428,60624,7438,68490,"2019-12-01",2019
"19-Dec",경기,연천군,300,23250,5319,28869,"2019-12-01",2019
"19-Dec",경기,오산시,207,101576,3351,105134,"2019-12-01",2019
"19-Dec",경기,용인시 기흥구,133,183923,6036,190092,"2019-12-01",2019
"19-Dec",경기,용인시 수지구,49,138549,2284,140882,"2019-12-01",2019
"19-Dec",경기,용인시 처인구,746,124620,7160,132526,"2019-12-01",2019
"19-Dec",경기,의왕시,290,61399,3190,64879,"2019-12-01",2019
"19-Dec",경기,의정부시,659,153384,5027,159070,"2019-12-01",2019
"19-Dec",경기,이천시,406,108249,5865,114520,"2019-12-01",2019
"19-Dec",경기,파주시,510,201821,9403,211734,"2019-12-01",2019
"19-Dec",경기,평택시,696,260702,11726,273124,"2019-12-01",2019
"19-Dec",경기,포천시,378,82680,10041,93099,"2019-12-01",2019
"19-Dec",경기,하남시,385,110649,2709,113743,"2019-12-01",2019
"19-Dec",경기,화성시,871,414358,11194,426423,"2019-12-01",2019
"19-Dec",경기,계,17341,5519399,228952,5765692,"2019-12-01",2019
"19-Dec",강원,강릉시,523,103937,4706,109166,"2019-12-01",2019
"19-Dec",강원,고성군,179,13806,232,14217,"2019-12-01",2019
"19-Dec",강원,동해시,303,43629,1392,45324,"2019-12-01",2019
"19-Dec",강원,삼척시,391,31546,725,32662,"2019-12-01",2019
"19-Dec",강원,속초시,292,36359,1353,38004,"2019-12-01",2019
"19-Dec",강원,양구군,184,11852,121,12157,"2019-12-01",2019
"19-Dec",강원,양양군,188,15136,238,15562,"2019-12-01",2019
"19-Dec",강원,영월군,335,20526,362,21223,"2019-12-01",2019
"19-Dec",강원,원주시,539,165301,5839,171679,"2019-12-01",2019
"19-Dec",강원,인제군,217,17546,293,18056,"2019-12-01",2019
"19-Dec",강원,정선군,334,20150,479,20963,"2019-12-01",2019
"19-Dec",강원,철원군,229,23640,305,24174,"2019-12-01",2019
"19-Dec",강원,춘천시,801,127594,5995,134390,"2019-12-01",2019
"19-Dec",강원,태백시,228,19968,792,20988,"2019-12-01",2019
"19-Dec",강원,평창군,291,25065,511,25867,"2019-12-01",2019
"19-Dec",강원,홍천군,419,37329,1078,38826,"2019-12-01",2019
"19-Dec",강원,화천군,231,12578,201,13010,"2019-12-01",2019
"19-Dec",강원,횡성군,246,25471,715,26432,"2019-12-01",2019
"19-Dec",강원,계,5930,751433,25337,782700,"2019-12-01",2019
"19-Dec",충북,괴산군,201,22423,387,23011,"2019-12-01",2019
"19-Dec",충북,단양군,220,15547,759,16526,"2019-12-01",2019
"19-Dec",충북,보은군,219,17615,901,18735,"2019-12-01",2019
"19-Dec",충북,영동군,227,24675,381,25283,"2019-12-01",2019
"19-Dec",충북,옥천군,197,26087,1138,27422,"2019-12-01",2019
"19-Dec",충북,음성군,216,56983,1832,59031,"2019-12-01",2019
"19-Dec",충북,제천시,330,65790,3521,69641,"2019-12-01",2019
"19-Dec",충북,증평군,90,18738,753,19581,"2019-12-01",2019
"19-Dec",충북,진천군,210,46557,1313,48080,"2019-12-01",2019
"19-Dec",충북,청원군,1,19,0,20,"2019-12-01",2019
"19-Dec",충북,청주시 상당구,502,81676,2505,84683,"2019-12-01",2019
"19-Dec",충북,청주시 서원구,239,93323,5056,98618,"2019-12-01",2019
"19-Dec",충북,청주시 청원구,350,100289,4112,104751,"2019-12-01",2019
"19-Dec",충북,청주시 흥덕구,357,122652,7407,130416,"2019-12-01",2019
"19-Dec",충북,충주시,590,105746,5468,111804,"2019-12-01",2019
"19-Dec",충북,계,3949,798120,35533,837602,"2019-12-01",2019
"19-Dec",충남,계룡시,148,21193,546,21887,"2019-12-01",2019
"19-Dec",충남,공주시,572,52678,2270,55520,"2019-12-01",2019
"19-Dec",충남,금산군,194,27773,2155,30122,"2019-12-01",2019
"19-Dec",충남,논산시,383,59871,2429,62683,"2019-12-01",2019
"19-Dec",충남,당진시,376,92054,3825,96255,"2019-12-01",2019
"19-Dec",충남,보령시,391,51111,1310,52812,"2019-12-01",2019
"19-Dec",충남,부여군,285,33539,1254,35078,"2019-12-01",2019
"19-Dec",충남,서산시,405,91011,3411,94827,"2019-12-01",2019
"19-Dec",충남,서천군,232,26744,881,27857,"2019-12-01",2019
"19-Dec",충남,아산시,504,160461,6447,167412,"2019-12-01",2019
"19-Dec",충남,예산군,388,42187,1421,43996,"2019-12-01",2019
"19-Dec",충남,천안시 동남구,246,127632,4732,132610,"2019-12-01",2019
"19-Dec",충남,천안시 서북구,532,185633,5731,191896,"2019-12-01",2019
"19-Dec",충남,청양군,252,16773,827,17852,"2019-12-01",2019
"19-Dec",충남,태안군,288,33241,500,34029,"2019-12-01",2019
"19-Dec",충남,홍성군,418,51438,1425,53281,"2019-12-01",2019
"19-Dec",충남,계,5614,1073339,39164,1118117,"2019-12-01",2019
"19-Dec",전북,고창군,276,29675,591,30542,"2019-12-01",2019
"19-Dec",전북,군산시,528,127126,6439,134093,"2019-12-01",2019
"19-Dec",전북,김제시,308,44169,2019,46496,"2019-12-01",2019
"19-Dec",전북,남원시,410,39617,5326,45353,"2019-12-01",2019
"19-Dec",전북,무주군,185,12450,379,13014,"2019-12-01",2019
"19-Dec",전북,부안군,261,26899,614,27774,"2019-12-01",2019
"19-Dec",전북,순창군,229,14286,183,14698,"2019-12-01",2019
"19-Dec",전북,완주군,357,49728,3165,53250,"2019-12-01",2019
"19-Dec",전북,익산시,513,134675,6196,141384,"2019-12-01",2019
"19-Dec",전북,임실군,205,14456,429,15090,"2019-12-01",2019
"19-Dec",전북,장수군,243,11751,174,12168,"2019-12-01",2019
"19-Dec",전북,전주시 덕진구,407,165153,7481,173041,"2019-12-01",2019
"19-Dec",전북,전주시 완산구,670,146337,4104,151111,"2019-12-01",2019
"19-Dec",전북,정읍시,351,53010,3559,56920,"2019-12-01",2019
"19-Dec",전북,진안군,254,13669,204,14127,"2019-12-01",2019
"19-Dec",전북,계,5197,883001,40863,929061,"2019-12-01",2019
"19-Dec",전남,강진군,220,18067,1130,19417,"2019-12-01",2019
"19-Dec",전남,고흥군,297,30752,626,31675,"2019-12-01",2019
"19-Dec",전남,곡성군,151,14293,716,15160,"2019-12-01",2019
"19-Dec",전남,광양시,247,81797,5946,87990,"2019-12-01",2019
"19-Dec",전남,구례군,136,13057,649,13842,"2019-12-01",2019
"19-Dec",전남,나주시,468,61695,3251,65414,"2019-12-01",2019
"19-Dec",전남,담양군,214,25770,1560,27544,"2019-12-01",2019
"19-Dec",전남,목포시,444,95044,5750,101238,"2019-12-01",2019
"19-Dec",전남,무안군,553,41379,991,42923,"2019-12-01",2019
"19-Dec",전남,보성군,198,21019,49469,70686,"2019-12-01",2019
"19-Dec",전남,순천시,504,133897,5130,139531,"2019-12-01",2019
"19-Dec",전남,신안군,275,20380,1218,21873,"2019-12-01",2019
"19-Dec",전남,여수시,543,127301,7005,134849,"2019-12-01",2019
"19-Dec",전남,영광군,205,26931,727,27863,"2019-12-01",2019
"19-Dec",전남,영암군,251,32448,15843,48542,"2019-12-01",2019
"19-Dec",전남,완도군,251,24619,506,25376,"2019-12-01",2019
"19-Dec",전남,장성군,184,26015,1154,27353,"2019-12-01",2019
"19-Dec",전남,장흥군,206,19678,458,20342,"2019-12-01",2019
"19-Dec",전남,진도군,162,16176,298,16636,"2019-12-01",2019
"19-Dec",전남,함평군,191,17548,27750,45489,"2019-12-01",2019
"19-Dec",전남,해남군,344,38081,598,39023,"2019-12-01",2019
"19-Dec",전남,화순군,213,31228,2032,33473,"2019-12-01",2019
"19-Dec",전남,계,6257,917175,132807,1056239,"2019-12-01",2019
"19-Dec",경북,경산시,321,134093,4502,138916,"2019-12-01",2019
"19-Dec",경북,경주시,580,137679,4621,142880,"2019-12-01",2019
"19-Dec",경북,고령군,164,20220,498,20882,"2019-12-01",2019
"19-Dec",경북,구미시,515,208410,7241,216166,"2019-12-01",2019
"19-Dec",경북,군위군,114,14539,282,14935,"2019-12-01",2019
"19-Dec",경북,김천시,384,71820,1866,74070,"2019-12-01",2019
"19-Dec",경북,문경시,281,35649,824,36754,"2019-12-01",2019
"19-Dec",경북,봉화군,205,17395,200,17800,"2019-12-01",2019
"19-Dec",경북,상주시,380,52388,1857,54625,"2019-12-01",2019
"19-Dec",경북,성주군,204,29593,1398,31195,"2019-12-01",2019
"19-Dec",경북,안동시,719,79887,2619,83225,"2019-12-01",2019
"19-Dec",경북,영덕군,248,18538,294,19080,"2019-12-01",2019
"19-Dec",경북,영양군,140,9395,106,9641,"2019-12-01",2019
"19-Dec",경북,영주시,365,54394,1515,56274,"2019-12-01",2019
"19-Dec",경북,영천시,288,57990,2643,60921,"2019-12-01",2019
"19-Dec",경북,예천군,261,28172,471,28904,"2019-12-01",2019
"19-Dec",경북,울릉군,149,5166,494,5809,"2019-12-01",2019
"19-Dec",경북,울진군,297,25331,352,25980,"2019-12-01",2019
"19-Dec",경북,의성군,304,29817,950,31071,"2019-12-01",2019
"19-Dec",경북,청도군,208,24326,699,25233,"2019-12-01",2019
"19-Dec",경북,청송군,202,15056,204,15462,"2019-12-01",2019
"19-Dec",경북,칠곡군,350,67389,2275,70014,"2019-12-01",2019
"19-Dec",경북,포항시 남구,434,119304,8663,128401,"2019-12-01",2019
"19-Dec",경북,포항시 북구,343,133770,3911,138024,"2019-12-01",2019
"19-Dec",경북,계,7456,1390321,48485,1446262,"2019-12-01",2019
"19-Dec",경남,거제시,352,103849,2132,106333,"2019-12-01",2019
"19-Dec",경남,거창군,262,31204,799,32265,"2019-12-01",2019
"19-Dec",경남,고성군,220,25989,636,26845,"2019-12-01",2019
"19-Dec",경남,김해시,646,266211,7236,274093,"2019-12-01",2019
"19-Dec",경남,남해군,260,19156,474,19890,"2019-12-01",2019
"19-Dec",경남,밀양시,313,54060,3965,58338,"2019-12-01",2019
"19-Dec",경남,사천시,305,54688,1503,56496,"2019-12-01",2019
"19-Dec",경남,산청군,233,19485,791,20509,"2019-12-01",2019
"19-Dec",경남,양산시,404,159536,9935,169875,"2019-12-01",2019
"19-Dec",경남,의령군,193,13974,672,14839,"2019-12-01",2019
"19-Dec",경남,진주시,594,160628,6667,167889,"2019-12-01",2019
"19-Dec",경남,창녕군,240,34633,939,35812,"2019-12-01",2019
"19-Dec",경남,창원시 마산합포구,330,98099,2897,101326,"2019-12-01",2019
"19-Dec",경남,창원시 마산회원구,178,92883,5005,98066,"2019-12-01",2019
"19-Dec",경남,창원시 성산구,147,115557,5684,121388,"2019-12-01",2019
"19-Dec",경남,창원시 의창구,937,132639,18504,152080,"2019-12-01",2019
"19-Dec",경남,창원시 진해구,213,88518,1688,90419,"2019-12-01",2019
"19-Dec",경남,통영시,319,52040,1401,53760,"2019-12-01",2019
"19-Dec",경남,하동군,226,24142,461,24829,"2019-12-01",2019
"19-Dec",경남,함안군,191,40018,13151,53360,"2019-12-01",2019
"19-Dec",경남,함양군,213,18813,447,19473,"2019-12-01",2019
"19-Dec",경남,합천군,275,22697,646,23618,"2019-12-01",2019
"19-Dec",경남,계,7051,1628819,85633,1721503,"2019-12-01",2019
"19-Dec",제주,서귀포시,798,102085,2020,104903,"2019-12-01",2019
"19-Dec",제주,제주시,1629,265568,224115,491312,"2019-12-01",2019
"19-Dec",제주,계,2427,367653,226135,596215,"2019-12-01",2019
"20-Jan",서울,강남구,384,216264,18949,235597,"2020-01-01",2020
"20-Jan",서울,강동구,271,131936,8942,141149,"2020-01-01",2020
"20-Jan",서울,강북구,313,71484,4585,76382,"2020-01-01",2020
"20-Jan",서울,강서구,334,185634,18947,204915,"2020-01-01",2020
"20-Jan",서울,관악구,304,114058,5706,120068,"2020-01-01",2020
"20-Jan",서울,광진구,291,93301,5714,99306,"2020-01-01",2020
"20-Jan",서울,구로구,281,130622,13822,144725,"2020-01-01",2020
"20-Jan",서울,금천구,135,81590,5949,87674,"2020-01-01",2020
"20-Jan",서울,노원구,318,142687,9375,152380,"2020-01-01",2020
"20-Jan",서울,도봉구,268,88661,7393,96322,"2020-01-01",2020
"20-Jan",서울,동대문구,310,92449,5205,97964,"2020-01-01",2020
"20-Jan",서울,동작구,311,102318,2726,105355,"2020-01-01",2020
"20-Jan",서울,마포구,331,110740,7009,118080,"2020-01-01",2020
"20-Jan",서울,서대문구,448,80996,6047,87491,"2020-01-01",2020
"20-Jan",서울,서초구,540,167647,13156,181343,"2020-01-01",2020
"20-Jan",서울,성동구,339,94129,11667,106135,"2020-01-01",2020
"20-Jan",서울,성북구,286,113769,5336,119391,"2020-01-01",2020
"20-Jan",서울,송파구,383,227333,13303,241019,"2020-01-01",2020
"20-Jan",서울,양천구,320,140665,8794,149779,"2020-01-01",2020
"20-Jan",서울,영등포구,371,131893,9570,141834,"2020-01-01",2020
"20-Jan",서울,용산구,343,74031,2218,76592,"2020-01-01",2020
"20-Jan",서울,은평구,293,122392,7157,129842,"2020-01-01",2020
"20-Jan",서울,종로구,3871,44541,1686,50098,"2020-01-01",2020
"20-Jan",서울,중구,1089,45792,4530,51411,"2020-01-01",2020
"20-Jan",서울,중랑구,239,102856,9619,112714,"2020-01-01",2020
"20-Jan",서울,계,12373,2907788,207405,3127566,"2020-01-01",2020
"20-Jan",부산,강서구,326,72560,3705,76591,"2020-01-01",2020
"20-Jan",부산,금정구,281,81056,7490,88827,"2020-01-01",2020
"20-Jan",부산,기장군,260,72108,2369,74737,"2020-01-01",2020
"20-Jan",부산,남구,233,91166,8375,99774,"2020-01-01",2020
"20-Jan",부산,동구,188,46839,4901,51928,"2020-01-01",2020
"20-Jan",부산,동래구,179,91048,4306,95533,"2020-01-01",2020
"20-Jan",부산,부산진구,419,119465,15501,135385,"2020-01-01",2020
"20-Jan",부산,북구,243,100441,3400,104084,"2020-01-01",2020
"20-Jan",부산,사상구,285,83537,5948,89770,"2020-01-01",2020
"20-Jan",부산,사하구,266,107589,6887,114742,"2020-01-01",2020
"20-Jan",부산,서구,137,28037,1428,29602,"2020-01-01",2020
"20-Jan",부산,수영구,164,67006,26773,93943,"2020-01-01",2020
"20-Jan",부산,연제구,865,88288,9261,98414,"2020-01-01",2020
"20-Jan",부산,영도구,229,31000,2091,33320,"2020-01-01",2020
"20-Jan",부산,중구,309,25857,7295,33461,"2020-01-01",2020
"20-Jan",부산,해운대구,319,163902,12726,176947,"2020-01-01",2020
"20-Jan",부산,계,4703,1269899,122456,1397058,"2020-01-01",2020
"20-Jan",대구,남구,351,55589,1758,57698,"2020-01-01",2020
"20-Jan",대구,달서구,480,266401,14801,281682,"2020-01-01",2020
"20-Jan",대구,달성군,497,129335,4885,134717,"2020-01-01",2020
"20-Jan",대구,동구,346,150668,11479,162493,"2020-01-01",2020
"20-Jan",대구,북구,487,196009,7766,204262,"2020-01-01",2020
"20-Jan",대구,서구,237,69739,4117,74093,"2020-01-01",2020
"20-Jan",대구,수성구,604,213131,5500,219235,"2020-01-01",2020
"20-Jan",대구,중구,299,55200,1810,57309,"2020-01-01",2020
"20-Jan",대구,계,3301,1136072,52116,1191489,"2020-01-01",2020
"20-Jan",인천,강화군,330,33570,49361,83261,"2020-01-01",2020
"20-Jan",인천,계양구,287,119692,189021,309000,"2020-01-01",2020
"20-Jan",인천,남동구,830,253502,38465,292797,"2020-01-01",2020
"20-Jan",인천,동구,91,26377,3872,30340,"2020-01-01",2020
"20-Jan",인천,미추홀구,411,154548,13333,168292,"2020-01-01",2020
"20-Jan",인천,부평구,334,213918,14684,228936,"2020-01-01",2020
"20-Jan",인천,서구,421,234207,11254,245882,"2020-01-01",2020
"20-Jan",인천,연수구,392,177992,7626,186010,"2020-01-01",2020
"20-Jan",인천,옹진군,208,11632,203,12043,"2020-01-01",2020
"20-Jan",인천,중구,644,62371,17864,80879,"2020-01-01",2020
"20-Jan",인천,계,3948,1287809,345683,1637440,"2020-01-01",2020
"20-Jan",광주,광산구,500,188388,12128,201016,"2020-01-01",2020
"20-Jan",광주,남구,218,89194,2688,92100,"2020-01-01",2020
"20-Jan",광주,동구,238,39347,1185,40770,"2020-01-01",2020
"20-Jan",광주,북구,614,185230,9719,195563,"2020-01-01",2020
"20-Jan",광주,서구,633,140967,6884,148484,"2020-01-01",2020
"20-Jan",광주,계,2203,643126,32604,677933,"2020-01-01",2020
"20-Jan",대전,대덕구,231,83802,6873,90906,"2020-01-01",2020
"20-Jan",대전,동구,254,88940,4329,93523,"2020-01-01",2020
"20-Jan",대전,서구,801,202785,7377,210963,"2020-01-01",2020
"20-Jan",대전,유성구,382,171669,5201,177252,"2020-01-01",2020
"20-Jan",대전,중구,232,96480,5909,102621,"2020-01-01",2020
"20-Jan",대전,계,1900,643676,29689,675265,"2020-01-01",2020
"20-Jan",울산,남구,701,151701,7109,159511,"2020-01-01",2020
"20-Jan",울산,동구,195,61330,1031,62556,"2020-01-01",2020
"20-Jan",울산,북구,185,109693,3911,113789,"2020-01-01",2020
"20-Jan",울산,울주군,379,120393,6720,127492,"2020-01-01",2020
"20-Jan",울산,중구,342,100316,2589,103247,"2020-01-01",2020
"20-Jan",울산,계,1802,543433,21360,566595,"2020-01-01",2020
"20-Jan",세종,세종특별자치시,764,160938,2797,164499,"2020-01-01",2020
"20-Jan",세종,계,764,160938,2797,164499,"2020-01-01",2020
"20-Jan",경기,가평군,365,29779,638,30782,"2020-01-01",2020
"20-Jan",경기,고양시 덕양구,671,170198,4056,174925,"2020-01-01",2020
"20-Jan",경기,고양시 일산동구,284,120161,6305,126750,"2020-01-01",2020
"20-Jan",경기,고양시 일산서구,130,113869,4226,118225,"2020-01-01",2020
"20-Jan",경기,과천시,721,20824,609,22154,"2020-01-01",2020
"20-Jan",경기,광명시,312,102439,4218,106969,"2020-01-01",2020
"20-Jan",경기,광주시,381,183035,8214,191630,"2020-01-01",2020
"20-Jan",경기,구리시,253,69583,2591,72427,"2020-01-01",2020
"20-Jan",경기,군포시,297,96674,5098,102069,"2020-01-01",2020
"20-Jan",경기,김포시,487,201549,7426,209462,"2020-01-01",2020
"20-Jan",경기,남양주시,679,283284,7976,291939,"2020-01-01",2020
"20-Jan",경기,동두천시,208,36845,1340,38393,"2020-01-01",2020
"20-Jan",경기,부천시,701,292212,12998,305911,"2020-01-01",2020
"20-Jan",경기,성남시 분당구,356,182220,6848,189424,"2020-01-01",2020
"20-Jan",경기,성남시 수정구,359,71932,2377,74668,"2020-01-01",2020
"20-Jan",경기,성남시 중원구,325,70771,4295,75391,"2020-01-01",2020
"20-Jan",경기,수원시 권선구,406,173805,8450,182661,"2020-01-01",2020
"20-Jan",경기,수원시 영통구,224,143698,3176,147098,"2020-01-01",2020
"20-Jan",경기,수원시 장안구,564,102142,3869,106575,"2020-01-01",2020
"20-Jan",경기,수원시 팔달구,498,67616,2997,71111,"2020-01-01",2020
"20-Jan",경기,시흥시,458,227047,7576,235081,"2020-01-01",2020
"20-Jan",경기,안산시 단원구,573,150305,8156,159034,"2020-01-01",2020
"20-Jan",경기,안산시 상록구,175,133917,4759,138851,"2020-01-01",2020
"20-Jan",경기,안성시,385,97745,5015,103145,"2020-01-01",2020
"20-Jan",경기,안양시 동안구,410,116235,6285,122930,"2020-01-01",2020
"20-Jan",경기,안양시 만안구,148,82707,3948,86803,"2020-01-01",2020
"20-Jan",경기,양주시,374,100504,3137,104015,"2020-01-01",2020
"20-Jan",경기,양평군,554,57803,1778,60135,"2020-01-01",2020
"20-Jan",경기,여주시,439,60828,7542,68809,"2020-01-01",2020
"20-Jan",경기,연천군,300,23274,5325,28899,"2020-01-01",2020
"20-Jan",경기,오산시,207,101721,3340,105268,"2020-01-01",2020
"20-Jan",경기,용인시 기흥구,133,184205,6125,190463,"2020-01-01",2020
"20-Jan",경기,용인시 수지구,49,139141,2273,141463,"2020-01-01",2020
"20-Jan",경기,용인시 처인구,753,124954,7178,132885,"2020-01-01",2020
"20-Jan",경기,의왕시,289,61936,3199,65424,"2020-01-01",2020
"20-Jan",경기,의정부시,666,153732,5021,159419,"2020-01-01",2020
"20-Jan",경기,이천시,407,108481,5884,114772,"2020-01-01",2020
"20-Jan",경기,파주시,505,202335,9429,212269,"2020-01-01",2020
"20-Jan",경기,평택시,700,262230,11786,274716,"2020-01-01",2020
"20-Jan",경기,포천시,378,83003,9888,93269,"2020-01-01",2020
"20-Jan",경기,하남시,387,111205,2731,114323,"2020-01-01",2020
"20-Jan",경기,화성시,876,416342,11308,428526,"2020-01-01",2020
"20-Jan",경기,계,17387,5532286,229390,5779063,"2020-01-01",2020
"20-Jan",강원,강릉시,518,104018,4711,109247,"2020-01-01",2020
"20-Jan",강원,고성군,179,13832,232,14243,"2020-01-01",2020
"20-Jan",강원,동해시,306,43733,1394,45433,"2020-01-01",2020
"20-Jan",강원,삼척시,395,31598,735,32728,"2020-01-01",2020
"20-Jan",강원,속초시,290,36468,1353,38111,"2020-01-01",2020
"20-Jan",강원,양구군,184,11787,121,12092,"2020-01-01",2020
"20-Jan",강원,양양군,186,15202,239,15627,"2020-01-01",2020
"20-Jan",강원,영월군,334,20645,362,21341,"2020-01-01",2020
"20-Jan",강원,원주시,537,166193,5835,172565,"2020-01-01",2020
"20-Jan",강원,인제군,217,17590,294,18101,"2020-01-01",2020
"20-Jan",강원,정선군,334,20176,480,20990,"2020-01-01",2020
"20-Jan",강원,철원군,233,23663,305,24201,"2020-01-01",2020
"20-Jan",강원,춘천시,805,128021,5999,134825,"2020-01-01",2020
"20-Jan",강원,태백시,227,19996,794,21017,"2020-01-01",2020
"20-Jan",강원,평창군,291,25134,508,25933,"2020-01-01",2020
"20-Jan",강원,홍천군,421,37383,1082,38886,"2020-01-01",2020
"20-Jan",강원,화천군,232,12575,200,13007,"2020-01-01",2020
"20-Jan",강원,횡성군,245,25499,717,26461,"2020-01-01",2020
"20-Jan",강원,계,5934,753513,25361,784808,"2020-01-01",2020
"20-Jan",충북,괴산군,207,22199,385,22791,"2020-01-01",2020
"20-Jan",충북,단양군,219,15583,763,16565,"2020-01-01",2020
"20-Jan",충북,보은군,217,17660,917,18794,"2020-01-01",2020
"20-Jan",충북,영동군,226,24746,388,25360,"2020-01-01",2020
"20-Jan",충북,옥천군,197,26183,1140,27520,"2020-01-01",2020
"20-Jan",충북,음성군,216,57185,1836,59237,"2020-01-01",2020
"20-Jan",충북,제천시,331,65589,3515,69435,"2020-01-01",2020
"20-Jan",충북,증평군,90,18834,756,19680,"2020-01-01",2020
"20-Jan",충북,진천군,210,46779,1314,48303,"2020-01-01",2020
"20-Jan",충북,청원군,1,19,0,20,"2020-01-01",2020
"20-Jan",충북,청주시 상당구,505,82373,2518,85396,"2020-01-01",2020
"20-Jan",충북,청주시 서원구,239,93146,5048,98433,"2020-01-01",2020
"20-Jan",충북,청주시 청원구,349,100260,4105,104714,"2020-01-01",2020
"20-Jan",충북,청주시 흥덕구,361,122945,7489,130795,"2020-01-01",2020
"20-Jan",충북,충주시,591,106097,5460,112148,"2020-01-01",2020
"20-Jan",충북,계,3959,799598,35634,839191,"2020-01-01",2020
"20-Jan",충남,계룡시,149,21158,544,21851,"2020-01-01",2020
"20-Jan",충남,공주시,571,52766,2259,55596,"2020-01-01",2020
"20-Jan",충남,금산군,196,28045,2178,30419,"2020-01-01",2020
"20-Jan",충남,논산시,386,60046,2418,62850,"2020-01-01",2020
"20-Jan",충남,당진시,376,92313,3832,96521,"2020-01-01",2020
"20-Jan",충남,보령시,391,51114,1305,52810,"2020-01-01",2020
"20-Jan",충남,부여군,287,33659,1253,35199,"2020-01-01",2020
"20-Jan",충남,서산시,405,91348,3421,95174,"2020-01-01",2020
"20-Jan",충남,서천군,229,26815,883,27927,"2020-01-01",2020
"20-Jan",충남,아산시,504,160771,6403,167678,"2020-01-01",2020
"20-Jan",충남,예산군,388,42287,1393,44068,"2020-01-01",2020
"20-Jan",충남,천안시 동남구,245,127989,4765,132999,"2020-01-01",2020
"20-Jan",충남,천안시 서북구,532,186541,5704,192777,"2020-01-01",2020
"20-Jan",충남,청양군,254,16782,831,17867,"2020-01-01",2020
"20-Jan",충남,태안군,292,33352,522,34166,"2020-01-01",2020
"20-Jan",충남,홍성군,416,51598,1433,53447,"2020-01-01",2020
"20-Jan",충남,계,5621,1076584,39144,1121349,"2020-01-01",2020
"20-Jan",전북,고창군,274,29852,594,30720,"2020-01-01",2020
"20-Jan",전북,군산시,530,127332,6445,134307,"2020-01-01",2020
"20-Jan",전북,김제시,307,44336,2032,46675,"2020-01-01",2020
"20-Jan",전북,남원시,401,39769,5322,45492,"2020-01-01",2020
"20-Jan",전북,무주군,186,12483,379,13048,"2020-01-01",2020
"20-Jan",전북,부안군,263,26966,619,27848,"2020-01-01",2020
"20-Jan",전북,순창군,233,14369,184,14786,"2020-01-01",2020
"20-Jan",전북,완주군,360,49893,3181,53434,"2020-01-01",2020
"20-Jan",전북,익산시,512,134999,6190,141701,"2020-01-01",2020
"20-Jan",전북,임실군,204,14310,431,14945,"2020-01-01",2020
"20-Jan",전북,장수군,242,11780,176,12198,"2020-01-01",2020
"20-Jan",전북,전주시 덕진구,406,165519,7461,173386,"2020-01-01",2020
"20-Jan",전북,전주시 완산구,668,146665,4114,151447,"2020-01-01",2020
"20-Jan",전북,정읍시,351,53143,3521,57015,"2020-01-01",2020
"20-Jan",전북,진안군,257,13762,210,14229,"2020-01-01",2020
"20-Jan",전북,계,5194,885178,40859,931231,"2020-01-01",2020
"20-Jan",전남,강진군,219,18146,1133,19498,"2020-01-01",2020
"20-Jan",전남,고흥군,295,30834,630,31759,"2020-01-01",2020
"20-Jan",전남,곡성군,152,14329,716,15197,"2020-01-01",2020
"20-Jan",전남,광양시,246,80462,5965,86673,"2020-01-01",2020
"20-Jan",전남,구례군,136,12972,652,13760,"2020-01-01",2020
"20-Jan",전남,나주시,463,61909,3244,65616,"2020-01-01",2020
"20-Jan",전남,담양군,212,25794,1564,27570,"2020-01-01",2020
"20-Jan",전남,목포시,443,95371,5739,101553,"2020-01-01",2020
"20-Jan",전남,무안군,548,41542,997,43087,"2020-01-01",2020
"20-Jan",전남,보성군,198,21081,40820,62099,"2020-01-01",2020
"20-Jan",전남,순천시,498,134872,5100,140470,"2020-01-01",2020
"20-Jan",전남,신안군,269,20428,17285,37982,"2020-01-01",2020
"20-Jan",전남,여수시,544,127489,7030,135063,"2020-01-01",2020
"20-Jan",전남,영광군,203,27002,726,27931,"2020-01-01",2020
"20-Jan",전남,영암군,250,32550,13618,46418,"2020-01-01",2020
"20-Jan",전남,완도군,249,24733,500,25482,"2020-01-01",2020
"20-Jan",전남,장성군,182,26043,1153,27378,"2020-01-01",2020
"20-Jan",전남,장흥군,206,19734,461,20401,"2020-01-01",2020
"20-Jan",전남,진도군,160,16239,300,16699,"2020-01-01",2020
"20-Jan",전남,함평군,190,17661,25635,43486,"2020-01-01",2020
"20-Jan",전남,해남군,341,38119,598,39058,"2020-01-01",2020
"20-Jan",전남,화순군,209,31344,2046,33599,"2020-01-01",2020
"20-Jan",전남,계,6213,918654,135912,1060779,"2020-01-01",2020
"20-Jan",경북,경산시,320,134519,4520,139359,"2020-01-01",2020
"20-Jan",경북,경주시,579,138117,4632,143328,"2020-01-01",2020
"20-Jan",경북,고령군,165,20262,510,20937,"2020-01-01",2020
"20-Jan",경북,구미시,511,209038,7247,216796,"2020-01-01",2020
"20-Jan",경북,군위군,114,14610,283,15007,"2020-01-01",2020
"20-Jan",경북,김천시,387,71946,1869,74202,"2020-01-01",2020
"20-Jan",경북,문경시,281,35625,832,36738,"2020-01-01",2020
"20-Jan",경북,봉화군,205,17452,199,17856,"2020-01-01",2020
"20-Jan",경북,상주시,385,52279,1862,54526,"2020-01-01",2020
"20-Jan",경북,성주군,204,29737,1415,31356,"2020-01-01",2020
"20-Jan",경북,안동시,727,80120,2616,83463,"2020-01-01",2020
"20-Jan",경북,영덕군,248,18597,306,19151,"2020-01-01",2020
"20-Jan",경북,영양군,139,9430,107,9676,"2020-01-01",2020
"20-Jan",경북,영주시,365,54510,1516,56391,"2020-01-01",2020
"20-Jan",경북,영천시,288,57981,2637,60906,"2020-01-01",2020
"20-Jan",경북,예천군,260,28316,473,29049,"2020-01-01",2020
"20-Jan",경북,울릉군,149,5161,494,5804,"2020-01-01",2020
"20-Jan",경북,울진군,299,25365,353,26017,"2020-01-01",2020
"20-Jan",경북,의성군,308,29931,949,31188,"2020-01-01",2020
"20-Jan",경북,청도군,209,24434,701,25344,"2020-01-01",2020
"20-Jan",경북,청송군,199,15135,204,15538,"2020-01-01",2020
"20-Jan",경북,칠곡군,349,67476,2282,70107,"2020-01-01",2020
"20-Jan",경북,포항시 남구,435,119360,8663,128458,"2020-01-01",2020
"20-Jan",경북,포항시 북구,344,134294,3926,138564,"2020-01-01",2020
"20-Jan",경북,계,7470,1393695,48596,1449761,"2020-01-01",2020
"20-Jan",경남,거제시,351,104072,2130,106553,"2020-01-01",2020
"20-Jan",경남,거창군,263,31312,801,32376,"2020-01-01",2020
"20-Jan",경남,고성군,218,26057,634,26909,"2020-01-01",2020
"20-Jan",경남,김해시,645,267003,7297,274945,"2020-01-01",2020
"20-Jan",경남,남해군,260,19225,473,19958,"2020-01-01",2020
"20-Jan",경남,밀양시,314,54240,3977,58531,"2020-01-01",2020
"20-Jan",경남,사천시,303,54838,1520,56661,"2020-01-01",2020
"20-Jan",경남,산청군,233,19516,798,20547,"2020-01-01",2020
"20-Jan",경남,양산시,404,160069,9915,170388,"2020-01-01",2020
"20-Jan",경남,의령군,194,14015,672,14881,"2020-01-01",2020
"20-Jan",경남,진주시,594,161202,6650,168446,"2020-01-01",2020
"20-Jan",경남,창녕군,241,34665,938,35844,"2020-01-01",2020
"20-Jan",경남,창원시 마산합포구,331,97763,2894,100988,"2020-01-01",2020
"20-Jan",경남,창원시 마산회원구,178,93172,5027,98377,"2020-01-01",2020
"20-Jan",경남,창원시 성산구,148,115133,6291,121572,"2020-01-01",2020
"20-Jan",경남,창원시 의창구,922,133779,18681,153382,"2020-01-01",2020
"20-Jan",경남,창원시 진해구,211,88633,1680,90524,"2020-01-01",2020
"20-Jan",경남,통영시,323,52144,1404,53871,"2020-01-01",2020
"20-Jan",경남,하동군,230,24148,446,24824,"2020-01-01",2020
"20-Jan",경남,함안군,186,40013,13412,53611,"2020-01-01",2020
"20-Jan",경남,함양군,214,18855,436,19505,"2020-01-01",2020
"20-Jan",경남,합천군,273,22718,643,23634,"2020-01-01",2020
"20-Jan",경남,계,7036,1632572,86719,1726327,"2020-01-01",2020
"20-Jan",제주,서귀포시,795,102081,2017,104893,"2020-01-01",2020
"20-Jan",제주,제주시,1625,264960,228454,495039,"2020-01-01",2020
"20-Jan",제주,계,2420,367041,230471,599932,"2020-01-01",2020
"20-Feb",서울,강남구,387,216414,18575,235376,"2020-02-01",2020
"20-Feb",서울,강동구,278,133983,8876,143137,"2020-02-01",2020
"20-Feb",서울,강북구,311,71380,4574,76265,"2020-02-01",2020
"20-Feb",서울,강서구,334,184700,18966,204000,"2020-02-01",2020
"20-Feb",서울,관악구,305,113654,5687,119646,"2020-02-01",2020
"20-Feb",서울,광진구,286,93084,5719,99089,"2020-02-01",2020
"20-Feb",서울,구로구,282,130355,13302,143939,"2020-02-01",2020
"20-Feb",서울,금천구,136,81417,5941,87494,"2020-02-01",2020
"20-Feb",서울,노원구,319,142427,9426,152172,"2020-02-01",2020
"20-Feb",서울,도봉구,266,88345,7358,95969,"2020-02-01",2020
"20-Feb",서울,동대문구,311,92216,5185,97712,"2020-02-01",2020
"20-Feb",서울,동작구,310,102022,2734,105066,"2020-02-01",2020
"20-Feb",서울,마포구,328,110829,6975,118132,"2020-02-01",2020
"20-Feb",서울,서대문구,447,81293,6000,87740,"2020-02-01",2020
"20-Feb",서울,서초구,552,167468,13111,181131,"2020-02-01",2020
"20-Feb",서울,성동구,346,93624,11784,105754,"2020-02-01",2020
"20-Feb",서울,성북구,290,113493,5319,119102,"2020-02-01",2020
"20-Feb",서울,송파구,386,226887,13398,240671,"2020-02-01",2020
"20-Feb",서울,양천구,317,140366,8791,149474,"2020-02-01",2020
"20-Feb",서울,영등포구,368,132400,9664,142432,"2020-02-01",2020
"20-Feb",서울,용산구,342,74056,2029,76427,"2020-02-01",2020
"20-Feb",서울,은평구,290,121996,7166,129452,"2020-02-01",2020
"20-Feb",서울,종로구,3872,44508,1714,50094,"2020-02-01",2020
"20-Feb",서울,중구,1107,45698,4472,51277,"2020-02-01",2020
"20-Feb",서울,중랑구,239,102647,9547,112433,"2020-02-01",2020
"20-Feb",서울,계,12409,2905262,206313,3123984,"2020-02-01",2020
"20-Feb",부산,강서구,319,72837,3621,76777,"2020-02-01",2020
"20-Feb",부산,금정구,275,80906,7471,88652,"2020-02-01",2020
"20-Feb",부산,기장군,259,72791,2389,75439,"2020-02-01",2020
"20-Feb",부산,남구,227,90779,8387,99393,"2020-02-01",2020
"20-Feb",부산,동구,187,47014,4869,52070,"2020-02-01",2020
"20-Feb",부산,동래구,177,91119,4231,95527,"2020-02-01",2020
"20-Feb",부산,부산진구,409,119198,16359,135966,"2020-02-01",2020
"20-Feb",부산,북구,234,100224,3385,103843,"2020-02-01",2020
"20-Feb",부산,사상구,283,83340,6026,89649,"2020-02-01",2020
"20-Feb",부산,사하구,259,107341,6856,114456,"2020-02-01",2020
"20-Feb",부산,서구,133,27989,1428,29550,"2020-02-01",2020
"20-Feb",부산,수영구,164,67349,27339,94852,"2020-02-01",2020
"20-Feb",부산,연제구,862,88392,9341,98595,"2020-02-01",2020
"20-Feb",부산,영도구,228,30918,2086,33232,"2020-02-01",2020
"20-Feb",부산,중구,308,26097,7282,33687,"2020-02-01",2020
"20-Feb",부산,해운대구,309,163873,12768,176950,"2020-02-01",2020
"20-Feb",부산,계,4633,1270167,123838,1398638,"2020-02-01",2020
"20-Feb",대구,남구,352,55656,1754,57762,"2020-02-01",2020
"20-Feb",대구,달서구,481,266692,14770,281943,"2020-02-01",2020
"20-Feb",대구,달성군,496,129331,4888,134715,"2020-02-01",2020
"20-Feb",대구,동구,345,150311,11385,162041,"2020-02-01",2020
"20-Feb",대구,북구,486,196012,7772,204270,"2020-02-01",2020
"20-Feb",대구,서구,237,69831,4137,74205,"2020-02-01",2020
"20-Feb",대구,수성구,592,213167,5424,219183,"2020-02-01",2020
"20-Feb",대구,중구,297,55463,1818,57578,"2020-02-01",2020
"20-Feb",대구,계,3286,1136463,51948,1191697,"2020-02-01",2020
"20-Feb",인천,강화군,332,33561,48574,82467,"2020-02-01",2020
"20-Feb",인천,계양구,289,119159,188394,307842,"2020-02-01",2020
"20-Feb",인천,남동구,837,253415,38258,292510,"2020-02-01",2020
"20-Feb",인천,동구,90,26120,3948,30158,"2020-02-01",2020
"20-Feb",인천,미추홀구,414,154345,12983,167742,"2020-02-01",2020
"20-Feb",인천,부평구,334,213640,15116,229090,"2020-02-01",2020
"20-Feb",인천,서구,423,233860,11213,245496,"2020-02-01",2020
"20-Feb",인천,연수구,392,179049,7670,187111,"2020-02-01",2020
"20-Feb",인천,옹진군,210,11658,206,12074,"2020-02-01",2020
"20-Feb",인천,중구,675,62556,17868,81099,"2020-02-01",2020
"20-Feb",인천,계,3996,1287363,344230,1635589,"2020-02-01",2020
"20-Feb",광주,광산구,494,188812,12139,201445,"2020-02-01",2020
"20-Feb",광주,남구,218,89270,2679,92167,"2020-02-01",2020
"20-Feb",광주,동구,230,39440,1183,40853,"2020-02-01",2020
"20-Feb",광주,북구,605,185477,9644,195726,"2020-02-01",2020
"20-Feb",광주,서구,630,140720,6901,148251,"2020-02-01",2020
"20-Feb",광주,계,2177,643719,32546,678442,"2020-02-01",2020
"20-Feb",대전,대덕구,228,83776,6884,90888,"2020-02-01",2020
"20-Feb",대전,동구,244,88773,4317,93334,"2020-02-01",2020
"20-Feb",대전,서구,797,203156,7358,211311,"2020-02-01",2020
"20-Feb",대전,유성구,379,172058,5178,177615,"2020-02-01",2020
"20-Feb",대전,중구,232,96418,5887,102537,"2020-02-01",2020
"20-Feb",대전,계,1880,644181,29624,675685,"2020-02-01",2020
"20-Feb",울산,남구,704,151919,7162,159785,"2020-02-01",2020
"20-Feb",울산,동구,196,61251,1027,62474,"2020-02-01",2020
"20-Feb",울산,북구,184,109817,3885,113886,"2020-02-01",2020
"20-Feb",울산,울주군,382,120368,6708,127458,"2020-02-01",2020
"20-Feb",울산,중구,342,100150,2584,103076,"2020-02-01",2020
"20-Feb",울산,계,1808,543505,21366,566679,"2020-02-01",2020
"20-Feb",세종,세종특별자치시,761,161930,2795,165486,"2020-02-01",2020
"20-Feb",세종,계,761,161930,2795,165486,"2020-02-01",2020
"20-Feb",경기,가평군,369,29796,638,30803,"2020-02-01",2020
"20-Feb",경기,고양시 덕양구,673,170833,4060,175566,"2020-02-01",2020
"20-Feb",경기,고양시 일산동구,287,120311,6142,126740,"2020-02-01",2020
"20-Feb",경기,고양시 일산서구,124,113805,4213,118142,"2020-02-01",2020
"20-Feb",경기,과천시,718,20792,594,22104,"2020-02-01",2020
"20-Feb",경기,광명시,317,102552,4203,107072,"2020-02-01",2020
"20-Feb",경기,광주시,379,182893,8287,191559,"2020-02-01",2020
"20-Feb",경기,구리시,254,69464,2633,72351,"2020-02-01",2020
"20-Feb",경기,군포시,295,96631,5119,102045,"2020-02-01",2020
"20-Feb",경기,김포시,483,201712,7399,209594,"2020-02-01",2020
"20-Feb",경기,남양주시,676,283720,8090,292486,"2020-02-01",2020
"20-Feb",경기,동두천시,206,36656,1342,38204,"2020-02-01",2020
"20-Feb",경기,부천시,696,291232,12939,304867,"2020-02-01",2020
"20-Feb",경기,성남시 분당구,348,182060,7074,189482,"2020-02-01",2020
"20-Feb",경기,성남시 수정구,355,71869,2369,74593,"2020-02-01",2020
"20-Feb",경기,성남시 중원구,330,70687,4040,75057,"2020-02-01",2020
"20-Feb",경기,수원시 권선구,397,172381,8454,181232,"2020-02-01",2020
"20-Feb",경기,수원시 영통구,223,143814,3152,147189,"2020-02-01",2020
"20-Feb",경기,수원시 장안구,560,101810,3849,106219,"2020-02-01",2020
"20-Feb",경기,수원시 팔달구,496,67423,2996,70915,"2020-02-01",2020
"20-Feb",경기,시흥시,456,227265,7565,235286,"2020-02-01",2020
"20-Feb",경기,안산시 단원구,564,150049,8099,158712,"2020-02-01",2020
"20-Feb",경기,안산시 상록구,170,134207,4760,139137,"2020-02-01",2020
"20-Feb",경기,안성시,389,97782,5036,103207,"2020-02-01",2020
"20-Feb",경기,안양시 동안구,403,115712,6245,122360,"2020-02-01",2020
"20-Feb",경기,안양시 만안구,144,82229,3943,86316,"2020-02-01",2020
"20-Feb",경기,양주시,375,100547,3125,104047,"2020-02-01",2020
"20-Feb",경기,양평군,557,57830,1771,60158,"2020-02-01",2020
"20-Feb",경기,여주시,440,60794,7550,68784,"2020-02-01",2020
"20-Feb",경기,연천군,298,23168,5338,28804,"2020-02-01",2020
"20-Feb",경기,오산시,207,101689,3340,105236,"2020-02-01",2020
"20-Feb",경기,용인시 기흥구,133,184078,6142,190353,"2020-02-01",2020
"20-Feb",경기,용인시 수지구,48,139730,2285,142063,"2020-02-01",2020
"20-Feb",경기,용인시 처인구,754,125198,7205,133157,"2020-02-01",2020
"20-Feb",경기,의왕시,288,62688,3204,66180,"2020-02-01",2020
"20-Feb",경기,의정부시,669,153964,5050,159683,"2020-02-01",2020
"20-Feb",경기,이천시,405,108447,5901,114753,"2020-02-01",2020
"20-Feb",경기,파주시,508,202139,9466,212113,"2020-02-01",2020
"20-Feb",경기,평택시,705,263266,11830,275801,"2020-02-01",2020
"20-Feb",경기,포천시,375,82622,9746,92743,"2020-02-01",2020
"20-Feb",경기,하남시,394,111874,2733,115001,"2020-02-01",2020
"20-Feb",경기,화성시,884,417872,11343,430099,"2020-02-01",2020
"20-Feb",경기,계,17352,5533591,229270,5780213,"2020-02-01",2020
"20-Feb",강원,강릉시,520,104133,4681,109334,"2020-02-01",2020
"20-Feb",강원,고성군,179,13843,235,14257,"2020-02-01",2020
"20-Feb",강원,동해시,302,43641,1383,45326,"2020-02-01",2020
"20-Feb",강원,삼척시,397,31619,735,32751,"2020-02-01",2020
"20-Feb",강원,속초시,287,36467,1351,38105,"2020-02-01",2020
"20-Feb",강원,양구군,181,11716,121,12018,"2020-02-01",2020
"20-Feb",강원,양양군,184,15247,236,15667,"2020-02-01",2020
"20-Feb",강원,영월군,329,20666,363,21358,"2020-02-01",2020
"20-Feb",강원,원주시,540,166836,5824,173200,"2020-02-01",2020
"20-Feb",강원,인제군,215,17633,293,18141,"2020-02-01",2020
"20-Feb",강원,정선군,331,20127,476,20934,"2020-02-01",2020
"20-Feb",강원,철원군,232,23638,307,24177,"2020-02-01",2020
"20-Feb",강원,춘천시,798,128347,6002,135147,"2020-02-01",2020
"20-Feb",강원,태백시,222,19979,788,20989,"2020-02-01",2020
"20-Feb",강원,평창군,284,25098,512,25894,"2020-02-01",2020
"20-Feb",강원,홍천군,413,37399,1074,38886,"2020-02-01",2020
"20-Feb",강원,화천군,230,12530,202,12962,"2020-02-01",2020
"20-Feb",강원,횡성군,244,25691,725,26660,"2020-02-01",2020
"20-Feb",강원,계,5888,754610,25308,785806,"2020-02-01",2020
"20-Feb",충북,괴산군,207,22195,388,22790,"2020-02-01",2020
"20-Feb",충북,단양군,219,15539,772,16530,"2020-02-01",2020
"20-Feb",충북,보은군,220,17695,906,18821,"2020-02-01",2020
"20-Feb",충북,영동군,230,24743,389,25362,"2020-02-01",2020
"20-Feb",충북,옥천군,198,26206,1136,27540,"2020-02-01",2020
"20-Feb",충북,음성군,221,57235,1834,59290,"2020-02-01",2020
"20-Feb",충북,제천시,325,65643,3519,69487,"2020-02-01",2020
"20-Feb",충북,증평군,91,18845,759,19695,"2020-02-01",2020
"20-Feb",충북,진천군,213,46937,1317,48467,"2020-02-01",2020
"20-Feb",충북,청원군,1,19,0,20,"2020-02-01",2020
"20-Feb",충북,청주시 상당구,504,82861,2514,85879,"2020-02-01",2020
"20-Feb",충북,청주시 서원구,238,93010,5057,98305,"2020-02-01",2020
"20-Feb",충북,청주시 청원구,344,100452,4014,104810,"2020-02-01",2020
"20-Feb",충북,청주시 흥덕구,361,123506,7444,131311,"2020-02-01",2020
"20-Feb",충북,충주시,584,106369,5446,112399,"2020-02-01",2020
"20-Feb",충북,계,3956,801255,35495,840706,"2020-02-01",2020
"20-Feb",충남,계룡시,149,21209,543,21901,"2020-02-01",2020
"20-Feb",충남,공주시,576,52880,2255,55711,"2020-02-01",2020
"20-Feb",충남,금산군,193,28066,2193,30452,"2020-02-01",2020
"20-Feb",충남,논산시,394,60161,2416,62971,"2020-02-01",2020
"20-Feb",충남,당진시,384,92418,3828,96630,"2020-02-01",2020
"20-Feb",충남,보령시,394,51322,1309,53025,"2020-02-01",2020
"20-Feb",충남,부여군,286,33771,1256,35313,"2020-02-01",2020
"20-Feb",충남,서산시,396,91554,3428,95378,"2020-02-01",2020
"20-Feb",충남,서천군,230,26843,882,27955,"2020-02-01",2020
"20-Feb",충남,아산시,504,160775,6386,167665,"2020-02-01",2020
"20-Feb",충남,예산군,397,42280,1391,44068,"2020-02-01",2020
"20-Feb",충남,천안시 동남구,243,128297,4774,133314,"2020-02-01",2020
"20-Feb",충남,천안시 서북구,537,187110,5668,193315,"2020-02-01",2020
"20-Feb",충남,청양군,257,16748,816,17821,"2020-02-01",2020
"20-Feb",충남,태안군,291,33363,520,34174,"2020-02-01",2020
"20-Feb",충남,홍성군,420,51659,1448,53527,"2020-02-01",2020
"20-Feb",충남,계,5651,1078456,39113,1123220,"2020-02-01",2020
"20-Feb",전북,고창군,277,29746,586,30609,"2020-02-01",2020
"20-Feb",전북,군산시,524,127300,6446,134270,"2020-02-01",2020
"20-Feb",전북,김제시,306,44448,2021,46775,"2020-02-01",2020
"20-Feb",전북,남원시,401,39936,5209,45546,"2020-02-01",2020
"20-Feb",전북,무주군,191,12508,374,13073,"2020-02-01",2020
"20-Feb",전북,부안군,264,27033,620,27917,"2020-02-01",2020
"20-Feb",전북,순창군,232,14394,187,14813,"2020-02-01",2020
"20-Feb",전북,완주군,360,50010,3191,53561,"2020-02-01",2020
"20-Feb",전북,익산시,515,134933,6156,141604,"2020-02-01",2020
"20-Feb",전북,임실군,204,14229,428,14861,"2020-02-01",2020
"20-Feb",전북,장수군,243,11831,175,12249,"2020-02-01",2020
"20-Feb",전북,전주시 덕진구,404,165730,7432,173566,"2020-02-01",2020
"20-Feb",전북,전주시 완산구,663,147179,4119,151961,"2020-02-01",2020
"20-Feb",전북,정읍시,356,53259,3569,57184,"2020-02-01",2020
"20-Feb",전북,진안군,254,13759,209,14222,"2020-02-01",2020
"20-Feb",전북,계,5194,886295,40722,932211,"2020-02-01",2020
"20-Feb",전남,강진군,222,18157,1125,19504,"2020-02-01",2020
"20-Feb",전남,고흥군,297,30949,630,31876,"2020-02-01",2020
"20-Feb",전남,곡성군,154,14335,702,15191,"2020-02-01",2020
"20-Feb",전남,광양시,248,80133,5953,86334,"2020-02-01",2020
"20-Feb",전남,구례군,135,12973,647,13755,"2020-02-01",2020
"20-Feb",전남,나주시,468,62038,3221,65727,"2020-02-01",2020
"20-Feb",전남,담양군,216,25868,1580,27664,"2020-02-01",2020
"20-Feb",전남,목포시,444,95397,5674,101515,"2020-02-01",2020
"20-Feb",전남,무안군,552,41733,1004,43289,"2020-02-01",2020
"20-Feb",전남,보성군,204,21153,39325,60682,"2020-02-01",2020
"20-Feb",전남,순천시,496,135186,5131,140813,"2020-02-01",2020
"20-Feb",전남,신안군,271,20479,19570,40320,"2020-02-01",2020
"20-Feb",전남,여수시,541,127802,7000,135343,"2020-02-01",2020
"20-Feb",전남,영광군,204,26957,724,27885,"2020-02-01",2020
"20-Feb",전남,영암군,257,32592,13224,46073,"2020-02-01",2020
"20-Feb",전남,완도군,247,24787,501,25535,"2020-02-01",2020
"20-Feb",전남,장성군,185,26081,1158,27424,"2020-02-01",2020
"20-Feb",전남,장흥군,211,19730,461,20402,"2020-02-01",2020
"20-Feb",전남,진도군,163,16263,296,16722,"2020-02-01",2020
"20-Feb",전남,함평군,194,17686,25080,42960,"2020-02-01",2020
"20-Feb",전남,해남군,342,38115,592,39049,"2020-02-01",2020
"20-Feb",전남,화순군,209,31340,2049,33598,"2020-02-01",2020
"20-Feb",전남,계,6260,919754,135647,1061661,"2020-02-01",2020
"20-Feb",경북,경산시,324,134748,4517,139589,"2020-02-01",2020
"20-Feb",경북,경주시,582,138161,4598,143341,"2020-02-01",2020
"20-Feb",경북,고령군,166,20237,509,20912,"2020-02-01",2020
"20-Feb",경북,구미시,514,209284,7228,217026,"2020-02-01",2020
"20-Feb",경북,군위군,114,14644,280,15038,"2020-02-01",2020
"20-Feb",경북,김천시,394,72089,1862,74345,"2020-02-01",2020
"20-Feb",경북,문경시,282,35679,833,36794,"2020-02-01",2020
"20-Feb",경북,봉화군,204,17520,198,17922,"2020-02-01",2020
"20-Feb",경북,상주시,388,52280,1861,54529,"2020-02-01",2020
"20-Feb",경북,성주군,204,29769,1415,31388,"2020-02-01",2020
"20-Feb",경북,안동시,727,80011,2604,83342,"2020-02-01",2020
"20-Feb",경북,영덕군,251,18617,308,19176,"2020-02-01",2020
"20-Feb",경북,영양군,142,9412,108,9662,"2020-02-01",2020
"20-Feb",경북,영주시,365,54589,1516,56470,"2020-02-01",2020
"20-Feb",경북,영천시,288,58121,2637,61046,"2020-02-01",2020
"20-Feb",경북,예천군,266,28549,472,29287,"2020-02-01",2020
"20-Feb",경북,울릉군,148,5141,494,5783,"2020-02-01",2020
"20-Feb",경북,울진군,300,25355,356,26011,"2020-02-01",2020
"20-Feb",경북,의성군,311,29982,952,31245,"2020-02-01",2020
"20-Feb",경북,청도군,210,24483,698,25391,"2020-02-01",2020
"20-Feb",경북,청송군,200,15226,207,15633,"2020-02-01",2020
"20-Feb",경북,칠곡군,348,67471,2293,70112,"2020-02-01",2020
"20-Feb",경북,포항시 남구,440,118862,8613,127915,"2020-02-01",2020
"20-Feb",경북,포항시 북구,345,135083,3913,139341,"2020-02-01",2020
"20-Feb",경북,계,7513,1395313,48472,1451298,"2020-02-01",2020
"20-Feb",경남,거제시,351,104132,2137,106620,"2020-02-01",2020
"20-Feb",경남,거창군,266,31377,805,32448,"2020-02-01",2020
"20-Feb",경남,고성군,219,26073,646,26938,"2020-02-01",2020
"20-Feb",경남,김해시,646,267614,7327,275587,"2020-02-01",2020
"20-Feb",경남,남해군,262,19215,467,19944,"2020-02-01",2020
"20-Feb",경남,밀양시,316,54393,3963,58672,"2020-02-01",2020
"20-Feb",경남,사천시,305,54982,1497,56784,"2020-02-01",2020
"20-Feb",경남,산청군,234,19548,800,20582,"2020-02-01",2020
"20-Feb",경남,양산시,407,160461,9921,170789,"2020-02-01",2020
"20-Feb",경남,의령군,195,14075,679,14949,"2020-02-01",2020
"20-Feb",경남,진주시,592,161548,6635,168775,"2020-02-01",2020
"20-Feb",경남,창녕군,241,34697,933,35871,"2020-02-01",2020
"20-Feb",경남,창원시 마산합포구,333,97427,2892,100652,"2020-02-01",2020
"20-Feb",경남,창원시 마산회원구,178,93224,4961,98363,"2020-02-01",2020
"20-Feb",경남,창원시 성산구,148,114797,6135,121080,"2020-02-01",2020
"20-Feb",경남,창원시 의창구,927,135083,19481,155491,"2020-02-01",2020
"20-Feb",경남,창원시 진해구,210,88598,1684,90492,"2020-02-01",2020
"20-Feb",경남,통영시,323,52166,1407,53896,"2020-02-01",2020
"20-Feb",경남,하동군,232,24123,449,24804,"2020-02-01",2020
"20-Feb",경남,함안군,187,39990,13841,54018,"2020-02-01",2020
"20-Feb",경남,함양군,216,18872,432,19520,"2020-02-01",2020
"20-Feb",경남,합천군,266,22757,646,23669,"2020-02-01",2020
"20-Feb",경남,계,7054,1635152,87738,1729944,"2020-02-01",2020
"20-Feb",제주,서귀포시,791,102139,2010,104940,"2020-02-01",2020
"20-Feb",제주,제주시,1620,265463,230109,497192,"2020-02-01",2020
"20-Feb",제주,계,2411,367602,232119,602132,"2020-02-01",2020
"20-Mar",서울,강남구,394,216297,18503,235194,"2020-03-01",2020
"20-Mar",서울,강동구,282,135995,8849,145126,"2020-03-01",2020
"20-Mar",서울,강북구,316,71229,4536,76081,"2020-03-01",2020
"20-Mar",서울,강서구,333,185053,18957,204343,"2020-03-01",2020
"20-Mar",서울,관악구,309,113472,5671,119452,"2020-03-01",2020
"20-Mar",서울,광진구,285,92769,5718,98772,"2020-03-01",2020
"20-Mar",서울,구로구,282,130358,13121,143761,"2020-03-01",2020
"20-Mar",서울,금천구,136,81416,5896,87448,"2020-03-01",2020
"20-Mar",서울,노원구,332,142461,9375,152168,"2020-03-01",2020
"20-Mar",서울,도봉구,267,88272,7312,95851,"2020-03-01",2020
"20-Mar",서울,동대문구,314,92320,5184,97818,"2020-03-01",2020
"20-Mar",서울,동작구,310,102034,2725,105069,"2020-03-01",2020
"20-Mar",서울,마포구,327,111003,6981,118311,"2020-03-01",2020
"20-Mar",서울,서대문구,451,81609,5977,88037,"2020-03-01",2020
"20-Mar",서울,서초구,541,167426,13046,181013,"2020-03-01",2020
"20-Mar",서울,성동구,348,93547,11635,105530,"2020-03-01",2020
"20-Mar",서울,성북구,288,113587,5307,119182,"2020-03-01",2020
"20-Mar",서울,송파구,388,227248,13338,240974,"2020-03-01",2020
"20-Mar",서울,양천구,314,140313,8731,149358,"2020-03-01",2020
"20-Mar",서울,영등포구,371,132790,9603,142764,"2020-03-01",2020
"20-Mar",서울,용산구,347,74174,1960,76481,"2020-03-01",2020
"20-Mar",서울,은평구,285,121858,7120,129263,"2020-03-01",2020
"20-Mar",서울,종로구,3797,44534,1729,50060,"2020-03-01",2020
"20-Mar",서울,중구,1168,45621,4371,51160,"2020-03-01",2020
"20-Mar",서울,중랑구,247,102343,9527,112117,"2020-03-01",2020
"20-Mar",서울,계,12432,2907729,205172,3125333,"2020-03-01",2020
"20-Mar",부산,강서구,322,73052,3613,76987,"2020-03-01",2020
"20-Mar",부산,금정구,278,80685,7437,88400,"2020-03-01",2020
"20-Mar",부산,기장군,261,73377,2396,76034,"2020-03-01",2020
"20-Mar",부산,남구,227,90772,8380,99379,"2020-03-01",2020
"20-Mar",부산,동구,190,45834,4875,50899,"2020-03-01",2020
"20-Mar",부산,동래구,175,91500,4211,95886,"2020-03-01",2020
"20-Mar",부산,부산진구,412,119012,16740,136164,"2020-03-01",2020
"20-Mar",부산,북구,238,100021,3398,103657,"2020-03-01",2020
"20-Mar",부산,사상구,287,83507,6021,89815,"2020-03-01",2020
"20-Mar",부산,사하구,258,107297,6831,114386,"2020-03-01",2020
"20-Mar",부산,서구,133,27892,1414,29439,"2020-03-01",2020
"20-Mar",부산,수영구,164,67340,28038,95542,"2020-03-01",2020
"20-Mar",부산,연제구,867,88283,9320,98470,"2020-03-01",2020
"20-Mar",부산,영도구,228,30834,2078,33140,"2020-03-01",2020
"20-Mar",부산,중구,309,26344,7274,33927,"2020-03-01",2020
"20-Mar",부산,해운대구,310,163940,12734,176984,"2020-03-01",2020
"20-Mar",부산,계,4659,1269690,124760,1399109,"2020-03-01",2020
"20-Mar",대구,남구,351,55729,1749,57829,"2020-03-01",2020
"20-Mar",대구,달서구,599,267655,14710,282964,"2020-03-01",2020
"20-Mar",대구,달성군,505,129760,4887,135152,"2020-03-01",2020
"20-Mar",대구,동구,348,150966,11028,162342,"2020-03-01",2020
"20-Mar",대구,북구,489,196599,7465,204553,"2020-03-01",2020
"20-Mar",대구,서구,236,69877,4107,74220,"2020-03-01",2020
"20-Mar",대구,수성구,587,213791,5383,219761,"2020-03-01",2020
"20-Mar",대구,중구,299,54399,2374,57072,"2020-03-01",2020
"20-Mar",대구,계,3414,1138776,51703,1193893,"2020-03-01",2020
"20-Mar",인천,강화군,336,33581,47765,81682,"2020-03-01",2020
"20-Mar",인천,계양구,289,119006,190505,309800,"2020-03-01",2020
"20-Mar",인천,남동구,835,254123,38103,293061,"2020-03-01",2020
"20-Mar",인천,동구,91,25954,4053,30098,"2020-03-01",2020
"20-Mar",인천,미추홀구,416,154743,12561,167720,"2020-03-01",2020
"20-Mar",인천,부평구,343,213774,15649,229766,"2020-03-01",2020
"20-Mar",인천,서구,427,234564,11131,246122,"2020-03-01",2020
"20-Mar",인천,연수구,399,179916,7747,188062,"2020-03-01",2020
"20-Mar",인천,옹진군,215,11633,202,12050,"2020-03-01",2020
"20-Mar",인천,중구,684,62971,17843,81498,"2020-03-01",2020
"20-Mar",인천,계,4035,1290265,345559,1639859,"2020-03-01",2020
"20-Mar",광주,광산구,504,189567,12074,202145,"2020-03-01",2020
"20-Mar",광주,남구,216,89454,2678,92348,"2020-03-01",2020
"20-Mar",광주,동구,229,39581,1174,40984,"2020-03-01",2020
"20-Mar",광주,북구,610,185960,9552,196122,"2020-03-01",2020
"20-Mar",광주,서구,633,141238,6893,148764,"2020-03-01",2020
"20-Mar",광주,계,2192,645800,32371,680363,"2020-03-01",2020
"20-Mar",대전,대덕구,236,84063,6869,91168,"2020-03-01",2020
"20-Mar",대전,동구,247,88819,4289,93355,"2020-03-01",2020
"20-Mar",대전,서구,802,203710,7266,211778,"2020-03-01",2020
"20-Mar",대전,유성구,378,173327,5105,178810,"2020-03-01",2020
"20-Mar",대전,중구,234,96484,5887,102605,"2020-03-01",2020
"20-Mar",대전,계,1897,646403,29416,677716,"2020-03-01",2020
"20-Mar",울산,남구,699,152167,7127,159993,"2020-03-01",2020
"20-Mar",울산,동구,196,61305,1028,62529,"2020-03-01",2020
"20-Mar",울산,북구,184,110487,3886,114557,"2020-03-01",2020
"20-Mar",울산,울주군,384,120627,6770,127781,"2020-03-01",2020
"20-Mar",울산,중구,342,100081,2574,102997,"2020-03-01",2020
"20-Mar",울산,계,1805,544667,21385,567857,"2020-03-01",2020
"20-Mar",세종,세종특별자치시,769,162885,2795,166449,"2020-03-01",2020
"20-Mar",세종,계,769,162885,2795,166449,"2020-03-01",2020
"20-Mar",경기,가평군,370,29843,642,30855,"2020-03-01",2020
"20-Mar",경기,고양시 덕양구,676,171568,4045,176289,"2020-03-01",2020
"20-Mar",경기,고양시 일산동구,284,120661,6095,127040,"2020-03-01",2020
"20-Mar",경기,고양시 일산서구,127,114125,4178,118430,"2020-03-01",2020
"20-Mar",경기,과천시,718,20847,614,22179,"2020-03-01",2020
"20-Mar",경기,광명시,317,102901,4179,107397,"2020-03-01",2020
"20-Mar",경기,광주시,378,183833,8250,192461,"2020-03-01",2020
"20-Mar",경기,구리시,258,69650,2635,72543,"2020-03-01",2020
"20-Mar",경기,군포시,293,96816,5099,102208,"2020-03-01",2020
"20-Mar",경기,김포시,478,203716,7397,211591,"2020-03-01",2020
"20-Mar",경기,남양주시,678,284618,8127,293423,"2020-03-01",2020
"20-Mar",경기,동두천시,207,36612,1321,38140,"2020-03-01",2020
"20-Mar",경기,부천시,698,291834,12858,305390,"2020-03-01",2020
"20-Mar",경기,성남시 분당구,356,182279,7041,189676,"2020-03-01",2020
"20-Mar",경기,성남시 수정구,358,71992,2364,74714,"2020-03-01",2020
"20-Mar",경기,성남시 중원구,340,70755,4026,75121,"2020-03-01",2020
"20-Mar",경기,수원시 권선구,464,175049,8424,183937,"2020-03-01",2020
"20-Mar",경기,수원시 영통구,220,144253,3135,147608,"2020-03-01",2020
"20-Mar",경기,수원시 장안구,483,101941,3830,106254,"2020-03-01",2020
"20-Mar",경기,수원시 팔달구,494,67399,2959,70852,"2020-03-01",2020
"20-Mar",경기,시흥시,460,227758,7560,235778,"2020-03-01",2020
"20-Mar",경기,안산시 단원구,567,150385,8014,158966,"2020-03-01",2020
"20-Mar",경기,안산시 상록구,174,135632,4755,140561,"2020-03-01",2020
"20-Mar",경기,안성시,391,98175,5028,103594,"2020-03-01",2020
"20-Mar",경기,안양시 동안구,409,115726,6215,122350,"2020-03-01",2020
"20-Mar",경기,안양시 만안구,144,82234,3916,86294,"2020-03-01",2020
"20-Mar",경기,양주시,376,101284,3134,104794,"2020-03-01",2020
"20-Mar",경기,양평군,558,57979,1752,60289,"2020-03-01",2020
"20-Mar",경기,여주시,436,60835,7570,68841,"2020-03-01",2020
"20-Mar",경기,연천군,304,23190,5334,28828,"2020-03-01",2020
"20-Mar",경기,오산시,209,102408,3322,105939,"2020-03-01",2020
"20-Mar",경기,용인시 기흥구,128,184749,6138,191015,"2020-03-01",2020
"20-Mar",경기,용인시 수지구,49,140168,2269,142486,"2020-03-01",2020
"20-Mar",경기,용인시 처인구,755,125596,7215,133566,"2020-03-01",2020
"20-Mar",경기,의왕시,286,63099,3198,66583,"2020-03-01",2020
"20-Mar",경기,의정부시,670,154470,5039,160179,"2020-03-01",2020
"20-Mar",경기,이천시,402,108831,5895,115128,"2020-03-01",2020
"20-Mar",경기,파주시,518,202662,9397,212577,"2020-03-01",2020
"20-Mar",경기,평택시,736,264472,11737,276945,"2020-03-01",2020
"20-Mar",경기,포천시,385,82907,9628,92920,"2020-03-01",2020
"20-Mar",경기,하남시,398,112592,2784,115774,"2020-03-01",2020
"20-Mar",경기,화성시,890,420771,11420,433081,"2020-03-01",2020
"20-Mar",경기,계,17442,5556615,228539,5802596,"2020-03-01",2020
"20-Mar",강원,강릉시,523,104500,4720,109743,"2020-03-01",2020
"20-Mar",강원,고성군,180,13845,233,14258,"2020-03-01",2020
"20-Mar",강원,동해시,302,43798,1378,45478,"2020-03-01",2020
"20-Mar",강원,삼척시,404,31586,742,32732,"2020-03-01",2020
"20-Mar",강원,속초시,290,36565,1343,38198,"2020-03-01",2020
"20-Mar",강원,양구군,183,11729,121,12033,"2020-03-01",2020
"20-Mar",강원,양양군,183,15271,235,15689,"2020-03-01",2020
"20-Mar",강원,영월군,330,20678,368,21376,"2020-03-01",2020
"20-Mar",강원,원주시,551,167005,5813,173369,"2020-03-01",2020
"20-Mar",강원,인제군,215,17638,291,18144,"2020-03-01",2020
"20-Mar",강원,정선군,334,20151,483,20968,"2020-03-01",2020
"20-Mar",강원,철원군,230,23573,318,24121,"2020-03-01",2020
"20-Mar",강원,춘천시,805,128515,5955,135275,"2020-03-01",2020
"20-Mar",강원,태백시,222,19953,751,20926,"2020-03-01",2020
"20-Mar",강원,평창군,286,25169,508,25963,"2020-03-01",2020
"20-Mar",강원,홍천군,417,37441,1073,38931,"2020-03-01",2020
"20-Mar",강원,화천군,230,12533,202,12965,"2020-03-01",2020
"20-Mar",강원,횡성군,244,25693,721,26658,"2020-03-01",2020
"20-Mar",강원,계,5929,755643,25255,786827,"2020-03-01",2020
"20-Mar",충북,괴산군,208,22100,392,22700,"2020-03-01",2020
"20-Mar",충북,단양군,219,15537,773,16529,"2020-03-01",2020
"20-Mar",충북,보은군,221,17643,884,18748,"2020-03-01",2020
"20-Mar",충북,영동군,233,24625,394,25252,"2020-03-01",2020
"20-Mar",충북,옥천군,198,26149,1132,27479,"2020-03-01",2020
"20-Mar",충북,음성군,223,57292,1834,59349,"2020-03-01",2020
"20-Mar",충북,제천시,328,65835,3509,69672,"2020-03-01",2020
"20-Mar",충북,증평군,92,18852,759,19703,"2020-03-01",2020
"20-Mar",충북,진천군,214,47024,1317,48555,"2020-03-01",2020
"20-Mar",충북,청원군,1,19,0,20,"2020-03-01",2020
"20-Mar",충북,청주시 상당구,507,83696,2510,86713,"2020-03-01",2020
"20-Mar",충북,청주시 서원구,246,95828,5023,101097,"2020-03-01",2020
"20-Mar",충북,청주시 청원구,348,100578,3992,104918,"2020-03-01",2020
"20-Mar",충북,청주시 흥덕구,363,124141,7351,131855,"2020-03-01",2020
"20-Mar",충북,충주시,584,106400,5405,112389,"2020-03-01",2020
"20-Mar",충북,계,3985,805719,35275,844979,"2020-03-01",2020
"20-Mar",충남,계룡시,149,21223,540,21912,"2020-03-01",2020
"20-Mar",충남,공주시,575,52860,2280,55715,"2020-03-01",2020
"20-Mar",충남,금산군,185,28089,2206,30480,"2020-03-01",2020
"20-Mar",충남,논산시,400,60149,2411,62960,"2020-03-01",2020
"20-Mar",충남,당진시,387,92559,3839,96785,"2020-03-01",2020
"20-Mar",충남,보령시,393,51429,1305,53127,"2020-03-01",2020
"20-Mar",충남,부여군,291,33846,1258,35395,"2020-03-01",2020
"20-Mar",충남,서산시,401,91994,3387,95782,"2020-03-01",2020
"20-Mar",충남,서천군,231,26781,888,27900,"2020-03-01",2020
"20-Mar",충남,아산시,509,161276,6364,168149,"2020-03-01",2020
"20-Mar",충남,예산군,397,42343,1401,44141,"2020-03-01",2020
"20-Mar",충남,천안시 동남구,247,128723,4769,133739,"2020-03-01",2020
"20-Mar",충남,천안시 서북구,543,187853,5642,194038,"2020-03-01",2020
"20-Mar",충남,청양군,260,16689,815,17764,"2020-03-01",2020
"20-Mar",충남,태안군,295,33302,513,34110,"2020-03-01",2020
"20-Mar",충남,홍성군,423,51545,1444,53412,"2020-03-01",2020
"20-Mar",충남,계,5686,1080661,39062,1125409,"2020-03-01",2020
"20-Mar",전북,고창군,276,29745,581,30602,"2020-03-01",2020
"20-Mar",전북,군산시,532,127540,6429,134501,"2020-03-01",2020
"20-Mar",전북,김제시,308,44318,2010,46636,"2020-03-01",2020
"20-Mar",전북,남원시,408,39957,5155,45520,"2020-03-01",2020
"20-Mar",전북,무주군,193,12469,385,13047,"2020-03-01",2020
"20-Mar",전북,부안군,270,26855,619,27744,"2020-03-01",2020
"20-Mar",전북,순창군,235,14407,184,14826,"2020-03-01",2020
"20-Mar",전북,완주군,363,49955,3183,53501,"2020-03-01",2020
"20-Mar",전북,익산시,519,135308,6143,141970,"2020-03-01",2020
"20-Mar",전북,임실군,208,14187,421,14816,"2020-03-01",2020
"20-Mar",전북,장수군,245,11837,172,12254,"2020-03-01",2020
"20-Mar",전북,전주시 덕진구,400,166151,7382,173933,"2020-03-01",2020
"20-Mar",전북,전주시 완산구,668,147433,4129,152230,"2020-03-01",2020
"20-Mar",전북,정읍시,358,53554,3673,57585,"2020-03-01",2020
"20-Mar",전북,진안군,258,13768,209,14235,"2020-03-01",2020
"20-Mar",전북,계,5241,887484,40675,933400,"2020-03-01",2020
"20-Mar",전남,강진군,227,18242,1128,19597,"2020-03-01",2020
"20-Mar",전남,고흥군,296,30943,632,31871,"2020-03-01",2020
"20-Mar",전남,곡성군,156,14374,699,15229,"2020-03-01",2020
"20-Mar",전남,광양시,250,80045,5958,86253,"2020-03-01",2020
"20-Mar",전남,구례군,135,12922,651,13708,"2020-03-01",2020
"20-Mar",전남,나주시,467,62057,3244,65768,"2020-03-01",2020
"20-Mar",전남,담양군,219,25794,1574,27587,"2020-03-01",2020
"20-Mar",전남,목포시,452,95561,5651,101664,"2020-03-01",2020
"20-Mar",전남,무안군,553,41947,1004,43504,"2020-03-01",2020
"20-Mar",전남,보성군,205,21147,37488,58840,"2020-03-01",2020
"20-Mar",전남,순천시,495,135913,5132,141540,"2020-03-01",2020
"20-Mar",전남,신안군,270,20479,21587,42336,"2020-03-01",2020
"20-Mar",전남,여수시,538,128143,6996,135677,"2020-03-01",2020
"20-Mar",전남,영광군,204,26995,724,27923,"2020-03-01",2020
"20-Mar",전남,영암군,255,32631,12903,45789,"2020-03-01",2020
"20-Mar",전남,완도군,244,24707,516,25467,"2020-03-01",2020
"20-Mar",전남,장성군,183,26139,1156,27478,"2020-03-01",2020
"20-Mar",전남,장흥군,208,19761,456,20425,"2020-03-01",2020
"20-Mar",전남,진도군,163,16263,295,16721,"2020-03-01",2020
"20-Mar",전남,함평군,194,17719,25043,42956,"2020-03-01",2020
"20-Mar",전남,해남군,346,38154,592,39092,"2020-03-01",2020
"20-Mar",전남,화순군,223,31462,2046,33731,"2020-03-01",2020
"20-Mar",전남,계,6283,921398,135475,1063156,"2020-03-01",2020
"20-Mar",경북,경산시,323,134972,4478,139773,"2020-03-01",2020
"20-Mar",경북,경주시,581,138010,4622,143213,"2020-03-01",2020
"20-Mar",경북,고령군,165,20178,512,20855,"2020-03-01",2020
"20-Mar",경북,구미시,510,209487,7228,217225,"2020-03-01",2020
"20-Mar",경북,군위군,126,14533,282,14941,"2020-03-01",2020
"20-Mar",경북,김천시,389,72110,1869,74368,"2020-03-01",2020
"20-Mar",경북,문경시,282,35577,837,36696,"2020-03-01",2020
"20-Mar",경북,봉화군,201,17523,195,17919,"2020-03-01",2020
"20-Mar",경북,상주시,391,52266,1860,54517,"2020-03-01",2020
"20-Mar",경북,성주군,203,29697,1416,31316,"2020-03-01",2020
"20-Mar",경북,안동시,721,80119,2587,83427,"2020-03-01",2020
"20-Mar",경북,영덕군,255,18559,299,19113,"2020-03-01",2020
"20-Mar",경북,영양군,142,9429,111,9682,"2020-03-01",2020
"20-Mar",경북,영주시,366,54547,1522,56435,"2020-03-01",2020
"20-Mar",경북,영천시,294,58041,2672,61007,"2020-03-01",2020
"20-Mar",경북,예천군,261,28584,481,29326,"2020-03-01",2020
"20-Mar",경북,울릉군,148,5058,500,5706,"2020-03-01",2020
"20-Mar",경북,울진군,303,25406,353,26062,"2020-03-01",2020
"20-Mar",경북,의성군,309,29832,948,31089,"2020-03-01",2020
"20-Mar",경북,청도군,212,24437,698,25347,"2020-03-01",2020
"20-Mar",경북,청송군,203,15170,206,15579,"2020-03-01",2020
"20-Mar",경북,칠곡군,331,67386,2283,70000,"2020-03-01",2020
"20-Mar",경북,포항시 남구,438,118544,8567,127549,"2020-03-01",2020
"20-Mar",경북,포항시 북구,339,135326,3909,139574,"2020-03-01",2020
"20-Mar",경북,계,7493,1394791,48435,1450719,"2020-03-01",2020
"20-Mar",경남,거제시,356,104099,2110,106565,"2020-03-01",2020
"20-Mar",경남,거창군,271,31275,804,32350,"2020-03-01",2020
"20-Mar",경남,고성군,219,26084,635,26938,"2020-03-01",2020
"20-Mar",경남,김해시,638,267840,7285,275763,"2020-03-01",2020
"20-Mar",경남,남해군,263,19216,467,19946,"2020-03-01",2020
"20-Mar",경남,밀양시,318,54412,3962,58692,"2020-03-01",2020
"20-Mar",경남,사천시,311,54965,1493,56769,"2020-03-01",2020
"20-Mar",경남,산청군,232,19549,795,20576,"2020-03-01",2020
"20-Mar",경남,양산시,408,160912,9910,171230,"2020-03-01",2020
"20-Mar",경남,의령군,197,14065,675,14937,"2020-03-01",2020
"20-Mar",경남,진주시,591,161814,6619,169024,"2020-03-01",2020
"20-Mar",경남,창녕군,238,34614,937,35789,"2020-03-01",2020
"20-Mar",경남,창원시 마산합포구,334,96913,2884,100131,"2020-03-01",2020
"20-Mar",경남,창원시 마산회원구,176,93198,4933,98307,"2020-03-01",2020
"20-Mar",경남,창원시 성산구,149,114968,5959,121076,"2020-03-01",2020
"20-Mar",경남,창원시 의창구,931,135812,20474,157217,"2020-03-01",2020
"20-Mar",경남,창원시 진해구,210,88559,1684,90453,"2020-03-01",2020
"20-Mar",경남,통영시,325,52060,1403,53788,"2020-03-01",2020
"20-Mar",경남,하동군,230,24012,442,24684,"2020-03-01",2020
"20-Mar",경남,함안군,190,39887,14585,54662,"2020-03-01",2020
"20-Mar",경남,함양군,222,18875,431,19528,"2020-03-01",2020
"20-Mar",경남,합천군,266,22740,644,23650,"2020-03-01",2020
"20-Mar",경남,계,7075,1635869,89131,1732075,"2020-03-01",2020
"20-Mar",제주,서귀포시,793,102180,1975,104948,"2020-03-01",2020
"20-Mar",제주,제주시,1622,268877,231896,502395,"2020-03-01",2020
"20-Mar",제주,계,2415,371057,233871,607343,"2020-03-01",2020
"20-Apr",서울,강남구,402,215928,18579,234909,"2020-04-01",2020
"20-Apr",서울,강동구,284,137127,8854,146265,"2020-04-01",2020
"20-Apr",서울,강북구,317,71242,4538,76097,"2020-04-01",2020
"20-Apr",서울,강서구,340,185673,19019,205032,"2020-04-01",2020
"20-Apr",서울,관악구,316,113439,5650,119405,"2020-04-01",2020
"20-Apr",서울,광진구,288,92777,5700,98765,"2020-04-01",2020
"20-Apr",서울,구로구,283,130415,12963,143661,"2020-04-01",2020
"20-Apr",서울,금천구,137,81521,5862,87520,"2020-04-01",2020
"20-Apr",서울,노원구,334,142515,9371,152220,"2020-04-01",2020
"20-Apr",서울,도봉구,269,88266,7287,95822,"2020-04-01",2020
"20-Apr",서울,동대문구,308,92352,5180,97840,"2020-04-01",2020
"20-Apr",서울,동작구,313,102117,2727,105157,"2020-04-01",2020
"20-Apr",서울,마포구,330,111167,6954,118451,"2020-04-01",2020
"20-Apr",서울,서대문구,453,81777,5946,88176,"2020-04-01",2020
"20-Apr",서울,서초구,540,167449,13133,181122,"2020-04-01",2020
"20-Apr",서울,성동구,350,93681,11199,105230,"2020-04-01",2020
"20-Apr",서울,성북구,288,113638,5399,119325,"2020-04-01",2020
"20-Apr",서울,송파구,385,227405,13213,241003,"2020-04-01",2020
"20-Apr",서울,양천구,314,141093,8734,150141,"2020-04-01",2020
"20-Apr",서울,영등포구,374,133087,9490,142951,"2020-04-01",2020
"20-Apr",서울,용산구,349,74431,1853,76633,"2020-04-01",2020
"20-Apr",서울,은평구,286,122113,7129,129528,"2020-04-01",2020
"20-Apr",서울,종로구,3816,44559,1704,50079,"2020-04-01",2020
"20-Apr",서울,중구,1163,45582,4358,51103,"2020-04-01",2020
"20-Apr",서울,중랑구,248,102337,9503,112088,"2020-04-01",2020
"20-Apr",서울,계,12487,2911691,204345,3128523,"2020-04-01",2020
"20-Apr",부산,강서구,324,73311,3600,77235,"2020-04-01",2020
"20-Apr",부산,금정구,279,80716,7746,88741,"2020-04-01",2020
"20-Apr",부산,기장군,261,73818,2400,76479,"2020-04-01",2020
"20-Apr",부산,남구,227,90875,8364,99466,"2020-04-01",2020
"20-Apr",부산,동구,187,45989,4879,51055,"2020-04-01",2020
"20-Apr",부산,동래구,176,91717,3875,95768,"2020-04-01",2020
"20-Apr",부산,부산진구,410,119159,17471,137040,"2020-04-01",2020
"20-Apr",부산,북구,239,99989,3399,103627,"2020-04-01",2020
"20-Apr",부산,사상구,286,83722,6012,90020,"2020-04-01",2020
"20-Apr",부산,사하구,259,107377,6838,114474,"2020-04-01",2020
"20-Apr",부산,서구,134,27999,1417,29550,"2020-04-01",2020
"20-Apr",부산,수영구,165,67323,28658,96146,"2020-04-01",2020
"20-Apr",부산,연제구,874,88489,9409,98772,"2020-04-01",2020
"20-Apr",부산,영도구,228,30823,2080,33131,"2020-04-01",2020
"20-Apr",부산,중구,312,26330,7295,33937,"2020-04-01",2020
"20-Apr",부산,해운대구,317,164206,12705,177228,"2020-04-01",2020
"20-Apr",부산,계,4678,1271843,126148,1402669,"2020-04-01",2020
"20-Apr",대구,남구,352,55737,1755,57844,"2020-04-01",2020
"20-Apr",대구,달서구,601,268607,14530,283738,"2020-04-01",2020
"20-Apr",대구,달성군,506,130133,4965,135604,"2020-04-01",2020
"20-Apr",대구,동구,352,151409,11043,162804,"2020-04-01",2020
"20-Apr",대구,북구,495,197068,7450,205013,"2020-04-01",2020
"20-Apr",대구,서구,243,69847,4052,74142,"2020-04-01",2020
"20-Apr",대구,수성구,589,213844,5345,219778,"2020-04-01",2020
"20-Apr",대구,중구,302,55243,2356,57901,"2020-04-01",2020
"20-Apr",대구,계,3440,1141888,51496,1196824,"2020-04-01",2020
"20-Apr",인천,강화군,341,33732,46634,80707,"2020-04-01",2020
"20-Apr",인천,계양구,287,118982,191443,310712,"2020-04-01",2020
"20-Apr",인천,남동구,839,254135,52514,307488,"2020-04-01",2020
"20-Apr",인천,동구,90,25772,4122,29984,"2020-04-01",2020
"20-Apr",인천,미추홀구,422,155601,12102,168125,"2020-04-01",2020
"20-Apr",인천,부평구,337,213887,16201,230425,"2020-04-01",2020
"20-Apr",인천,서구,428,235866,11129,247423,"2020-04-01",2020
"20-Apr",인천,연수구,400,180716,7827,188943,"2020-04-01",2020
"20-Apr",인천,옹진군,215,11638,202,12055,"2020-04-01",2020
"20-Apr",인천,중구,693,63273,17637,81603,"2020-04-01",2020
"20-Apr",인천,계,4052,1293602,359811,1657465,"2020-04-01",2020
"20-Apr",광주,광산구,503,190416,12112,203031,"2020-04-01",2020
"20-Apr",광주,남구,214,89452,2679,92345,"2020-04-01",2020
"20-Apr",광주,동구,234,39593,1173,41000,"2020-04-01",2020
"20-Apr",광주,북구,618,186334,9455,196407,"2020-04-01",2020
"20-Apr",광주,서구,632,141811,6901,149344,"2020-04-01",2020
"20-Apr",광주,계,2201,647606,32320,682127,"2020-04-01",2020
"20-Apr",대전,대덕구,241,84107,6713,91061,"2020-04-01",2020
"20-Apr",대전,동구,251,88697,4446,93394,"2020-04-01",2020
"20-Apr",대전,서구,809,204002,7329,212140,"2020-04-01",2020
"20-Apr",대전,유성구,379,174337,5059,179775,"2020-04-01",2020
"20-Apr",대전,중구,237,96363,5867,102467,"2020-04-01",2020
"20-Apr",대전,계,1917,647506,29414,678837,"2020-04-01",2020
"20-Apr",울산,남구,698,152263,7119,160080,"2020-04-01",2020
"20-Apr",울산,동구,194,61256,1042,62492,"2020-04-01",2020
"20-Apr",울산,북구,184,110889,3889,114962,"2020-04-01",2020
"20-Apr",울산,울주군,388,120935,6753,128076,"2020-04-01",2020
"20-Apr",울산,중구,340,99935,2558,102833,"2020-04-01",2020
"20-Apr",울산,계,1804,545278,21361,568443,"2020-04-01",2020
"20-Apr",세종,세종특별자치시,769,163479,2709,166957,"2020-04-01",2020
"20-Apr",세종,계,769,163479,2709,166957,"2020-04-01",2020
"20-Apr",경기,가평군,371,29925,612,30908,"2020-04-01",2020
"20-Apr",경기,고양시 덕양구,673,172354,4029,177056,"2020-04-01",2020
"20-Apr",경기,고양시 일산동구,289,121166,5985,127440,"2020-04-01",2020
"20-Apr",경기,고양시 일산서구,128,114429,4186,118743,"2020-04-01",2020
"20-Apr",경기,과천시,696,21420,613,22729,"2020-04-01",2020
"20-Apr",경기,광명시,311,103170,4182,107663,"2020-04-01",2020
"20-Apr",경기,광주시,379,184386,8265,193030,"2020-04-01",2020
"20-Apr",경기,구리시,262,69763,2632,72657,"2020-04-01",2020
"20-Apr",경기,군포시,296,97020,5098,102414,"2020-04-01",2020
"20-Apr",경기,김포시,495,205313,7411,213219,"2020-04-01",2020
"20-Apr",경기,남양주시,688,285434,8143,294265,"2020-04-01",2020
"20-Apr",경기,동두천시,213,36615,1312,38140,"2020-04-01",2020
"20-Apr",경기,부천시,695,292652,12834,306181,"2020-04-01",2020
"20-Apr",경기,성남시 분당구,358,182515,7022,189895,"2020-04-01",2020
"20-Apr",경기,성남시 수정구,358,72192,2358,74908,"2020-04-01",2020
"20-Apr",경기,성남시 중원구,337,70858,4035,75230,"2020-04-01",2020
"20-Apr",경기,수원시 권선구,474,179417,8453,188344,"2020-04-01",2020
"20-Apr",경기,수원시 영통구,220,144599,3109,147928,"2020-04-01",2020
"20-Apr",경기,수원시 장안구,482,102171,3803,106456,"2020-04-01",2020
"20-Apr",경기,수원시 팔달구,498,67447,2935,70880,"2020-04-01",2020
"20-Apr",경기,시흥시,460,228895,7533,236888,"2020-04-01",2020
"20-Apr",경기,안산시 단원구,569,150945,7934,159448,"2020-04-01",2020
"20-Apr",경기,안산시 상록구,175,136608,4773,141556,"2020-04-01",2020
"20-Apr",경기,안성시,392,98707,5021,104120,"2020-04-01",2020
"20-Apr",경기,안양시 동안구,411,115686,6205,122302,"2020-04-01",2020
"20-Apr",경기,안양시 만안구,144,82481,3905,86530,"2020-04-01",2020
"20-Apr",경기,양주시,383,101959,3156,105498,"2020-04-01",2020
"20-Apr",경기,양평군,565,58170,1762,60497,"2020-04-01",2020
"20-Apr",경기,여주시,439,61019,7535,68993,"2020-04-01",2020
"20-Apr",경기,연천군,301,23256,5346,28903,"2020-04-01",2020
"20-Apr",경기,오산시,213,102340,3325,105878,"2020-04-01",2020
"20-Apr",경기,용인시 기흥구,127,184880,6127,191134,"2020-04-01",2020
"20-Apr",경기,용인시 수지구,49,141089,2258,143396,"2020-04-01",2020
"20-Apr",경기,용인시 처인구,760,126054,7231,134045,"2020-04-01",2020
"20-Apr",경기,의왕시,283,63287,3202,66772,"2020-04-01",2020
"20-Apr",경기,의정부시,681,155158,5026,160865,"2020-04-01",2020
"20-Apr",경기,이천시,412,109335,5885,115632,"2020-04-01",2020
"20-Apr",경기,파주시,521,203443,10303,214267,"2020-04-01",2020
"20-Apr",경기,평택시,741,265801,11725,278267,"2020-04-01",2020
"20-Apr",경기,포천시,388,83431,10332,94151,"2020-04-01",2020
"20-Apr",경기,하남시,405,113761,2769,116935,"2020-04-01",2020
"20-Apr",경기,화성시,896,424211,11420,436527,"2020-04-01",2020
"20-Apr",경기,계,17538,5583362,229790,5830690,"2020-04-01",2020
"20-Apr",강원,강릉시,527,104943,4702,110172,"2020-04-01",2020
"20-Apr",강원,고성군,187,13858,230,14275,"2020-04-01",2020
"20-Apr",강원,동해시,307,43909,1389,45605,"2020-04-01",2020
"20-Apr",강원,삼척시,404,31583,744,32731,"2020-04-01",2020
"20-Apr",강원,속초시,298,36771,1345,38414,"2020-04-01",2020
"20-Apr",강원,양구군,184,11768,121,12073,"2020-04-01",2020
"20-Apr",강원,양양군,186,15296,236,15718,"2020-04-01",2020
"20-Apr",강원,영월군,329,20645,371,21345,"2020-04-01",2020
"20-Apr",강원,원주시,554,167678,5780,174012,"2020-04-01",2020
"20-Apr",강원,인제군,218,17723,285,18226,"2020-04-01",2020
"20-Apr",강원,정선군,330,20187,478,20995,"2020-04-01",2020
"20-Apr",강원,철원군,231,23581,315,24127,"2020-04-01",2020
"20-Apr",강원,춘천시,813,128746,5961,135520,"2020-04-01",2020
"20-Apr",강원,태백시,222,19960,747,20929,"2020-04-01",2020
"20-Apr",강원,평창군,288,25234,505,26027,"2020-04-01",2020
"20-Apr",강원,홍천군,417,37558,1059,39034,"2020-04-01",2020
"20-Apr",강원,화천군,232,12583,202,13017,"2020-04-01",2020
"20-Apr",강원,횡성군,247,25715,701,26663,"2020-04-01",2020
"20-Apr",강원,계,5974,757738,25171,788883,"2020-04-01",2020
"20-Apr",충북,괴산군,208,22084,391,22683,"2020-04-01",2020
"20-Apr",충북,단양군,221,15569,771,16561,"2020-04-01",2020
"20-Apr",충북,보은군,225,17658,882,18765,"2020-04-01",2020
"20-Apr",충북,영동군,233,24630,392,25255,"2020-04-01",2020
"20-Apr",충북,옥천군,200,26261,1132,27593,"2020-04-01",2020
"20-Apr",충북,음성군,222,57349,1834,59405,"2020-04-01",2020
"20-Apr",충북,제천시,329,65969,3500,69798,"2020-04-01",2020
"20-Apr",충북,증평군,92,18899,756,19747,"2020-04-01",2020
"20-Apr",충북,진천군,214,47206,1319,48739,"2020-04-01",2020
"20-Apr",충북,청원군,1,19,0,20,"2020-04-01",2020
"20-Apr",충북,청주시 상당구,510,84204,2514,87228,"2020-04-01",2020
"20-Apr",충북,청주시 서원구,241,95627,5004,100872,"2020-04-01",2020
"20-Apr",충북,청주시 청원구,351,100652,4011,105014,"2020-04-01",2020
"20-Apr",충북,청주시 흥덕구,364,124726,7338,132428,"2020-04-01",2020
"20-Apr",충북,충주시,589,106572,5491,112652,"2020-04-01",2020
"20-Apr",충북,계,4000,807425,35335,846760,"2020-04-01",2020
"20-Apr",충남,계룡시,152,21303,541,21996,"2020-04-01",2020
"20-Apr",충남,공주시,572,52946,2318,55836,"2020-04-01",2020
"20-Apr",충남,금산군,187,28213,2210,30610,"2020-04-01",2020
"20-Apr",충남,논산시,399,60133,2378,62910,"2020-04-01",2020
"20-Apr",충남,당진시,389,92529,3839,96757,"2020-04-01",2020
"20-Apr",충남,보령시,394,51331,1307,53032,"2020-04-01",2020
"20-Apr",충남,부여군,288,33839,1247,35374,"2020-04-01",2020
"20-Apr",충남,서산시,401,91937,3384,95722,"2020-04-01",2020
"20-Apr",충남,서천군,232,26806,888,27926,"2020-04-01",2020
"20-Apr",충남,아산시,506,161166,6353,168025,"2020-04-01",2020
"20-Apr",충남,예산군,400,42485,1407,44292,"2020-04-01",2020
"20-Apr",충남,천안시 동남구,248,128776,4814,133838,"2020-04-01",2020
"20-Apr",충남,천안시 서북구,544,188336,5601,194481,"2020-04-01",2020
"20-Apr",충남,청양군,259,16745,820,17824,"2020-04-01",2020
"20-Apr",충남,태안군,294,33352,517,34163,"2020-04-01",2020
"20-Apr",충남,홍성군,417,51646,1450,53513,"2020-04-01",2020
"20-Apr",충남,계,5682,1081543,39074,1126299,"2020-04-01",2020
"20-Apr",전북,고창군,282,29760,562,30604,"2020-04-01",2020
"20-Apr",전북,군산시,525,127521,6442,134488,"2020-04-01",2020
"20-Apr",전북,김제시,295,44320,1995,46610,"2020-04-01",2020
"20-Apr",전북,남원시,406,40058,5040,45504,"2020-04-01",2020
"20-Apr",전북,무주군,193,12512,388,13093,"2020-04-01",2020
"20-Apr",전북,부안군,269,26879,620,27768,"2020-04-01",2020
"20-Apr",전북,순창군,234,14433,178,14845,"2020-04-01",2020
"20-Apr",전북,완주군,386,50069,3178,53633,"2020-04-01",2020
"20-Apr",전북,익산시,510,135021,6116,141647,"2020-04-01",2020
"20-Apr",전북,임실군,210,14145,419,14774,"2020-04-01",2020
"20-Apr",전북,장수군,244,11858,172,12274,"2020-04-01",2020
"20-Apr",전북,전주시 덕진구,381,166994,7383,174758,"2020-04-01",2020
"20-Apr",전북,전주시 완산구,667,147085,4137,151889,"2020-04-01",2020
"20-Apr",전북,정읍시,355,53419,3682,57456,"2020-04-01",2020
"20-Apr",전북,진안군,247,13769,214,14230,"2020-04-01",2020
"20-Apr",전북,계,5204,887843,40526,933573,"2020-04-01",2020
"20-Apr",전남,강진군,232,18240,1129,19601,"2020-04-01",2020
"20-Apr",전남,고흥군,299,31021,630,31950,"2020-04-01",2020
"20-Apr",전남,곡성군,156,14387,691,15234,"2020-04-01",2020
"20-Apr",전남,광양시,249,80597,5951,86797,"2020-04-01",2020
"20-Apr",전남,구례군,138,12907,678,13723,"2020-04-01",2020
"20-Apr",전남,나주시,468,62210,3199,65877,"2020-04-01",2020
"20-Apr",전남,담양군,216,25846,1621,27683,"2020-04-01",2020
"20-Apr",전남,목포시,456,95789,5645,101890,"2020-04-01",2020
"20-Apr",전남,무안군,562,42136,1000,43698,"2020-04-01",2020
"20-Apr",전남,보성군,205,21187,35770,57162,"2020-04-01",2020
"20-Apr",전남,순천시,495,135987,5123,141605,"2020-04-01",2020
"20-Apr",전남,신안군,271,20491,23097,43859,"2020-04-01",2020
"20-Apr",전남,여수시,544,128486,6992,136022,"2020-04-01",2020
"20-Apr",전남,영광군,203,27074,727,28004,"2020-04-01",2020
"20-Apr",전남,영암군,251,32842,12435,45528,"2020-04-01",2020
"20-Apr",전남,완도군,245,24773,523,25541,"2020-04-01",2020
"20-Apr",전남,장성군,186,26217,1134,27537,"2020-04-01",2020
"20-Apr",전남,장흥군,206,19804,456,20466,"2020-04-01",2020
"20-Apr",전남,진도군,164,16275,293,16732,"2020-04-01",2020
"20-Apr",전남,함평군,198,17720,24872,42790,"2020-04-01",2020
"20-Apr",전남,해남군,349,38264,605,39218,"2020-04-01",2020
"20-Apr",전남,화순군,219,31605,2047,33871,"2020-04-01",2020
"20-Apr",전남,계,6312,923858,134618,1064788,"2020-04-01",2020
"20-Apr",경북,경산시,325,135068,4477,139870,"2020-04-01",2020
"20-Apr",경북,경주시,587,138181,4614,143382,"2020-04-01",2020
"20-Apr",경북,고령군,164,20196,514,20874,"2020-04-01",2020
"20-Apr",경북,구미시,510,210380,7189,218079,"2020-04-01",2020
"20-Apr",경북,군위군,127,14527,283,14937,"2020-04-01",2020
"20-Apr",경북,김천시,385,71986,1869,74240,"2020-04-01",2020
"20-Apr",경북,문경시,283,35618,841,36742,"2020-04-01",2020
"20-Apr",경북,봉화군,202,17525,193,17920,"2020-04-01",2020
"20-Apr",경북,상주시,383,52238,1851,54472,"2020-04-01",2020
"20-Apr",경북,성주군,201,29755,1422,31378,"2020-04-01",2020
"20-Apr",경북,안동시,727,80215,2589,83531,"2020-04-01",2020
"20-Apr",경북,영덕군,263,18550,295,19108,"2020-04-01",2020
"20-Apr",경북,영양군,145,9424,111,9680,"2020-04-01",2020
"20-Apr",경북,영주시,369,54607,1519,56495,"2020-04-01",2020
"20-Apr",경북,영천시,315,58254,2671,61240,"2020-04-01",2020
"20-Apr",경북,예천군,267,28788,480,29535,"2020-04-01",2020
"20-Apr",경북,울릉군,150,5019,497,5666,"2020-04-01",2020
"20-Apr",경북,울진군,305,25430,349,26084,"2020-04-01",2020
"20-Apr",경북,의성군,310,29890,952,31152,"2020-04-01",2020
"20-Apr",경북,청도군,215,24449,707,25371,"2020-04-01",2020
"20-Apr",경북,청송군,205,15209,206,15620,"2020-04-01",2020
"20-Apr",경북,칠곡군,319,67427,2281,70027,"2020-04-01",2020
"20-Apr",경북,포항시 남구,437,118596,8525,127558,"2020-04-01",2020
"20-Apr",경북,포항시 북구,342,135729,3877,139948,"2020-04-01",2020
"20-Apr",경북,계,7536,1397061,48312,1452909,"2020-04-01",2020
"20-Apr",경남,거제시,359,104327,2103,106789,"2020-04-01",2020
"20-Apr",경남,거창군,266,31357,804,32427,"2020-04-01",2020
"20-Apr",경남,고성군,224,26125,629,26978,"2020-04-01",2020
"20-Apr",경남,김해시,641,268673,7287,276601,"2020-04-01",2020
"20-Apr",경남,남해군,263,19215,466,19944,"2020-04-01",2020
"20-Apr",경남,밀양시,325,54552,3955,58832,"2020-04-01",2020
"20-Apr",경남,사천시,312,55048,1493,56853,"2020-04-01",2020
"20-Apr",경남,산청군,238,19593,791,20622,"2020-04-01",2020
"20-Apr",경남,양산시,413,161129,9953,171495,"2020-04-01",2020
"20-Apr",경남,의령군,200,14052,675,14927,"2020-04-01",2020
"20-Apr",경남,진주시,595,162240,6631,169466,"2020-04-01",2020
"20-Apr",경남,창녕군,240,34675,921,35836,"2020-04-01",2020
"20-Apr",경남,창원시 마산합포구,334,96597,2873,99804,"2020-04-01",2020
"20-Apr",경남,창원시 마산회원구,176,93368,4909,98453,"2020-04-01",2020
"20-Apr",경남,창원시 성산구,147,115077,5791,121015,"2020-04-01",2020
"20-Apr",경남,창원시 의창구,933,136649,21297,158879,"2020-04-01",2020
"20-Apr",경남,창원시 진해구,210,88823,1674,90707,"2020-04-01",2020
"20-Apr",경남,통영시,328,52069,1398,53795,"2020-04-01",2020
"20-Apr",경남,하동군,228,24039,412,24679,"2020-04-01",2020
"20-Apr",경남,함안군,189,39936,15233,55358,"2020-04-01",2020
"20-Apr",경남,함양군,219,18978,429,19626,"2020-04-01",2020
"20-Apr",경남,합천군,267,22787,637,23691,"2020-04-01",2020
"20-Apr",경남,계,7107,1639309,90361,1736777,"2020-04-01",2020
"20-Apr",제주,서귀포시,800,101979,1930,104709,"2020-04-01",2020
"20-Apr",제주,제주시,1628,269598,220634,491860,"2020-04-01",2020
"20-Apr",제주,계,2428,371577,222564,596569,"2020-04-01",2020
"20-May",서울,강남구,399,215684,18603,234686,"2020-05-01",2020
"20-May",서울,강동구,286,137867,8907,147060,"2020-05-01",2020
"20-May",서울,강북구,319,71260,4517,76096,"2020-05-01",2020
"20-May",서울,강서구,340,185793,18981,205114,"2020-05-01",2020
"20-May",서울,관악구,320,113590,5657,119567,"2020-05-01",2020
"20-May",서울,광진구,291,92880,5726,98897,"2020-05-01",2020
"20-May",서울,구로구,290,130755,12806,143851,"2020-05-01",2020
"20-May",서울,금천구,138,81714,5878,87730,"2020-05-01",2020
"20-May",서울,노원구,338,142623,9382,152343,"2020-05-01",2020
"20-May",서울,도봉구,269,88432,7264,95965,"2020-05-01",2020
"20-May",서울,동대문구,309,92567,5185,98061,"2020-05-01",2020
"20-May",서울,동작구,316,102395,2729,105440,"2020-05-01",2020
"20-May",서울,마포구,333,111355,7019,118707,"2020-05-01",2020
"20-May",서울,서대문구,454,81929,5972,88355,"2020-05-01",2020
"20-May",서울,서초구,547,167498,13069,181114,"2020-05-01",2020
"20-May",서울,성동구,350,93790,11059,105199,"2020-05-01",2020
"20-May",서울,성북구,289,113875,5428,119592,"2020-05-01",2020
"20-May",서울,송파구,385,227957,13167,241509,"2020-05-01",2020
"20-May",서울,양천구,317,141872,8709,150898,"2020-05-01",2020
"20-May",서울,영등포구,374,133411,9483,143268,"2020-05-01",2020
"20-May",서울,용산구,351,74482,1845,76678,"2020-05-01",2020
"20-May",서울,은평구,288,122485,7112,129885,"2020-05-01",2020
"20-May",서울,종로구,3750,44578,1705,50033,"2020-05-01",2020
"20-May",서울,중구,1162,45632,4349,51143,"2020-05-01",2020
"20-May",서울,중랑구,248,102462,9452,112162,"2020-05-01",2020
"20-May",서울,계,12463,2916886,204004,3133353,"2020-05-01",2020
"20-May",부산,강서구,323,73653,3554,77530,"2020-05-01",2020
"20-May",부산,금정구,280,80725,7717,88722,"2020-05-01",2020
"20-May",부산,기장군,262,74445,2465,77172,"2020-05-01",2020
"20-May",부산,남구,228,91019,8323,99570,"2020-05-01",2020
"20-May",부산,동구,186,46086,4897,51169,"2020-05-01",2020
"20-May",부산,동래구,175,91845,3925,95945,"2020-05-01",2020
"20-May",부산,부산진구,370,119575,17799,137744,"2020-05-01",2020
"20-May",부산,북구,250,100232,3409,103891,"2020-05-01",2020
"20-May",부산,사상구,285,83810,5995,90090,"2020-05-01",2020
"20-May",부산,사하구,260,107560,6813,114633,"2020-05-01",2020
"20-May",부산,서구,135,28144,1418,29697,"2020-05-01",2020
"20-May",부산,수영구,163,67305,29128,96596,"2020-05-01",2020
"20-May",부산,연제구,909,88684,9397,98990,"2020-05-01",2020
"20-May",부산,영도구,234,30799,2071,33104,"2020-05-01",2020
"20-May",부산,중구,313,26538,7216,34067,"2020-05-01",2020
"20-May",부산,해운대구,319,164449,12717,177485,"2020-05-01",2020
"20-May",부산,계,4692,1274869,126844,1406405,"2020-05-01",2020
"20-May",대구,남구,344,55664,1763,57771,"2020-05-01",2020
"20-May",대구,달서구,557,268596,14524,283677,"2020-05-01",2020
"20-May",대구,달성군,514,130268,4971,135753,"2020-05-01",2020
"20-May",대구,동구,354,150979,11046,162379,"2020-05-01",2020
"20-May",대구,북구,518,197442,7456,205416,"2020-05-01",2020
"20-May",대구,서구,244,69457,4086,73787,"2020-05-01",2020
"20-May",대구,수성구,591,213778,5335,219704,"2020-05-01",2020
"20-May",대구,중구,305,56033,2393,58731,"2020-05-01",2020
"20-May",대구,계,3427,1142217,51574,1197218,"2020-05-01",2020
"20-May",인천,강화군,339,33876,45517,79732,"2020-05-01",2020
"20-May",인천,계양구,288,119126,192455,311869,"2020-05-01",2020
"20-May",인천,남동구,827,254873,52350,308050,"2020-05-01",2020
"20-May",인천,동구,91,25807,4144,30042,"2020-05-01",2020
"20-May",인천,미추홀구,418,156162,11762,168342,"2020-05-01",2020
"20-May",인천,부평구,343,214151,16697,231191,"2020-05-01",2020
"20-May",인천,서구,430,236148,11095,247673,"2020-05-01",2020
"20-May",인천,연수구,398,181612,7850,189860,"2020-05-01",2020
"20-May",인천,옹진군,210,11694,200,12104,"2020-05-01",2020
"20-May",인천,중구,708,63679,17535,81922,"2020-05-01",2020
"20-May",인천,계,4052,1297128,359605,1660785,"2020-05-01",2020
"20-May",광주,광산구,505,191042,12209,203756,"2020-05-01",2020
"20-May",광주,남구,210,89387,2652,92249,"2020-05-01",2020
"20-May",광주,동구,236,39918,1190,41344,"2020-05-01",2020
"20-May",광주,북구,620,186481,9387,196488,"2020-05-01",2020
"20-May",광주,서구,637,141975,6790,149402,"2020-05-01",2020
"20-May",광주,계,2208,648803,32228,683239,"2020-05-01",2020
"20-May",대전,대덕구,240,84230,6744,91214,"2020-05-01",2020
"20-May",대전,동구,252,88556,4440,93248,"2020-05-01",2020
"20-May",대전,서구,804,204383,7329,212516,"2020-05-01",2020
"20-May",대전,유성구,379,175043,4985,180407,"2020-05-01",2020
"20-May",대전,중구,236,96365,5881,102482,"2020-05-01",2020
"20-May",대전,계,1911,648577,29379,679867,"2020-05-01",2020
"20-May",울산,남구,708,152569,7127,160404,"2020-05-01",2020
"20-May",울산,동구,189,61301,1038,62528,"2020-05-01",2020
"20-May",울산,북구,184,111184,3875,115243,"2020-05-01",2020
"20-May",울산,울주군,388,121058,6745,128191,"2020-05-01",2020
"20-May",울산,중구,340,99955,2548,102843,"2020-05-01",2020
"20-May",울산,계,1809,546067,21333,569209,"2020-05-01",2020
"20-May",세종,세종특별자치시,770,163754,2708,167232,"2020-05-01",2020
"20-May",세종,계,770,163754,2708,167232,"2020-05-01",2020
"20-May",경기,가평군,376,30070,611,31057,"2020-05-01",2020
"20-May",경기,고양시 덕양구,669,173325,4053,178047,"2020-05-01",2020
"20-May",경기,고양시 일산동구,282,121513,5870,127665,"2020-05-01",2020
"20-May",경기,고양시 일산서구,126,114968,4149,119243,"2020-05-01",2020
"20-May",경기,과천시,663,21897,612,23172,"2020-05-01",2020
"20-May",경기,광명시,308,103072,4183,107563,"2020-05-01",2020
"20-May",경기,광주시,377,185346,8221,193944,"2020-05-01",2020
"20-May",경기,구리시,263,70013,2632,72908,"2020-05-01",2020
"20-May",경기,군포시,299,97371,5093,102763,"2020-05-01",2020
"20-May",경기,김포시,500,206319,7420,214239,"2020-05-01",2020
"20-May",경기,남양주시,702,286610,8073,295385,"2020-05-01",2020
"20-May",경기,동두천시,211,36716,1309,38236,"2020-05-01",2020
"20-May",경기,부천시,698,293292,12704,306694,"2020-05-01",2020
"20-May",경기,성남시 분당구,360,182821,6893,190074,"2020-05-01",2020
"20-May",경기,성남시 수정구,360,72604,2390,75354,"2020-05-01",2020
"20-May",경기,성남시 중원구,336,70926,4043,75305,"2020-05-01",2020
"20-May",경기,수원시 권선구,479,181648,8433,190560,"2020-05-01",2020
"20-May",경기,수원시 영통구,222,145071,3171,148464,"2020-05-01",2020
"20-May",경기,수원시 장안구,493,102153,3813,106459,"2020-05-01",2020
"20-May",경기,수원시 팔달구,498,67499,2924,70921,"2020-05-01",2020
"20-May",경기,시흥시,462,230367,7541,238370,"2020-05-01",2020
"20-May",경기,안산시 단원구,570,151325,7885,159780,"2020-05-01",2020
"20-May",경기,안산시 상록구,175,137397,4811,142383,"2020-05-01",2020
"20-May",경기,안성시,398,99395,5022,104815,"2020-05-01",2020
"20-May",경기,안양시 동안구,410,115580,6188,122178,"2020-05-01",2020
"20-May",경기,안양시 만안구,150,82847,3901,86898,"2020-05-01",2020
"20-May",경기,양주시,382,102510,3168,106060,"2020-05-01",2020
"20-May",경기,양평군,565,58358,1780,60703,"2020-05-01",2020
"20-May",경기,여주시,443,61168,7597,69208,"2020-05-01",2020
"20-May",경기,연천군,302,23327,5354,28983,"2020-05-01",2020
"20-May",경기,오산시,216,102627,3316,106159,"2020-05-01",2020
"20-May",경기,용인시 기흥구,129,185264,6119,191512,"2020-05-01",2020
"20-May",경기,용인시 수지구,49,141792,2262,144103,"2020-05-01",2020
"20-May",경기,용인시 처인구,773,126624,7247,134644,"2020-05-01",2020
"20-May",경기,의왕시,287,63355,3178,66820,"2020-05-01",2020
"20-May",경기,의정부시,692,156017,5039,161748,"2020-05-01",2020
"20-May",경기,이천시,417,109745,5880,116042,"2020-05-01",2020
"20-May",경기,파주시,527,204224,10245,214996,"2020-05-01",2020
"20-May",경기,평택시,747,267260,11726,279733,"2020-05-01",2020
"20-May",경기,포천시,390,83684,10149,94223,"2020-05-01",2020
"20-May",경기,하남시,400,114840,2779,118019,"2020-05-01",2020
"20-May",경기,화성시,921,426861,11441,439223,"2020-05-01",2020
"20-May",경기,계,17627,5607801,229225,5854653,"2020-05-01",2020
"20-May",강원,강릉시,535,105017,4686,110238,"2020-05-01",2020
"20-May",강원,고성군,190,13903,231,14324,"2020-05-01",2020
"20-May",강원,동해시,308,44157,1404,45869,"2020-05-01",2020
"20-May",강원,삼척시,409,31700,738,32847,"2020-05-01",2020
"20-May",강원,속초시,301,36967,1343,38611,"2020-05-01",2020
"20-May",강원,양구군,186,11820,121,12127,"2020-05-01",2020
"20-May",강원,양양군,189,15368,234,15791,"2020-05-01",2020
"20-May",강원,영월군,327,20737,371,21435,"2020-05-01",2020
"20-May",강원,원주시,560,168578,5761,174899,"2020-05-01",2020
"20-May",강원,인제군,217,17864,282,18363,"2020-05-01",2020
"20-May",강원,정선군,333,20286,476,21095,"2020-05-01",2020
"20-May",강원,철원군,233,23690,316,24239,"2020-05-01",2020
"20-May",강원,춘천시,819,129243,5963,136025,"2020-05-01",2020
"20-May",강원,태백시,222,19970,745,20937,"2020-05-01",2020
"20-May",강원,평창군,293,25266,504,26063,"2020-05-01",2020
"20-May",강원,홍천군,425,37736,1066,39227,"2020-05-01",2020
"20-May",강원,화천군,233,12633,201,13067,"2020-05-01",2020
"20-May",강원,횡성군,250,25795,706,26751,"2020-05-01",2020
"20-May",강원,계,6030,760730,25148,791908,"2020-05-01",2020
"20-May",충북,괴산군,207,22117,390,22714,"2020-05-01",2020
"20-May",충북,단양군,217,15588,771,16576,"2020-05-01",2020
"20-May",충북,보은군,225,17705,886,18816,"2020-05-01",2020
"20-May",충북,영동군,232,24679,392,25303,"2020-05-01",2020
"20-May",충북,옥천군,199,26353,1117,27669,"2020-05-01",2020
"20-May",충북,음성군,224,57486,1847,59557,"2020-05-01",2020
"20-May",충북,제천시,332,66069,3488,69889,"2020-05-01",2020
"20-May",충북,증평군,94,18965,758,19817,"2020-05-01",2020
"20-May",충북,진천군,216,47376,1315,48907,"2020-05-01",2020
"20-May",충북,청원군,1,19,0,20,"2020-05-01",2020
"20-May",충북,청주시 상당구,511,84588,2531,87630,"2020-05-01",2020
"20-May",충북,청주시 서원구,245,95714,4988,100947,"2020-05-01",2020
"20-May",충북,청주시 청원구,360,101013,3976,105349,"2020-05-01",2020
"20-May",충북,청주시 흥덕구,368,125411,7337,133116,"2020-05-01",2020
"20-May",충북,충주시,589,106993,5580,113162,"2020-05-01",2020
"20-May",충북,계,4020,810076,35376,849472,"2020-05-01",2020
"20-May",충남,계룡시,152,21351,535,22038,"2020-05-01",2020
"20-May",충남,공주시,574,52997,2354,55925,"2020-05-01",2020
"20-May",충남,금산군,187,28224,2214,30625,"2020-05-01",2020
"20-May",충남,논산시,400,60230,2380,63010,"2020-05-01",2020
"20-May",충남,당진시,391,92732,3843,96966,"2020-05-01",2020
"20-May",충남,보령시,397,51463,1308,53168,"2020-05-01",2020
"20-May",충남,부여군,290,33967,1243,35500,"2020-05-01",2020
"20-May",충남,서산시,403,92302,3365,96070,"2020-05-01",2020
"20-May",충남,서천군,233,26811,894,27938,"2020-05-01",2020
"20-May",충남,아산시,508,161797,6313,168618,"2020-05-01",2020
"20-May",충남,예산군,405,42574,1403,44382,"2020-05-01",2020
"20-May",충남,천안시 동남구,256,128750,4836,133842,"2020-05-01",2020
"20-May",충남,천안시 서북구,553,189491,5574,195618,"2020-05-01",2020
"20-May",충남,청양군,262,16815,819,17896,"2020-05-01",2020
"20-May",충남,태안군,305,33505,515,34325,"2020-05-01",2020
"20-May",충남,홍성군,417,51762,1457,53636,"2020-05-01",2020
"20-May",충남,계,5733,1084771,39053,1129557,"2020-05-01",2020
"20-May",전북,고창군,286,29958,554,30798,"2020-05-01",2020
"20-May",전북,군산시,532,127677,6422,134631,"2020-05-01",2020
"20-May",전북,김제시,297,44587,2010,46894,"2020-05-01",2020
"20-May",전북,남원시,411,40134,4937,45482,"2020-05-01",2020
"20-May",전북,무주군,193,12563,386,13142,"2020-05-01",2020
"20-May",전북,부안군,263,26978,619,27860,"2020-05-01",2020
"20-May",전북,순창군,235,14456,164,14855,"2020-05-01",2020
"20-May",전북,완주군,392,50103,3177,53672,"2020-05-01",2020
"20-May",전북,익산시,518,134963,6063,141544,"2020-05-01",2020
"20-May",전북,임실군,210,14148,418,14776,"2020-05-01",2020
"20-May",전북,장수군,246,11866,170,12282,"2020-05-01",2020
"20-May",전북,전주시 덕진구,386,168046,7315,175747,"2020-05-01",2020
"20-May",전북,전주시 완산구,685,147453,4153,152291,"2020-05-01",2020
"20-May",전북,정읍시,353,53593,3655,57601,"2020-05-01",2020
"20-May",전북,진안군,248,13753,214,14215,"2020-05-01",2020
"20-May",전북,계,5255,890278,40257,935790,"2020-05-01",2020
"20-May",전남,강진군,234,18273,1130,19637,"2020-05-01",2020
"20-May",전남,고흥군,301,31119,627,32047,"2020-05-01",2020
"20-May",전남,곡성군,159,14439,692,15290,"2020-05-01",2020
"20-May",전남,광양시,248,81467,5944,87659,"2020-05-01",2020
"20-May",전남,구례군,139,12965,684,13788,"2020-05-01",2020
"20-May",전남,나주시,474,62494,3210,66178,"2020-05-01",2020
"20-May",전남,담양군,213,25924,1599,27736,"2020-05-01",2020
"20-May",전남,목포시,459,96060,5633,102152,"2020-05-01",2020
"20-May",전남,무안군,573,42361,1011,43945,"2020-05-01",2020
"20-May",전남,보성군,210,21208,34651,56069,"2020-05-01",2020
"20-May",전남,순천시,495,136259,5120,141874,"2020-05-01",2020
"20-May",전남,신안군,273,20578,25368,46219,"2020-05-01",2020
"20-May",전남,여수시,537,128681,6952,136170,"2020-05-01",2020
"20-May",전남,영광군,204,27117,726,28047,"2020-05-01",2020
"20-May",전남,영암군,251,32975,11949,45175,"2020-05-01",2020
"20-May",전남,완도군,248,24880,506,25634,"2020-05-01",2020
"20-May",전남,장성군,187,26322,1145,27654,"2020-05-01",2020
"20-May",전남,장흥군,210,19724,453,20387,"2020-05-01",2020
"20-May",전남,진도군,167,16314,293,16774,"2020-05-01",2020
"20-May",전남,함평군,198,17710,24867,42775,"2020-05-01",2020
"20-May",전남,해남군,345,38383,606,39334,"2020-05-01",2020
"20-May",전남,화순군,218,31771,2044,34033,"2020-05-01",2020
"20-May",전남,계,6343,927024,135210,1068577,"2020-05-01",2020
"20-May",경북,경산시,327,135330,4467,140124,"2020-05-01",2020
"20-May",경북,경주시,585,138493,4569,143647,"2020-05-01",2020
"20-May",경북,고령군,167,20275,511,20953,"2020-05-01",2020
"20-May",경북,구미시,511,210633,7181,218325,"2020-05-01",2020
"20-May",경북,군위군,128,14529,279,14936,"2020-05-01",2020
"20-May",경북,김천시,386,72102,1872,74360,"2020-05-01",2020
"20-May",경북,문경시,284,35710,843,36837,"2020-05-01",2020
"20-May",경북,봉화군,204,17594,196,17994,"2020-05-01",2020
"20-May",경북,상주시,383,52305,1837,54525,"2020-05-01",2020
"20-May",경북,성주군,200,29788,1384,31372,"2020-05-01",2020
"20-May",경북,안동시,726,80462,2598,83786,"2020-05-01",2020
"20-May",경북,영덕군,264,18637,304,19205,"2020-05-01",2020
"20-May",경북,영양군,146,9443,111,9700,"2020-05-01",2020
"20-May",경북,영주시,373,54675,1528,56576,"2020-05-01",2020
"20-May",경북,영천시,318,58409,2708,61435,"2020-05-01",2020
"20-May",경북,예천군,270,28893,485,29648,"2020-05-01",2020
"20-May",경북,울릉군,150,5029,492,5671,"2020-05-01",2020
"20-May",경북,울진군,310,25547,359,26216,"2020-05-01",2020
"20-May",경북,의성군,314,29965,960,31239,"2020-05-01",2020
"20-May",경북,청도군,217,24498,719,25434,"2020-05-01",2020
"20-May",경북,청송군,203,15259,207,15669,"2020-05-01",2020
"20-May",경북,칠곡군,298,67529,2287,70114,"2020-05-01",2020
"20-May",경북,포항시 남구,446,118751,8506,127703,"2020-05-01",2020
"20-May",경북,포항시 북구,349,136128,3850,140327,"2020-05-01",2020
"20-May",경북,계,7559,1399984,48253,1455796,"2020-05-01",2020
"20-May",경남,거제시,362,104494,2095,106951,"2020-05-01",2020
"20-May",경남,거창군,259,31458,809,32526,"2020-05-01",2020
"20-May",경남,고성군,228,26180,627,27035,"2020-05-01",2020
"20-May",경남,김해시,646,269534,7296,277476,"2020-05-01",2020
"20-May",경남,남해군,262,19298,467,20027,"2020-05-01",2020
"20-May",경남,밀양시,328,54674,3963,58965,"2020-05-01",2020
"20-May",경남,사천시,312,55154,1497,56963,"2020-05-01",2020
"20-May",경남,산청군,239,19649,787,20675,"2020-05-01",2020
"20-May",경남,양산시,415,161434,9958,171807,"2020-05-01",2020
"20-May",경남,의령군,206,14105,677,14988,"2020-05-01",2020
"20-May",경남,진주시,595,162611,6619,169825,"2020-05-01",2020
"20-May",경남,창녕군,235,34844,917,35996,"2020-05-01",2020
"20-May",경남,창원시 마산합포구,330,96289,2870,99489,"2020-05-01",2020
"20-May",경남,창원시 마산회원구,176,93502,4871,98549,"2020-05-01",2020
"20-May",경남,창원시 성산구,144,115047,5675,120866,"2020-05-01",2020
"20-May",경남,창원시 의창구,934,137488,22255,160677,"2020-05-01",2020
"20-May",경남,창원시 진해구,212,88981,1761,90954,"2020-05-01",2020
"20-May",경남,통영시,331,52228,1394,53953,"2020-05-01",2020
"20-May",경남,하동군,231,24087,411,24729,"2020-05-01",2020
"20-May",경남,함안군,191,39890,15536,55617,"2020-05-01",2020
"20-May",경남,함양군,217,19032,433,19682,"2020-05-01",2020
"20-May",경남,합천군,268,22840,638,23746,"2020-05-01",2020
"20-May",경남,계,7121,1642819,91556,1741496,"2020-05-01",2020
"20-May",제주,서귀포시,807,101971,1917,104695,"2020-05-01",2020
"20-May",제주,제주시,1644,271066,224116,496826,"2020-05-01",2020
"20-May",제주,계,2451,373037,226033,601521,"2020-05-01",2020
"20-Jun",서울,강남구,409,215820,18669,234898,"2020-06-01",2020
"20-Jun",서울,강동구,293,138554,8909,147756,"2020-06-01",2020
"20-Jun",서울,강북구,324,71418,4363,76105,"2020-06-01",2020
"20-Jun",서울,강서구,343,186098,18963,205404,"2020-06-01",2020
"20-Jun",서울,관악구,323,113953,5652,119928,"2020-06-01",2020
"20-Jun",서울,광진구,292,93087,5775,99154,"2020-06-01",2020
"20-Jun",서울,구로구,295,131231,13000,144526,"2020-06-01",2020
"20-Jun",서울,금천구,138,81940,5855,87933,"2020-06-01",2020
"20-Jun",서울,노원구,339,143033,9379,152751,"2020-06-01",2020
"20-Jun",서울,도봉구,273,88618,7407,96298,"2020-06-01",2020
"20-Jun",서울,동대문구,310,92813,5172,98295,"2020-06-01",2020
"20-Jun",서울,동작구,318,102627,2733,105678,"2020-06-01",2020
"20-Jun",서울,마포구,341,111575,6996,118912,"2020-06-01",2020
"20-Jun",서울,서대문구,462,82074,6005,88541,"2020-06-01",2020
"20-Jun",서울,서초구,546,167779,13057,181382,"2020-06-01",2020
"20-Jun",서울,성동구,352,93687,10874,104913,"2020-06-01",2020
"20-Jun",서울,성북구,290,114363,5465,120118,"2020-06-01",2020
"20-Jun",서울,송파구,384,228854,13263,242501,"2020-06-01",2020
"20-Jun",서울,양천구,313,142400,8756,151469,"2020-06-01",2020
"20-Jun",서울,영등포구,375,133873,9499,143747,"2020-06-01",2020
"20-Jun",서울,용산구,355,74944,1831,77130,"2020-06-01",2020
"20-Jun",서울,은평구,284,123349,7146,130779,"2020-06-01",2020
"20-Jun",서울,종로구,3885,44619,1700,50204,"2020-06-01",2020
"20-Jun",서울,중구,1163,45721,3917,50801,"2020-06-01",2020
"20-Jun",서울,중랑구,250,102721,9516,112487,"2020-06-01",2020
"20-Jun",서울,계,12657,2925151,203902,3141710,"2020-06-01",2020
"20-Jun",부산,강서구,317,74071,3535,77923,"2020-06-01",2020
"20-Jun",부산,금정구,284,80783,7712,88779,"2020-06-01",2020
"20-Jun",부산,기장군,267,75017,2490,77774,"2020-06-01",2020
"20-Jun",부산,남구,228,91033,8361,99622,"2020-06-01",2020
"20-Jun",부산,동구,189,46266,4812,51267,"2020-06-01",2020
"20-Jun",부산,동래구,181,92243,3922,96346,"2020-06-01",2020
"20-Jun",부산,부산진구,379,120960,18002,139341,"2020-06-01",2020
"20-Jun",부산,북구,245,100396,3411,104052,"2020-06-01",2020
"20-Jun",부산,사상구,287,83948,5984,90219,"2020-06-01",2020
"20-Jun",부산,사하구,269,107611,6792,114672,"2020-06-01",2020
"20-Jun",부산,서구,135,28318,1398,29851,"2020-06-01",2020
"20-Jun",부산,수영구,165,67435,29776,97376,"2020-06-01",2020
"20-Jun",부산,연제구,955,88804,9538,99297,"2020-06-01",2020
"20-Jun",부산,영도구,239,30851,2050,33140,"2020-06-01",2020
"20-Jun",부산,중구,314,26680,7203,34197,"2020-06-01",2020
"20-Jun",부산,해운대구,322,164436,12712,177470,"2020-06-01",2020
"20-Jun",부산,계,4776,1278852,127698,1411326,"2020-06-01",2020
"20-Jun",대구,남구,350,55779,1753,57882,"2020-06-01",2020
"20-Jun",대구,달서구,508,269140,14447,284095,"2020-06-01",2020
"20-Jun",대구,달성군,522,130635,4977,136134,"2020-06-01",2020
"20-Jun",대구,동구,356,151537,11350,163243,"2020-06-01",2020
"20-Jun",대구,북구,527,198452,7610,206589,"2020-06-01",2020
"20-Jun",대구,서구,241,69375,3669,73285,"2020-06-01",2020
"20-Jun",대구,수성구,580,213919,5366,219865,"2020-06-01",2020
"20-Jun",대구,중구,304,56861,2404,59569,"2020-06-01",2020
"20-Jun",대구,계,3388,1145698,51576,1200662,"2020-06-01",2020
"20-Jun",인천,강화군,341,34015,44390,78746,"2020-06-01",2020
"20-Jun",인천,계양구,286,119346,196716,316348,"2020-06-01",2020
"20-Jun",인천,남동구,858,256868,52112,309838,"2020-06-01",2020
"20-Jun",인천,동구,90,23999,4248,28337,"2020-06-01",2020
"20-Jun",인천,미추홀구,416,156943,11511,168870,"2020-06-01",2020
"20-Jun",인천,부평구,349,213817,17418,231584,"2020-06-01",2020
"20-Jun",인천,서구,436,236866,11029,248331,"2020-06-01",2020
"20-Jun",인천,연수구,400,182510,7950,190860,"2020-06-01",2020
"20-Jun",인천,옹진군,214,11749,200,12163,"2020-06-01",2020
"20-Jun",인천,중구,683,64025,15712,80420,"2020-06-01",2020
"20-Jun",인천,계,4073,1300138,361286,1665497,"2020-06-01",2020
"20-Jun",광주,광산구,515,191828,12197,204540,"2020-06-01",2020
"20-Jun",광주,남구,210,89387,2662,92259,"2020-06-01",2020
"20-Jun",광주,동구,245,40106,1187,41538,"2020-06-01",2020
"20-Jun",광주,북구,620,187649,9314,197583,"2020-06-01",2020
"20-Jun",광주,서구,651,142191,6793,149635,"2020-06-01",2020
"20-Jun",광주,계,2241,651161,32153,685555,"2020-06-01",2020
"20-Jun",대전,대덕구,241,84318,6721,91280,"2020-06-01",2020
"20-Jun",대전,동구,251,88593,4434,93278,"2020-06-01",2020
"20-Jun",대전,서구,821,204987,7388,213196,"2020-06-01",2020
"20-Jun",대전,유성구,382,175809,4752,180943,"2020-06-01",2020
"20-Jun",대전,중구,241,96460,5868,102569,"2020-06-01",2020
"20-Jun",대전,계,1936,650167,29163,681266,"2020-06-01",2020
"20-Jun",울산,남구,713,153102,7379,161194,"2020-06-01",2020
"20-Jun",울산,동구,193,61469,1046,62708,"2020-06-01",2020
"20-Jun",울산,북구,182,111836,3940,115958,"2020-06-01",2020
"20-Jun",울산,울주군,388,121378,6751,128517,"2020-06-01",2020
"20-Jun",울산,중구,343,100067,2520,102930,"2020-06-01",2020
"20-Jun",울산,계,1819,547852,21636,571307,"2020-06-01",2020
"20-Jun",세종,세종특별자치시,782,164133,2708,167623,"2020-06-01",2020
"20-Jun",세종,계,782,164133,2708,167623,"2020-06-01",2020
"20-Jun",경기,가평군,380,30280,605,31265,"2020-06-01",2020
"20-Jun",경기,고양시 덕양구,676,174206,4053,178935,"2020-06-01",2020
"20-Jun",경기,고양시 일산동구,280,122047,5792,128119,"2020-06-01",2020
"20-Jun",경기,고양시 일산서구,128,115484,4035,119647,"2020-06-01",2020
"20-Jun",경기,과천시,718,22190,617,23525,"2020-06-01",2020
"20-Jun",경기,광명시,306,102982,4232,107520,"2020-06-01",2020
"20-Jun",경기,광주시,385,186561,8291,195237,"2020-06-01",2020
"20-Jun",경기,구리시,265,70221,2629,73115,"2020-06-01",2020
"20-Jun",경기,군포시,306,97804,5169,103279,"2020-06-01",2020
"20-Jun",경기,김포시,498,207930,7425,215853,"2020-06-01",2020
"20-Jun",경기,남양주시,709,287940,8121,296770,"2020-06-01",2020
"20-Jun",경기,동두천시,213,36924,1314,38451,"2020-06-01",2020
"20-Jun",경기,부천시,705,293939,12652,307296,"2020-06-01",2020
"20-Jun",경기,성남시 분당구,364,183393,6848,190605,"2020-06-01",2020
"20-Jun",경기,성남시 수정구,364,73109,2396,75869,"2020-06-01",2020
"20-Jun",경기,성남시 중원구,337,71149,4049,75535,"2020-06-01",2020
"20-Jun",경기,수원시 권선구,507,183712,8519,192738,"2020-06-01",2020
"20-Jun",경기,수원시 영통구,226,145709,3259,149194,"2020-06-01",2020
"20-Jun",경기,수원시 장안구,478,101770,3818,106066,"2020-06-01",2020
"20-Jun",경기,수원시 팔달구,501,69995,2888,73384,"2020-06-01",2020
"20-Jun",경기,시흥시,465,231822,7574,239861,"2020-06-01",2020
"20-Jun",경기,안산시 단원구,572,152009,7841,160422,"2020-06-01",2020
"20-Jun",경기,안산시 상록구,177,138261,4823,143261,"2020-06-01",2020
"20-Jun",경기,안성시,394,99983,5007,105384,"2020-06-01",2020
"20-Jun",경기,안양시 동안구,414,115658,6171,122243,"2020-06-01",2020
"20-Jun",경기,안양시 만안구,150,83155,3925,87230,"2020-06-01",2020
"20-Jun",경기,양주시,385,103282,3186,106853,"2020-06-01",2020
"20-Jun",경기,양평군,562,58578,1794,60934,"2020-06-01",2020
"20-Jun",경기,여주시,446,61487,7592,69525,"2020-06-01",2020
"20-Jun",경기,연천군,305,23406,5338,29049,"2020-06-01",2020
"20-Jun",경기,오산시,217,103435,3339,106991,"2020-06-01",2020
"20-Jun",경기,용인시 기흥구,134,185902,6168,192204,"2020-06-01",2020
"20-Jun",경기,용인시 수지구,50,142460,2258,144768,"2020-06-01",2020
"20-Jun",경기,용인시 처인구,774,127341,7270,135385,"2020-06-01",2020
"20-Jun",경기,의왕시,291,63538,3183,67012,"2020-06-01",2020
"20-Jun",경기,의정부시,713,156956,5065,162734,"2020-06-01",2020
"20-Jun",경기,이천시,419,110216,5869,116504,"2020-06-01",2020
"20-Jun",경기,파주시,527,205344,10313,216184,"2020-06-01",2020
"20-Jun",경기,평택시,749,268983,11708,281440,"2020-06-01",2020
"20-Jun",경기,포천시,397,84033,9948,94378,"2020-06-01",2020
"20-Jun",경기,하남시,401,115956,2792,119149,"2020-06-01",2020
"20-Jun",경기,화성시,927,428713,11511,441151,"2020-06-01",2020
"20-Jun",경기,계,17815,5637863,229387,5885065,"2020-06-01",2020
"20-Jun",강원,강릉시,542,105494,4645,110681,"2020-06-01",2020
"20-Jun",강원,고성군,188,14027,230,14445,"2020-06-01",2020
"20-Jun",강원,동해시,310,44470,1405,46185,"2020-06-01",2020
"20-Jun",강원,삼척시,401,31808,747,32956,"2020-06-01",2020
"20-Jun",강원,속초시,304,37208,1352,38864,"2020-06-01",2020
"20-Jun",강원,양구군,185,11855,122,12162,"2020-06-01",2020
"20-Jun",강원,양양군,189,15433,243,15865,"2020-06-01",2020
"20-Jun",강원,영월군,328,20859,372,21559,"2020-06-01",2020
"20-Jun",강원,원주시,563,169623,5744,175930,"2020-06-01",2020
"20-Jun",강원,인제군,221,17929,285,18435,"2020-06-01",2020
"20-Jun",강원,정선군,333,20393,474,21200,"2020-06-01",2020
"20-Jun",강원,철원군,238,23776,317,24331,"2020-06-01",2020
"20-Jun",강원,춘천시,827,129923,5961,136711,"2020-06-01",2020
"20-Jun",강원,태백시,225,20019,742,20986,"2020-06-01",2020
"20-Jun",강원,평창군,297,25332,508,26137,"2020-06-01",2020
"20-Jun",강원,홍천군,426,37965,1054,39445,"2020-06-01",2020
"20-Jun",강원,화천군,234,12733,199,13166,"2020-06-01",2020
"20-Jun",강원,횡성군,252,25935,709,26896,"2020-06-01",2020
"20-Jun",강원,계,6063,764782,25109,795954,"2020-06-01",2020
"20-Jun",충북,괴산군,208,22220,388,22816,"2020-06-01",2020
"20-Jun",충북,단양군,219,15666,767,16652,"2020-06-01",2020
"20-Jun",충북,보은군,220,17784,889,18893,"2020-06-01",2020
"20-Jun",충북,영동군,247,24747,389,25383,"2020-06-01",2020
"20-Jun",충북,옥천군,200,26473,1126,27799,"2020-06-01",2020
"20-Jun",충북,음성군,230,57792,1860,59882,"2020-06-01",2020
"20-Jun",충북,제천시,336,66298,3482,70116,"2020-06-01",2020
"20-Jun",충북,증평군,94,19022,756,19872,"2020-06-01",2020
"20-Jun",충북,진천군,215,47590,1326,49131,"2020-06-01",2020
"20-Jun",충북,청원군,1,19,0,20,"2020-06-01",2020
"20-Jun",충북,청주시 상당구,513,85832,2552,88897,"2020-06-01",2020
"20-Jun",충북,청주시 서원구,240,95609,4999,100848,"2020-06-01",2020
"20-Jun",충북,청주시 청원구,363,101260,3985,105608,"2020-06-01",2020
"20-Jun",충북,청주시 흥덕구,366,126474,7269,134109,"2020-06-01",2020
"20-Jun",충북,충주시,591,107584,5569,113744,"2020-06-01",2020
"20-Jun",충북,계,4043,814370,35357,853770,"2020-06-01",2020
"20-Jun",충남,계룡시,149,21548,538,22235,"2020-06-01",2020
"20-Jun",충남,공주시,580,53185,2342,56107,"2020-06-01",2020
"20-Jun",충남,금산군,188,28194,2183,30565,"2020-06-01",2020
"20-Jun",충남,논산시,399,60412,2391,63202,"2020-06-01",2020
"20-Jun",충남,당진시,391,93151,3851,97393,"2020-06-01",2020
"20-Jun",충남,보령시,403,51773,1321,53497,"2020-06-01",2020
"20-Jun",충남,부여군,294,34070,1237,35601,"2020-06-01",2020
"20-Jun",충남,서산시,409,92742,3428,96579,"2020-06-01",2020
"20-Jun",충남,서천군,232,26929,894,28055,"2020-06-01",2020
"20-Jun",충남,아산시,512,161995,6365,168872,"2020-06-01",2020
"20-Jun",충남,예산군,405,42759,1398,44562,"2020-06-01",2020
"20-Jun",충남,천안시 동남구,255,129313,4801,134369,"2020-06-01",2020
"20-Jun",충남,천안시 서북구,551,191438,5586,197575,"2020-06-01",2020
"20-Jun",충남,청양군,251,16783,811,17845,"2020-06-01",2020
"20-Jun",충남,태안군,304,33651,518,34473,"2020-06-01",2020
"20-Jun",충남,홍성군,418,51965,1460,53843,"2020-06-01",2020
"20-Jun",충남,계,5741,1089908,39124,1134773,"2020-06-01",2020
"20-Jun",전북,고창군,290,29939,551,30780,"2020-06-01",2020
"20-Jun",전북,군산시,536,128278,6426,135240,"2020-06-01",2020
"20-Jun",전북,김제시,292,44811,2010,47113,"2020-06-01",2020
"20-Jun",전북,남원시,412,40268,4854,45534,"2020-06-01",2020
"20-Jun",전북,무주군,193,12553,386,13132,"2020-06-01",2020
"20-Jun",전북,부안군,265,27151,617,28033,"2020-06-01",2020
"20-Jun",전북,순창군,237,14468,163,14868,"2020-06-01",2020
"20-Jun",전북,완주군,396,50385,3177,53958,"2020-06-01",2020
"20-Jun",전북,익산시,527,135286,6046,141859,"2020-06-01",2020
"20-Jun",전북,임실군,209,14206,418,14833,"2020-06-01",2020
"20-Jun",전북,장수군,244,11950,170,12364,"2020-06-01",2020
"20-Jun",전북,전주시 덕진구,389,168405,7313,176107,"2020-06-01",2020
"20-Jun",전북,전주시 완산구,738,148192,4166,153096,"2020-06-01",2020
"20-Jun",전북,정읍시,349,53774,3750,57873,"2020-06-01",2020
"20-Jun",전북,진안군,250,13781,212,14243,"2020-06-01",2020
"20-Jun",전북,계,5327,893447,40259,939033,"2020-06-01",2020
"20-Jun",전남,강진군,234,18329,1119,19682,"2020-06-01",2020
"20-Jun",전남,고흥군,305,31303,628,32236,"2020-06-01",2020
"20-Jun",전남,곡성군,161,14483,696,15340,"2020-06-01",2020
"20-Jun",전남,광양시,247,81544,5949,87740,"2020-06-01",2020
"20-Jun",전남,구례군,141,13016,698,13855,"2020-06-01",2020
"20-Jun",전남,나주시,472,62703,3228,66403,"2020-06-01",2020
"20-Jun",전남,담양군,224,26026,1591,27841,"2020-06-01",2020
"20-Jun",전남,목포시,466,96300,5633,102399,"2020-06-01",2020
"20-Jun",전남,무안군,582,42549,1002,44133,"2020-06-01",2020
"20-Jun",전남,보성군,212,21260,33285,54757,"2020-06-01",2020
"20-Jun",전남,순천시,499,137162,5074,142735,"2020-06-01",2020
"20-Jun",전남,신안군,278,20663,28631,49572,"2020-06-01",2020
"20-Jun",전남,여수시,536,129329,7021,136886,"2020-06-01",2020
"20-Jun",전남,영광군,210,27270,727,28207,"2020-06-01",2020
"20-Jun",전남,영암군,261,33192,11542,44995,"2020-06-01",2020
"20-Jun",전남,완도군,247,25000,528,25775,"2020-06-01",2020
"20-Jun",전남,장성군,188,26401,1144,27733,"2020-06-01",2020
"20-Jun",전남,장흥군,211,19761,455,20427,"2020-06-01",2020
"20-Jun",전남,진도군,165,16348,293,16806,"2020-06-01",2020
"20-Jun",전남,함평군,197,17749,25034,42980,"2020-06-01",2020
"20-Jun",전남,해남군,352,38511,612,39475,"2020-06-01",2020
"20-Jun",전남,화순군,221,31946,2068,34235,"2020-06-01",2020
"20-Jun",전남,계,6409,930845,136958,1074212,"2020-06-01",2020
"20-Jun",경북,경산시,334,135688,4494,140516,"2020-06-01",2020
"20-Jun",경북,경주시,588,138893,4567,144048,"2020-06-01",2020
"20-Jun",경북,고령군,170,20295,514,20979,"2020-06-01",2020
"20-Jun",경북,구미시,515,211072,7189,218776,"2020-06-01",2020
"20-Jun",경북,군위군,129,14570,280,14979,"2020-06-01",2020
"20-Jun",경북,김천시,397,72524,1878,74799,"2020-06-01",2020
"20-Jun",경북,문경시,284,36012,847,37143,"2020-06-01",2020
"20-Jun",경북,봉화군,208,17695,195,18098,"2020-06-01",2020
"20-Jun",경북,상주시,383,52368,1826,54577,"2020-06-01",2020
"20-Jun",경북,성주군,204,29891,1391,31486,"2020-06-01",2020
"20-Jun",경북,안동시,738,80753,2601,84092,"2020-06-01",2020
"20-Jun",경북,영덕군,264,18693,301,19258,"2020-06-01",2020
"20-Jun",경북,영양군,144,9464,111,9719,"2020-06-01",2020
"20-Jun",경북,영주시,378,54825,1521,56724,"2020-06-01",2020
"20-Jun",경북,영천시,328,58672,2699,61699,"2020-06-01",2020
"20-Jun",경북,예천군,272,29044,488,29804,"2020-06-01",2020
"20-Jun",경북,울릉군,151,5048,499,5698,"2020-06-01",2020
"20-Jun",경북,울진군,318,25627,359,26304,"2020-06-01",2020
"20-Jun",경북,의성군,322,30094,958,31374,"2020-06-01",2020
"20-Jun",경북,청도군,221,24556,722,25499,"2020-06-01",2020
"20-Jun",경북,청송군,201,15299,211,15711,"2020-06-01",2020
"20-Jun",경북,칠곡군,310,67578,2290,70178,"2020-06-01",2020
"20-Jun",경북,포항시 남구,452,118964,8464,127880,"2020-06-01",2020
"20-Jun",경북,포항시 북구,355,136721,3844,140920,"2020-06-01",2020
"20-Jun",경북,계,7666,1404346,48249,1460261,"2020-06-01",2020
"20-Jun",경남,거제시,364,104822,2096,107282,"2020-06-01",2020
"20-Jun",경남,거창군,263,31597,807,32667,"2020-06-01",2020
"20-Jun",경남,고성군,227,26229,623,27079,"2020-06-01",2020
"20-Jun",경남,김해시,657,270369,7309,278335,"2020-06-01",2020
"20-Jun",경남,남해군,266,19407,469,20142,"2020-06-01",2020
"20-Jun",경남,밀양시,333,54903,3961,59197,"2020-06-01",2020
"20-Jun",경남,사천시,316,55279,1489,57084,"2020-06-01",2020
"20-Jun",경남,산청군,239,19794,794,20827,"2020-06-01",2020
"20-Jun",경남,양산시,422,162052,9956,172430,"2020-06-01",2020
"20-Jun",경남,의령군,203,14168,678,15049,"2020-06-01",2020
"20-Jun",경남,진주시,603,163085,6555,170243,"2020-06-01",2020
"20-Jun",경남,창녕군,236,34968,871,36075,"2020-06-01",2020
"20-Jun",경남,창원시 마산합포구,330,96045,2864,99239,"2020-06-01",2020
"20-Jun",경남,창원시 마산회원구,176,93693,4836,98705,"2020-06-01",2020
"20-Jun",경남,창원시 성산구,145,115861,5617,121623,"2020-06-01",2020
"20-Jun",경남,창원시 의창구,941,138106,23888,162935,"2020-06-01",2020
"20-Jun",경남,창원시 진해구,215,89327,1805,91347,"2020-06-01",2020
"20-Jun",경남,통영시,333,52213,1394,53940,"2020-06-01",2020
"20-Jun",경남,하동군,231,24124,414,24769,"2020-06-01",2020
"20-Jun",경남,함안군,192,40093,15885,56170,"2020-06-01",2020
"20-Jun",경남,함양군,219,19090,431,19740,"2020-06-01",2020
"20-Jun",경남,합천군,272,22899,641,23812,"2020-06-01",2020
"20-Jun",경남,계,7183,1648124,93383,1748690,"2020-06-01",2020
"20-Jun",제주,서귀포시,818,102118,1913,104849,"2020-06-01",2020
"20-Jun",제주,제주시,1650,272458,227422,501530,"2020-06-01",2020
"20-Jun",제주,계,2468,374576,229335,606379,"2020-06-01",2020
"20-Jul",서울,강남구,400,216072,18850,235322,"2020-07-01",2020
"20-Jul",서울,강동구,291,138853,8936,148080,"2020-07-01",2020
"20-Jul",서울,강북구,328,71437,4362,76127,"2020-07-01",2020
"20-Jul",서울,강서구,347,185911,19019,205277,"2020-07-01",2020
"20-Jul",서울,관악구,318,114339,5637,120294,"2020-07-01",2020
"20-Jul",서울,광진구,293,93162,5587,99042,"2020-07-01",2020
"20-Jul",서울,구로구,297,131572,12969,144838,"2020-07-01",2020
"20-Jul",서울,금천구,137,82159,6001,88297,"2020-07-01",2020
"20-Jul",서울,노원구,337,143224,9360,152921,"2020-07-01",2020
"20-Jul",서울,도봉구,270,88645,7405,96320,"2020-07-01",2020
"20-Jul",서울,동대문구,308,92872,5261,98441,"2020-07-01",2020
"20-Jul",서울,동작구,322,102834,2718,105874,"2020-07-01",2020
"20-Jul",서울,마포구,341,111746,7034,119121,"2020-07-01",2020
"20-Jul",서울,서대문구,467,82222,5961,88650,"2020-07-01",2020
"20-Jul",서울,서초구,541,167530,12959,181030,"2020-07-01",2020
"20-Jul",서울,성동구,353,93592,11592,105537,"2020-07-01",2020
"20-Jul",서울,성북구,291,114497,5451,120239,"2020-07-01",2020
"20-Jul",서울,송파구,387,229769,13218,243374,"2020-07-01",2020
"20-Jul",서울,양천구,319,142591,8745,151655,"2020-07-01",2020
"20-Jul",서울,영등포구,370,134137,9411,143918,"2020-07-01",2020
"20-Jul",서울,용산구,355,75053,1838,77246,"2020-07-01",2020
"20-Jul",서울,은평구,285,124190,7170,131645,"2020-07-01",2020
"20-Jul",서울,종로구,3844,44624,1712,50180,"2020-07-01",2020
"20-Jul",서울,중구,1270,45753,3890,50913,"2020-07-01",2020
"20-Jul",서울,중랑구,255,103005,9548,112808,"2020-07-01",2020
"20-Jul",서울,계,12726,2929789,204634,3147149,"2020-07-01",2020
"20-Jul",부산,강서구,315,74303,3486,78104,"2020-07-01",2020
"20-Jul",부산,금정구,284,80623,7707,88614,"2020-07-01",2020
"20-Jul",부산,기장군,265,75618,2508,78391,"2020-07-01",2020
"20-Jul",부산,남구,227,91026,8374,99627,"2020-07-01",2020
"20-Jul",부산,동구,186,46277,5013,51476,"2020-07-01",2020
"20-Jul",부산,동래구,178,92470,3895,96543,"2020-07-01",2020
"20-Jul",부산,부산진구,373,121329,18273,139975,"2020-07-01",2020
"20-Jul",부산,북구,242,100352,3426,104020,"2020-07-01",2020
"20-Jul",부산,사상구,285,83954,5982,90221,"2020-07-01",2020
"20-Jul",부산,사하구,266,107649,6803,114718,"2020-07-01",2020
"20-Jul",부산,서구,136,28389,1402,29927,"2020-07-01",2020
"20-Jul",부산,수영구,163,67230,31779,99172,"2020-07-01",2020
"20-Jul",부산,연제구,950,88679,9889,99518,"2020-07-01",2020
"20-Jul",부산,영도구,231,30908,2053,33192,"2020-07-01",2020
"20-Jul",부산,중구,311,26863,7014,34188,"2020-07-01",2020
"20-Jul",부산,해운대구,321,164506,12686,177513,"2020-07-01",2020
"20-Jul",부산,계,4733,1280176,130290,1415199,"2020-07-01",2020
"20-Jul",대구,남구,349,55767,1738,57854,"2020-07-01",2020
"20-Jul",대구,달서구,505,269897,14455,284857,"2020-07-01",2020
"20-Jul",대구,달성군,519,131391,5003,136913,"2020-07-01",2020
"20-Jul",대구,동구,352,152068,11362,163782,"2020-07-01",2020
"20-Jul",대구,북구,519,199531,7622,207672,"2020-07-01",2020
"20-Jul",대구,서구,239,69571,3677,73487,"2020-07-01",2020
"20-Jul",대구,수성구,576,214225,5370,220171,"2020-07-01",2020
"20-Jul",대구,중구,301,57559,2473,60333,"2020-07-01",2020
"20-Jul",대구,계,3360,1150009,51700,1205069,"2020-07-01",2020
"20-Jul",인천,강화군,338,34124,43413,77875,"2020-07-01",2020
"20-Jul",인천,계양구,285,119279,197431,316995,"2020-07-01",2020
"20-Jul",인천,남동구,856,257126,52032,310014,"2020-07-01",2020
"20-Jul",인천,동구,92,25537,4262,29891,"2020-07-01",2020
"20-Jul",인천,미추홀구,414,157239,11141,168794,"2020-07-01",2020
"20-Jul",인천,부평구,349,213888,18393,232630,"2020-07-01",2020
"20-Jul",인천,서구,433,238728,11011,250172,"2020-07-01",2020
"20-Jul",인천,연수구,408,183594,8041,192043,"2020-07-01",2020
"20-Jul",인천,옹진군,214,11834,204,12252,"2020-07-01",2020
"20-Jul",인천,중구,687,63236,15686,79609,"2020-07-01",2020
"20-Jul",인천,계,4076,1304585,361614,1670275,"2020-07-01",2020
"20-Jul",광주,광산구,517,192610,12228,205355,"2020-07-01",2020
"20-Jul",광주,남구,208,89614,2709,92531,"2020-07-01",2020
"20-Jul",광주,동구,240,40274,1200,41714,"2020-07-01",2020
"20-Jul",광주,북구,607,188183,9245,198035,"2020-07-01",2020
"20-Jul",광주,서구,650,142279,6827,149756,"2020-07-01",2020
"20-Jul",광주,계,2222,652960,32209,687391,"2020-07-01",2020
"20-Jul",대전,대덕구,241,84242,6735,91218,"2020-07-01",2020
"20-Jul",대전,동구,249,88866,4415,93530,"2020-07-01",2020
"20-Jul",대전,서구,807,205622,7403,213832,"2020-07-01",2020
"20-Jul",대전,유성구,379,176594,4773,181746,"2020-07-01",2020
"20-Jul",대전,중구,238,96687,5887,102812,"2020-07-01",2020
"20-Jul",대전,계,1914,652011,29213,683138,"2020-07-01",2020
"20-Jul",울산,남구,712,153415,7429,161556,"2020-07-01",2020
"20-Jul",울산,동구,193,61645,1055,62893,"2020-07-01",2020
"20-Jul",울산,북구,181,112733,3914,116828,"2020-07-01",2020
"20-Jul",울산,울주군,389,121827,6730,128946,"2020-07-01",2020
"20-Jul",울산,중구,343,100334,2515,103192,"2020-07-01",2020
"20-Jul",울산,계,1818,549954,21643,573415,"2020-07-01",2020
"20-Jul",세종,세종특별자치시,782,165045,2708,168535,"2020-07-01",2020
"20-Jul",세종,계,782,165045,2708,168535,"2020-07-01",2020
"20-Jul",경기,가평군,376,30353,596,31325,"2020-07-01",2020
"20-Jul",경기,고양시 덕양구,673,175006,4043,179722,"2020-07-01",2020
"20-Jul",경기,고양시 일산동구,280,122230,5794,128304,"2020-07-01",2020
"20-Jul",경기,고양시 일산서구,128,115760,4085,119973,"2020-07-01",2020
"20-Jul",경기,과천시,713,22330,612,23655,"2020-07-01",2020
"20-Jul",경기,광명시,306,102832,4252,107390,"2020-07-01",2020
"20-Jul",경기,광주시,389,187242,8421,196052,"2020-07-01",2020
"20-Jul",경기,구리시,265,70313,2627,73205,"2020-07-01",2020
"20-Jul",경기,군포시,304,98139,5188,103631,"2020-07-01",2020
"20-Jul",경기,김포시,490,209432,7472,217394,"2020-07-01",2020
"20-Jul",경기,남양주시,698,289440,8134,298272,"2020-07-01",2020
"20-Jul",경기,동두천시,212,37021,1324,38557,"2020-07-01",2020
"20-Jul",경기,부천시,701,293858,12720,307279,"2020-07-01",2020
"20-Jul",경기,성남시 분당구,368,183521,6866,190755,"2020-07-01",2020
"20-Jul",경기,성남시 수정구,366,73400,2455,76221,"2020-07-01",2020
"20-Jul",경기,성남시 중원구,339,71283,4043,75665,"2020-07-01",2020
"20-Jul",경기,수원시 권선구,502,184827,8518,193847,"2020-07-01",2020
"20-Jul",경기,수원시 영통구,223,146013,3258,149494,"2020-07-01",2020
"20-Jul",경기,수원시 장안구,468,101633,3821,105922,"2020-07-01",2020
"20-Jul",경기,수원시 팔달구,502,67884,2882,71268,"2020-07-01",2020
"20-Jul",경기,시흥시,464,233786,7546,241796,"2020-07-01",2020
"20-Jul",경기,안산시 단원구,566,152399,7888,160853,"2020-07-01",2020
"20-Jul",경기,안산시 상록구,178,138587,4871,143636,"2020-07-01",2020
"20-Jul",경기,안성시,393,100492,4978,105863,"2020-07-01",2020
"20-Jul",경기,안양시 동안구,416,115633,6262,122311,"2020-07-01",2020
"20-Jul",경기,안양시 만안구,146,83218,3916,87280,"2020-07-01",2020
"20-Jul",경기,양주시,384,104560,3183,108127,"2020-07-01",2020
"20-Jul",경기,양평군,564,58849,1811,61224,"2020-07-01",2020
"20-Jul",경기,여주시,445,61692,7497,69634,"2020-07-01",2020
"20-Jul",경기,연천군,306,23504,5330,29140,"2020-07-01",2020
"20-Jul",경기,오산시,217,103554,3367,107138,"2020-07-01",2020
"20-Jul",경기,용인시 기흥구,129,185825,6217,192171,"2020-07-01",2020
"20-Jul",경기,용인시 수지구,50,143103,2282,145435,"2020-07-01",2020
"20-Jul",경기,용인시 처인구,757,127888,7269,135914,"2020-07-01",2020
"20-Jul",경기,의왕시,291,63480,2991,66762,"2020-07-01",2020
"20-Jul",경기,의정부시,711,157549,5063,163323,"2020-07-01",2020
"20-Jul",경기,이천시,417,110611,5901,116929,"2020-07-01",2020
"20-Jul",경기,파주시,529,206250,10274,217053,"2020-07-01",2020
"20-Jul",경기,평택시,739,270268,11746,282753,"2020-07-01",2020
"20-Jul",경기,포천시,398,84110,9776,94284,"2020-07-01",2020
"20-Jul",경기,하남시,401,116729,2819,119949,"2020-07-01",2020
"20-Jul",경기,화성시,908,431717,11615,444240,"2020-07-01",2020
"20-Jul",경기,계,17712,5656321,229713,5903746,"2020-07-01",2020
"20-Jul",강원,강릉시,539,105977,4646,111162,"2020-07-01",2020
"20-Jul",강원,고성군,189,14081,230,14500,"2020-07-01",2020
"20-Jul",강원,동해시,308,44686,1418,46412,"2020-07-01",2020
"20-Jul",강원,삼척시,400,31957,746,33103,"2020-07-01",2020
"20-Jul",강원,속초시,307,37443,1381,39131,"2020-07-01",2020
"20-Jul",강원,양구군,185,11917,120,12222,"2020-07-01",2020
"20-Jul",강원,양양군,188,15526,278,15992,"2020-07-01",2020
"20-Jul",강원,영월군,334,20912,370,21616,"2020-07-01",2020
"20-Jul",강원,원주시,563,170538,5787,176888,"2020-07-01",2020
"20-Jul",강원,인제군,218,18024,288,18530,"2020-07-01",2020
"20-Jul",강원,정선군,335,20494,482,21311,"2020-07-01",2020
"20-Jul",강원,철원군,240,23855,318,24413,"2020-07-01",2020
"20-Jul",강원,춘천시,830,130281,5984,137095,"2020-07-01",2020
"20-Jul",강원,태백시,228,20029,739,20996,"2020-07-01",2020
"20-Jul",강원,평창군,296,25403,496,26195,"2020-07-01",2020
"20-Jul",강원,홍천군,427,38242,1054,39723,"2020-07-01",2020
"20-Jul",강원,화천군,232,12787,198,13217,"2020-07-01",2020
"20-Jul",강원,횡성군,251,26032,703,26986,"2020-07-01",2020
"20-Jul",강원,계,6070,768184,25238,799492,"2020-07-01",2020
"20-Jul",충북,괴산군,210,22238,389,22837,"2020-07-01",2020
"20-Jul",충북,단양군,217,15670,769,16656,"2020-07-01",2020
"20-Jul",충북,보은군,228,17767,905,18900,"2020-07-01",2020
"20-Jul",충북,영동군,250,24822,391,25463,"2020-07-01",2020
"20-Jul",충북,옥천군,201,26505,1124,27830,"2020-07-01",2020
"20-Jul",충북,음성군,233,58029,1861,60123,"2020-07-01",2020
"20-Jul",충북,제천시,335,66420,3476,70231,"2020-07-01",2020
"20-Jul",충북,증평군,92,19082,753,19927,"2020-07-01",2020
"20-Jul",충북,진천군,216,47725,1328,49269,"2020-07-01",2020
"20-Jul",충북,청원군,1,19,0,20,"2020-07-01",2020
"20-Jul",충북,청주시 상당구,511,86642,2567,89720,"2020-07-01",2020
"20-Jul",충북,청주시 서원구,240,95626,4985,100851,"2020-07-01",2020
"20-Jul",충북,청주시 청원구,355,101251,3973,105579,"2020-07-01",2020
"20-Jul",충북,청주시 흥덕구,366,126947,7301,134614,"2020-07-01",2020
"20-Jul",충북,충주시,588,107904,5725,114217,"2020-07-01",2020
"20-Jul",충북,계,4043,816647,35547,856237,"2020-07-01",2020
"20-Jul",충남,계룡시,149,21596,537,22282,"2020-07-01",2020
"20-Jul",충남,공주시,577,53347,2365,56289,"2020-07-01",2020
"20-Jul",충남,금산군,182,28407,2175,30764,"2020-07-01",2020
"20-Jul",충남,논산시,398,60505,2387,63290,"2020-07-01",2020
"20-Jul",충남,당진시,388,93608,3880,97876,"2020-07-01",2020
"20-Jul",충남,보령시,401,51903,1324,53628,"2020-07-01",2020
"20-Jul",충남,부여군,299,34095,1229,35623,"2020-07-01",2020
"20-Jul",충남,서산시,407,93152,3454,97013,"2020-07-01",2020
"20-Jul",충남,서천군,232,27033,893,28158,"2020-07-01",2020
"20-Jul",충남,아산시,510,162622,6357,169489,"2020-07-01",2020
"20-Jul",충남,예산군,405,42878,1396,44679,"2020-07-01",2020
"20-Jul",충남,천안시 동남구,249,129793,4817,134859,"2020-07-01",2020
"20-Jul",충남,천안시 서북구,548,192263,5573,198384,"2020-07-01",2020
"20-Jul",충남,청양군,246,16824,812,17882,"2020-07-01",2020
"20-Jul",충남,태안군,300,33819,519,34638,"2020-07-01",2020
"20-Jul",충남,홍성군,416,52171,1456,54043,"2020-07-01",2020
"20-Jul",충남,계,5707,1094016,39174,1138897,"2020-07-01",2020
"20-Jul",전북,고창군,290,30018,548,30856,"2020-07-01",2020
"20-Jul",전북,군산시,541,128503,6409,135453,"2020-07-01",2020
"20-Jul",전북,김제시,291,44836,1996,47123,"2020-07-01",2020
"20-Jul",전북,남원시,407,40381,4799,45587,"2020-07-01",2020
"20-Jul",전북,무주군,195,12594,390,13179,"2020-07-01",2020
"20-Jul",전북,부안군,261,27195,620,28076,"2020-07-01",2020
"20-Jul",전북,순창군,237,14512,163,14912,"2020-07-01",2020
"20-Jul",전북,완주군,401,50600,3175,54176,"2020-07-01",2020
"20-Jul",전북,익산시,522,135681,6045,142248,"2020-07-01",2020
"20-Jul",전북,임실군,207,14211,414,14832,"2020-07-01",2020
"20-Jul",전북,장수군,242,11987,171,12400,"2020-07-01",2020
"20-Jul",전북,전주시 덕진구,387,168569,7310,176266,"2020-07-01",2020
"20-Jul",전북,전주시 완산구,735,148908,4176,153819,"2020-07-01",2020
"20-Jul",전북,정읍시,345,53898,3693,57936,"2020-07-01",2020
"20-Jul",전북,진안군,250,13799,217,14266,"2020-07-01",2020
"20-Jul",전북,계,5311,895692,40126,941129,"2020-07-01",2020
"20-Jul",전남,강진군,238,18343,1118,19699,"2020-07-01",2020
"20-Jul",전남,고흥군,309,31408,624,32341,"2020-07-01",2020
"20-Jul",전남,곡성군,161,14501,711,15373,"2020-07-01",2020
"20-Jul",전남,광양시,246,81588,5936,87770,"2020-07-01",2020
"20-Jul",전남,구례군,141,13051,700,13892,"2020-07-01",2020
"20-Jul",전남,나주시,469,62808,3240,66517,"2020-07-01",2020
"20-Jul",전남,담양군,223,26149,1592,27964,"2020-07-01",2020
"20-Jul",전남,목포시,465,96563,5642,102670,"2020-07-01",2020
"20-Jul",전남,무안군,586,42690,1003,44279,"2020-07-01",2020
"20-Jul",전남,보성군,208,21306,31538,53052,"2020-07-01",2020
"20-Jul",전남,순천시,500,137878,5068,143446,"2020-07-01",2020
"20-Jul",전남,신안군,291,20765,32694,53750,"2020-07-01",2020
"20-Jul",전남,여수시,537,129949,7075,137561,"2020-07-01",2020
"20-Jul",전남,영광군,206,27339,733,28278,"2020-07-01",2020
"20-Jul",전남,영암군,261,33298,11020,44579,"2020-07-01",2020
"20-Jul",전남,완도군,245,25081,519,25845,"2020-07-01",2020
"20-Jul",전남,장성군,193,26480,1131,27804,"2020-07-01",2020
"20-Jul",전남,장흥군,212,19780,448,20440,"2020-07-01",2020
"20-Jul",전남,진도군,165,16411,294,16870,"2020-07-01",2020
"20-Jul",전남,함평군,196,17834,25025,43055,"2020-07-01",2020
"20-Jul",전남,해남군,354,38682,614,39650,"2020-07-01",2020
"20-Jul",전남,화순군,221,32079,2067,34367,"2020-07-01",2020
"20-Jul",전남,계,6427,933983,138792,1079202,"2020-07-01",2020
"20-Jul",경북,경산시,336,135460,4471,140267,"2020-07-01",2020
"20-Jul",경북,경주시,587,139382,4551,144520,"2020-07-01",2020
"20-Jul",경북,고령군,171,20292,517,20980,"2020-07-01",2020
"20-Jul",경북,구미시,531,211342,7201,219074,"2020-07-01",2020
"20-Jul",경북,군위군,130,14647,280,15057,"2020-07-01",2020
"20-Jul",경북,김천시,396,72735,1894,75025,"2020-07-01",2020
"20-Jul",경북,문경시,284,36038,847,37169,"2020-07-01",2020
"20-Jul",경북,봉화군,209,17757,197,18163,"2020-07-01",2020
"20-Jul",경북,상주시,381,52495,1824,54700,"2020-07-01",2020
"20-Jul",경북,성주군,203,29978,1375,31556,"2020-07-01",2020
"20-Jul",경북,안동시,741,81155,2603,84499,"2020-07-01",2020
"20-Jul",경북,영덕군,264,18740,300,19304,"2020-07-01",2020
"20-Jul",경북,영양군,140,9499,110,9749,"2020-07-01",2020
"20-Jul",경북,영주시,380,55007,1525,56912,"2020-07-01",2020
"20-Jul",경북,영천시,326,58891,2673,61890,"2020-07-01",2020
"20-Jul",경북,예천군,256,29135,489,29880,"2020-07-01",2020
"20-Jul",경북,울릉군,151,5076,505,5732,"2020-07-01",2020
"20-Jul",경북,울진군,323,25681,361,26365,"2020-07-01",2020
"20-Jul",경북,의성군,324,30195,966,31485,"2020-07-01",2020
"20-Jul",경북,청도군,220,24610,747,25577,"2020-07-01",2020
"20-Jul",경북,청송군,199,15317,208,15724,"2020-07-01",2020
"20-Jul",경북,칠곡군,312,67685,2289,70286,"2020-07-01",2020
"20-Jul",경북,포항시 남구,452,119192,8537,128181,"2020-07-01",2020
"20-Jul",경북,포항시 북구,356,137224,3820,141400,"2020-07-01",2020
"20-Jul",경북,계,7672,1407533,48290,1463495,"2020-07-01",2020
"20-Jul",경남,거제시,359,105054,2098,107511,"2020-07-01",2020
"20-Jul",경남,거창군,262,31712,812,32786,"2020-07-01",2020
"20-Jul",경남,고성군,226,26320,626,27172,"2020-07-01",2020
"20-Jul",경남,김해시,659,270825,7272,278756,"2020-07-01",2020
"20-Jul",경남,남해군,264,19433,469,20166,"2020-07-01",2020
"20-Jul",경남,밀양시,331,55115,3966,59412,"2020-07-01",2020
"20-Jul",경남,사천시,315,55618,1494,57427,"2020-07-01",2020
"20-Jul",경남,산청군,238,19836,799,20873,"2020-07-01",2020
"20-Jul",경남,양산시,413,162254,9975,172642,"2020-07-01",2020
"20-Jul",경남,의령군,204,14171,678,15053,"2020-07-01",2020
"20-Jul",경남,진주시,604,163339,6534,170477,"2020-07-01",2020
"20-Jul",경남,창녕군,239,35041,876,36156,"2020-07-01",2020
"20-Jul",경남,창원시 마산합포구,331,95644,2854,98829,"2020-07-01",2020
"20-Jul",경남,창원시 마산회원구,176,93838,4818,98832,"2020-07-01",2020
"20-Jul",경남,창원시 성산구,143,116560,4040,120743,"2020-07-01",2020
"20-Jul",경남,창원시 의창구,950,138835,25446,165231,"2020-07-01",2020
"20-Jul",경남,창원시 진해구,212,89623,1795,91630,"2020-07-01",2020
"20-Jul",경남,통영시,330,52250,1397,53977,"2020-07-01",2020
"20-Jul",경남,하동군,229,24216,413,24858,"2020-07-01",2020
"20-Jul",경남,함안군,195,40168,16310,56673,"2020-07-01",2020
"20-Jul",경남,함양군,219,19154,424,19797,"2020-07-01",2020
"20-Jul",경남,합천군,268,22972,641,23881,"2020-07-01",2020
"20-Jul",경남,계,7167,1651978,93737,1752882,"2020-07-01",2020
"20-Jul",제주,서귀포시,814,102362,1995,105171,"2020-07-01",2020
"20-Jul",제주,제주시,1649,273801,231704,507154,"2020-07-01",2020
"20-Jul",제주,계,2463,376163,233699,612325,"2020-07-01",2020
"20-Aug",서울,강남구,399,215949,18961,235309,"2020-08-01",2020
"20-Aug",서울,강동구,292,139021,8921,148234,"2020-08-01",2020
"20-Aug",서울,강북구,327,71325,4354,76006,"2020-08-01",2020
"20-Aug",서울,강서구,349,185166,19034,204549,"2020-08-01",2020
"20-Aug",서울,관악구,317,114142,5618,120077,"2020-08-01",2020
"20-Aug",서울,광진구,293,93049,5592,98934,"2020-08-01",2020
"20-Aug",서울,구로구,296,131795,12934,145025,"2020-08-01",2020
"20-Aug",서울,금천구,138,82192,5967,88297,"2020-08-01",2020
"20-Aug",서울,노원구,330,143127,9338,152795,"2020-08-01",2020
"20-Aug",서울,도봉구,269,88530,7384,96183,"2020-08-01",2020
"20-Aug",서울,동대문구,306,92788,5246,98340,"2020-08-01",2020
"20-Aug",서울,동작구,321,102823,2771,105915,"2020-08-01",2020
"20-Aug",서울,마포구,342,111678,6994,119014,"2020-08-01",2020
"20-Aug",서울,서대문구,462,82521,5948,88931,"2020-08-01",2020
"20-Aug",서울,서초구,540,167580,13008,181128,"2020-08-01",2020
"20-Aug",서울,성동구,350,93534,11398,105282,"2020-08-01",2020
"20-Aug",서울,성북구,291,114406,5455,120152,"2020-08-01",2020
"20-Aug",서울,송파구,388,230625,13223,244236,"2020-08-01",2020
"20-Aug",서울,양천구,319,142518,8729,151566,"2020-08-01",2020
"20-Aug",서울,영등포구,371,134526,9286,144183,"2020-08-01",2020
"20-Aug",서울,용산구,350,75054,1826,77230,"2020-08-01",2020
"20-Aug",서울,은평구,284,124559,7123,131966,"2020-08-01",2020
"20-Aug",서울,종로구,3828,44578,1710,50116,"2020-08-01",2020
"20-Aug",서울,중구,1270,45750,4014,51034,"2020-08-01",2020
"20-Aug",서울,중랑구,255,103715,9599,113569,"2020-08-01",2020
"20-Aug",서울,계,12687,2930951,204433,3148071,"2020-08-01",2020
"20-Aug",부산,강서구,315,74930,3519,78764,"2020-08-01",2020
"20-Aug",부산,금정구,285,80536,7771,88592,"2020-08-01",2020
"20-Aug",부산,기장군,263,76280,2504,79047,"2020-08-01",2020
"20-Aug",부산,남구,228,90896,8258,99382,"2020-08-01",2020
"20-Aug",부산,동구,185,46380,5000,51565,"2020-08-01",2020
"20-Aug",부산,동래구,175,92375,3895,96445,"2020-08-01",2020
"20-Aug",부산,부산진구,374,121546,18486,140406,"2020-08-01",2020
"20-Aug",부산,북구,236,100246,3439,103921,"2020-08-01",2020
"20-Aug",부산,사상구,285,83577,5953,89815,"2020-08-01",2020
"20-Aug",부산,사하구,266,107385,6791,114442,"2020-08-01",2020
"20-Aug",부산,서구,136,28373,1403,29912,"2020-08-01",2020
"20-Aug",부산,수영구,161,67245,32078,99484,"2020-08-01",2020
"20-Aug",부산,연제구,955,89038,10044,100037,"2020-08-01",2020
"20-Aug",부산,영도구,231,30823,2057,33111,"2020-08-01",2020
"20-Aug",부산,중구,313,27223,7023,34559,"2020-08-01",2020
"20-Aug",부산,해운대구,318,164413,12589,177320,"2020-08-01",2020
"20-Aug",부산,계,4726,1281266,130810,1416802,"2020-08-01",2020
"20-Aug",대구,남구,351,55828,1726,57905,"2020-08-01",2020
"20-Aug",대구,달서구,532,270147,14500,285179,"2020-08-01",2020
"20-Aug",대구,달성군,523,131841,5002,137366,"2020-08-01",2020
"20-Aug",대구,동구,351,152278,11318,163947,"2020-08-01",2020
"20-Aug",대구,북구,514,199894,7609,208017,"2020-08-01",2020
"20-Aug",대구,서구,242,69449,3722,73413,"2020-08-01",2020
"20-Aug",대구,수성구,575,214477,5379,220431,"2020-08-01",2020
"20-Aug",대구,중구,305,62952,2390,65647,"2020-08-01",2020
"20-Aug",대구,계,3393,1156866,51646,1211905,"2020-08-01",2020
"20-Aug",인천,강화군,333,34217,42521,77071,"2020-08-01",2020
"20-Aug",인천,계양구,284,119182,197096,316562,"2020-08-01",2020
"20-Aug",인천,남동구,858,253237,51733,305828,"2020-08-01",2020
"20-Aug",인천,동구,93,25342,4380,29815,"2020-08-01",2020
"20-Aug",인천,미추홀구,418,157184,10916,168518,"2020-08-01",2020
"20-Aug",인천,부평구,345,214043,19056,233444,"2020-08-01",2020
"20-Aug",인천,서구,431,238391,10994,249816,"2020-08-01",2020
"20-Aug",인천,연수구,406,185794,8060,194260,"2020-08-01",2020
"20-Aug",인천,옹진군,212,11889,205,12306,"2020-08-01",2020
"20-Aug",인천,중구,687,63334,15517,79538,"2020-08-01",2020
"20-Aug",인천,계,4067,1302613,360478,1667158,"2020-08-01",2020
"20-Aug",광주,광산구,511,193050,12304,205865,"2020-08-01",2020
"20-Aug",광주,남구,209,89559,2721,92489,"2020-08-01",2020
"20-Aug",광주,동구,241,40320,1229,41790,"2020-08-01",2020
"20-Aug",광주,북구,604,188238,9200,198042,"2020-08-01",2020
"20-Aug",광주,서구,646,141390,6785,148821,"2020-08-01",2020
"20-Aug",광주,계,2211,652557,32239,687007,"2020-08-01",2020
"20-Aug",대전,대덕구,234,84154,6719,91107,"2020-08-01",2020
"20-Aug",대전,동구,251,88897,4402,93550,"2020-08-01",2020
"20-Aug",대전,서구,804,205556,7383,213743,"2020-08-01",2020
"20-Aug",대전,유성구,377,176516,4807,181700,"2020-08-01",2020
"20-Aug",대전,중구,238,96594,5883,102715,"2020-08-01",2020
"20-Aug",대전,계,1904,651717,29194,682815,"2020-08-01",2020
"20-Aug",울산,남구,714,153316,7429,161459,"2020-08-01",2020
"20-Aug",울산,동구,193,61597,1051,62841,"2020-08-01",2020
"20-Aug",울산,북구,182,112597,3903,116682,"2020-08-01",2020
"20-Aug",울산,울주군,387,121918,6740,129045,"2020-08-01",2020
"20-Aug",울산,중구,344,100259,2515,103118,"2020-08-01",2020
"20-Aug",울산,계,1820,549687,21638,573145,"2020-08-01",2020
"20-Aug",세종,세종특별자치시,772,165864,2790,169426,"2020-08-01",2020
"20-Aug",세종,계,772,165864,2790,169426,"2020-08-01",2020
"20-Aug",경기,가평군,375,30369,597,31341,"2020-08-01",2020
"20-Aug",경기,고양시 덕양구,674,175143,4044,179861,"2020-08-01",2020
"20-Aug",경기,고양시 일산동구,280,122350,5722,128352,"2020-08-01",2020
"20-Aug",경기,고양시 일산서구,130,115602,4085,119817,"2020-08-01",2020
"20-Aug",경기,과천시,720,22454,614,23788,"2020-08-01",2020
"20-Aug",경기,광명시,305,102116,4275,106696,"2020-08-01",2020
"20-Aug",경기,광주시,387,187599,8407,196393,"2020-08-01",2020
"20-Aug",경기,구리시,263,70244,2647,73154,"2020-08-01",2020
"20-Aug",경기,군포시,303,98158,5124,103585,"2020-08-01",2020
"20-Aug",경기,김포시,489,212018,7646,220153,"2020-08-01",2020
"20-Aug",경기,남양주시,695,290091,8144,298930,"2020-08-01",2020
"20-Aug",경기,동두천시,212,37108,1404,38724,"2020-08-01",2020
"20-Aug",경기,부천시,698,293270,12561,306529,"2020-08-01",2020
"20-Aug",경기,성남시 분당구,366,183355,6867,190588,"2020-08-01",2020
"20-Aug",경기,성남시 수정구,360,74984,2469,77813,"2020-08-01",2020
"20-Aug",경기,성남시 중원구,340,70937,4053,75330,"2020-08-01",2020
"20-Aug",경기,수원시 권선구,501,184068,8548,193117,"2020-08-01",2020
"20-Aug",경기,수원시 영통구,223,146179,3243,149645,"2020-08-01",2020
"20-Aug",경기,수원시 장안구,470,101509,3816,105795,"2020-08-01",2020
"20-Aug",경기,수원시 팔달구,499,67979,2871,71349,"2020-08-01",2020
"20-Aug",경기,시흥시,463,235760,7553,243776,"2020-08-01",2020
"20-Aug",경기,안산시 단원구,562,152430,7859,160851,"2020-08-01",2020
"20-Aug",경기,안산시 상록구,178,138796,4874,143848,"2020-08-01",2020
"20-Aug",경기,안성시,390,101221,5038,106649,"2020-08-01",2020
"20-Aug",경기,안양시 동안구,415,115446,6235,122096,"2020-08-01",2020
"20-Aug",경기,안양시 만안구,148,83194,3906,87248,"2020-08-01",2020
"20-Aug",경기,양주시,383,105252,3129,108764,"2020-08-01",2020
"20-Aug",경기,양평군,563,59023,1812,61398,"2020-08-01",2020
"20-Aug",경기,여주시,444,61888,7493,69825,"2020-08-01",2020
"20-Aug",경기,연천군,304,23492,5325,29121,"2020-08-01",2020
"20-Aug",경기,오산시,211,104048,3408,107667,"2020-08-01",2020
"20-Aug",경기,용인시 기흥구,128,185667,6226,192021,"2020-08-01",2020
"20-Aug",경기,용인시 수지구,50,143286,2368,145704,"2020-08-01",2020
"20-Aug",경기,용인시 처인구,751,128183,7282,136216,"2020-08-01",2020
"20-Aug",경기,의왕시,291,63424,2998,66713,"2020-08-01",2020
"20-Aug",경기,의정부시,729,158225,4986,163940,"2020-08-01",2020
"20-Aug",경기,이천시,413,110926,5881,117220,"2020-08-01",2020
"20-Aug",경기,파주시,527,207485,10232,218244,"2020-08-01",2020
"20-Aug",경기,평택시,742,271443,11845,284030,"2020-08-01",2020
"20-Aug",경기,포천시,398,84280,9647,94325,"2020-08-01",2020
"20-Aug",경기,하남시,402,117444,2857,120703,"2020-08-01",2020
"20-Aug",경기,화성시,909,433810,11610,446329,"2020-08-01",2020
"20-Aug",경기,계,17691,5670256,229701,5917648,"2020-08-01",2020
"20-Aug",강원,강릉시,534,106126,4587,111247,"2020-08-01",2020
"20-Aug",강원,고성군,191,14113,230,14534,"2020-08-01",2020
"20-Aug",강원,동해시,307,44734,1418,46459,"2020-08-01",2020
"20-Aug",강원,삼척시,395,31927,753,33075,"2020-08-01",2020
"20-Aug",강원,속초시,308,37584,1377,39269,"2020-08-01",2020
"20-Aug",강원,양구군,185,11904,118,12207,"2020-08-01",2020
"20-Aug",강원,양양군,187,15566,306,16059,"2020-08-01",2020
"20-Aug",강원,영월군,333,20912,366,21611,"2020-08-01",2020
"20-Aug",강원,원주시,564,170989,5770,177323,"2020-08-01",2020
"20-Aug",강원,인제군,215,18105,285,18605,"2020-08-01",2020
"20-Aug",강원,정선군,337,20521,477,21335,"2020-08-01",2020
"20-Aug",강원,철원군,237,23886,319,24442,"2020-08-01",2020
"20-Aug",강원,춘천시,824,130611,5990,137425,"2020-08-01",2020
"20-Aug",강원,태백시,224,20047,740,21011,"2020-08-01",2020
"20-Aug",강원,평창군,295,25443,495,26233,"2020-08-01",2020
"20-Aug",강원,홍천군,426,38287,1048,39761,"2020-08-01",2020
"20-Aug",강원,화천군,231,12854,197,13282,"2020-08-01",2020
"20-Aug",강원,횡성군,253,26153,703,27109,"2020-08-01",2020
"20-Aug",강원,계,6046,769762,25179,800987,"2020-08-01",2020
"20-Aug",충북,괴산군,209,22323,399,22931,"2020-08-01",2020
"20-Aug",충북,단양군,220,15657,765,16642,"2020-08-01",2020
"20-Aug",충북,보은군,228,17813,952,18993,"2020-08-01",2020
"20-Aug",충북,영동군,250,24885,390,25525,"2020-08-01",2020
"20-Aug",충북,옥천군,205,26543,1122,27870,"2020-08-01",2020
"20-Aug",충북,음성군,234,58200,1864,60298,"2020-08-01",2020
"20-Aug",충북,제천시,334,66396,3469,70199,"2020-08-01",2020
"20-Aug",충북,증평군,91,19122,756,19969,"2020-08-01",2020
"20-Aug",충북,진천군,219,47863,1331,49413,"2020-08-01",2020
"20-Aug",충북,청원군,1,19,0,20,"2020-08-01",2020
"20-Aug",충북,청주시 상당구,513,86892,2571,89976,"2020-08-01",2020
"20-Aug",충북,청주시 서원구,239,95506,4312,100057,"2020-08-01",2020
"20-Aug",충북,청주시 청원구,353,101177,3980,105510,"2020-08-01",2020
"20-Aug",충북,청주시 흥덕구,364,127129,8003,135496,"2020-08-01",2020
"20-Aug",충북,충주시,589,108137,5812,114538,"2020-08-01",2020
"20-Aug",충북,계,4049,817662,35726,857437,"2020-08-01",2020
"20-Aug",충남,계룡시,149,21659,534,22342,"2020-08-01",2020
"20-Aug",충남,공주시,574,53519,2307,56400,"2020-08-01",2020
"20-Aug",충남,금산군,184,28448,2204,30836,"2020-08-01",2020
"20-Aug",충남,논산시,401,60567,2386,63354,"2020-08-01",2020
"20-Aug",충남,당진시,388,93782,3871,98041,"2020-08-01",2020
"20-Aug",충남,보령시,405,51962,1330,53697,"2020-08-01",2020
"20-Aug",충남,부여군,298,34066,1232,35596,"2020-08-01",2020
"20-Aug",충남,서산시,408,93401,3459,97268,"2020-08-01",2020
"20-Aug",충남,서천군,233,27049,888,28170,"2020-08-01",2020
"20-Aug",충남,아산시,516,163194,6380,170090,"2020-08-01",2020
"20-Aug",충남,예산군,409,42900,1396,44705,"2020-08-01",2020
"20-Aug",충남,천안시 동남구,271,129678,4824,134773,"2020-08-01",2020
"20-Aug",충남,천안시 서북구,526,192384,5539,198449,"2020-08-01",2020
"20-Aug",충남,청양군,247,16808,810,17865,"2020-08-01",2020
"20-Aug",충남,태안군,301,33885,518,34704,"2020-08-01",2020
"20-Aug",충남,홍성군,417,52244,1458,54119,"2020-08-01",2020
"20-Aug",충남,계,5727,1095546,39136,1140409,"2020-08-01",2020
"20-Aug",전북,고창군,287,30049,558,30894,"2020-08-01",2020
"20-Aug",전북,군산시,546,128565,6417,135528,"2020-08-01",2020
"20-Aug",전북,김제시,288,44883,1989,47160,"2020-08-01",2020
"20-Aug",전북,남원시,403,40401,4756,45560,"2020-08-01",2020
"20-Aug",전북,무주군,190,12594,393,13177,"2020-08-01",2020
"20-Aug",전북,부안군,261,27224,615,28100,"2020-08-01",2020
"20-Aug",전북,순창군,235,14498,168,14901,"2020-08-01",2020
"20-Aug",전북,완주군,397,50708,3168,54273,"2020-08-01",2020
"20-Aug",전북,익산시,515,135772,6029,142316,"2020-08-01",2020
"20-Aug",전북,임실군,211,14175,414,14800,"2020-08-01",2020
"20-Aug",전북,장수군,242,11975,173,12390,"2020-08-01",2020
"20-Aug",전북,전주시 덕진구,387,168345,7272,176004,"2020-08-01",2020
"20-Aug",전북,전주시 완산구,743,149458,4180,154381,"2020-08-01",2020
"20-Aug",전북,정읍시,344,53994,3722,58060,"2020-08-01",2020
"20-Aug",전북,진안군,245,13826,221,14292,"2020-08-01",2020
"20-Aug",전북,계,5294,896467,40075,941836,"2020-08-01",2020
"20-Aug",전남,강진군,242,18371,1120,19733,"2020-08-01",2020
"20-Aug",전남,고흥군,311,31467,620,32398,"2020-08-01",2020
"20-Aug",전남,곡성군,161,14529,710,15400,"2020-08-01",2020
"20-Aug",전남,광양시,246,81365,5924,87535,"2020-08-01",2020
"20-Aug",전남,구례군,141,12875,696,13712,"2020-08-01",2020
"20-Aug",전남,나주시,467,62981,3189,66637,"2020-08-01",2020
"20-Aug",전남,담양군,224,26077,1594,27895,"2020-08-01",2020
"20-Aug",전남,목포시,462,96114,5639,102215,"2020-08-01",2020
"20-Aug",전남,무안군,583,43540,1014,45137,"2020-08-01",2020
"20-Aug",전남,보성군,208,21310,30575,52093,"2020-08-01",2020
"20-Aug",전남,순천시,501,138109,5113,143723,"2020-08-01",2020
"20-Aug",전남,신안군,289,20814,35673,56776,"2020-08-01",2020
"20-Aug",전남,여수시,545,130015,7060,137620,"2020-08-01",2020
"20-Aug",전남,영광군,208,27341,764,28313,"2020-08-01",2020
"20-Aug",전남,영암군,261,33311,10686,44258,"2020-08-01",2020
"20-Aug",전남,완도군,246,25101,516,25863,"2020-08-01",2020
"20-Aug",전남,장성군,193,26444,1120,27757,"2020-08-01",2020
"20-Aug",전남,장흥군,214,19803,446,20463,"2020-08-01",2020
"20-Aug",전남,진도군,164,16423,292,16879,"2020-08-01",2020
"20-Aug",전남,함평군,200,17825,24996,43021,"2020-08-01",2020
"20-Aug",전남,해남군,361,38694,615,39670,"2020-08-01",2020
"20-Aug",전남,화순군,221,32160,2088,34469,"2020-08-01",2020
"20-Aug",전남,계,6448,934669,140450,1081567,"2020-08-01",2020
"20-Aug",경북,경산시,330,134938,4450,139718,"2020-08-01",2020
"20-Aug",경북,경주시,582,139577,4568,144727,"2020-08-01",2020
"20-Aug",경북,고령군,171,20286,514,20971,"2020-08-01",2020
"20-Aug",경북,구미시,520,211305,7219,219044,"2020-08-01",2020
"20-Aug",경북,군위군,126,14669,280,15075,"2020-08-01",2020
"20-Aug",경북,김천시,394,72971,1895,75260,"2020-08-01",2020
"20-Aug",경북,문경시,283,36026,852,37161,"2020-08-01",2020
"20-Aug",경북,봉화군,208,17770,195,18173,"2020-08-01",2020
"20-Aug",경북,상주시,382,52598,1825,54805,"2020-08-01",2020
"20-Aug",경북,성주군,201,30022,1354,31577,"2020-08-01",2020
"20-Aug",경북,안동시,727,81233,2605,84565,"2020-08-01",2020
"20-Aug",경북,영덕군,260,18761,301,19322,"2020-08-01",2020
"20-Aug",경북,영양군,140,9482,111,9733,"2020-08-01",2020
"20-Aug",경북,영주시,378,55053,1532,56963,"2020-08-01",2020
"20-Aug",경북,영천시,316,59047,2677,62040,"2020-08-01",2020
"20-Aug",경북,예천군,254,29116,487,29857,"2020-08-01",2020
"20-Aug",경북,울릉군,151,5101,506,5758,"2020-08-01",2020
"20-Aug",경북,울진군,318,25739,359,26416,"2020-08-01",2020
"20-Aug",경북,의성군,319,30273,962,31554,"2020-08-01",2020
"20-Aug",경북,청도군,222,24645,749,25616,"2020-08-01",2020
"20-Aug",경북,청송군,201,15337,204,15742,"2020-08-01",2020
"20-Aug",경북,칠곡군,307,67660,2294,70261,"2020-08-01",2020
"20-Aug",경북,포항시 남구,460,119182,8534,128176,"2020-08-01",2020
"20-Aug",경북,포항시 북구,339,137476,3817,141632,"2020-08-01",2020
"20-Aug",경북,계,7589,1408267,48290,1464146,"2020-08-01",2020
"20-Aug",경남,거제시,358,105219,2092,107669,"2020-08-01",2020
"20-Aug",경남,거창군,264,31749,810,32823,"2020-08-01",2020
"20-Aug",경남,고성군,226,26317,618,27161,"2020-08-01",2020
"20-Aug",경남,김해시,659,271186,7283,279128,"2020-08-01",2020
"20-Aug",경남,남해군,262,19482,468,20212,"2020-08-01",2020
"20-Aug",경남,밀양시,332,55202,3976,59510,"2020-08-01",2020
"20-Aug",경남,사천시,312,55786,1496,57594,"2020-08-01",2020
"20-Aug",경남,산청군,240,19866,791,20897,"2020-08-01",2020
"20-Aug",경남,양산시,399,162403,9960,172762,"2020-08-01",2020
"20-Aug",경남,의령군,202,14191,707,15100,"2020-08-01",2020
"20-Aug",경남,진주시,613,163355,6507,170475,"2020-08-01",2020
"20-Aug",경남,창녕군,237,35062,884,36183,"2020-08-01",2020
"20-Aug",경남,창원시 마산합포구,330,95513,2839,98682,"2020-08-01",2020
"20-Aug",경남,창원시 마산회원구,176,93803,4794,98773,"2020-08-01",2020
"20-Aug",경남,창원시 성산구,143,115647,4013,119803,"2020-08-01",2020
"20-Aug",경남,창원시 의창구,940,139181,25997,166118,"2020-08-01",2020
"20-Aug",경남,창원시 진해구,211,89817,1798,91826,"2020-08-01",2020
"20-Aug",경남,통영시,329,52276,1398,54003,"2020-08-01",2020
"20-Aug",경남,하동군,225,24113,408,24746,"2020-08-01",2020
"20-Aug",경남,함안군,196,40193,16607,56996,"2020-08-01",2020
"20-Aug",경남,함양군,219,19210,420,19849,"2020-08-01",2020
"20-Aug",경남,합천군,265,22972,636,23873,"2020-08-01",2020
"20-Aug",경남,계,7138,1652543,94502,1754183,"2020-08-01",2020
"20-Aug",제주,서귀포시,808,102641,1994,105443,"2020-08-01",2020
"20-Aug",제주,제주시,1637,274703,234085,510425,"2020-08-01",2020
"20-Aug",제주,계,2445,377344,236079,615868,"2020-08-01",2020
"20-Sep",서울,강남구,402,215896,19118,235416,"2020-09-01",2020
"20-Sep",서울,강동구,296,139507,8911,148714,"2020-09-01",2020
"20-Sep",서울,강북구,326,71310,4355,75991,"2020-09-01",2020
"20-Sep",서울,강서구,345,185334,18950,204629,"2020-09-01",2020
"20-Sep",서울,관악구,321,114027,5583,119931,"2020-09-01",2020
"20-Sep",서울,광진구,297,93027,5570,98894,"2020-09-01",2020
"20-Sep",서울,구로구,295,132099,12946,145340,"2020-09-01",2020
"20-Sep",서울,금천구,138,82252,5938,88328,"2020-09-01",2020
"20-Sep",서울,노원구,325,143044,9266,152635,"2020-09-01",2020
"20-Sep",서울,도봉구,276,88479,7370,96125,"2020-09-01",2020
"20-Sep",서울,동대문구,305,92840,4951,98096,"2020-09-01",2020
"20-Sep",서울,동작구,318,102716,2762,105796,"2020-09-01",2020
"20-Sep",서울,마포구,346,111840,6947,119133,"2020-09-01",2020
"20-Sep",서울,서대문구,464,82866,5893,89223,"2020-09-01",2020
"20-Sep",서울,서초구,545,167267,13112,180924,"2020-09-01",2020
"20-Sep",서울,성동구,347,93776,11290,105413,"2020-09-01",2020
"20-Sep",서울,성북구,295,114466,5461,120222,"2020-09-01",2020
"20-Sep",서울,송파구,394,232020,13190,245604,"2020-09-01",2020
"20-Sep",서울,양천구,321,142555,8710,151586,"2020-09-01",2020
"20-Sep",서울,영등포구,372,134927,9308,144607,"2020-09-01",2020
"20-Sep",서울,용산구,349,75531,2074,77954,"2020-09-01",2020
"20-Sep",서울,은평구,288,124669,7123,132080,"2020-09-01",2020
"20-Sep",서울,종로구,3834,44637,1707,50178,"2020-09-01",2020
"20-Sep",서울,중구,1272,45789,4094,51155,"2020-09-01",2020
"20-Sep",서울,중랑구,257,104086,9525,113868,"2020-09-01",2020
"20-Sep",서울,계,12728,2934960,204154,3151842,"2020-09-01",2020
"20-Sep",부산,강서구,316,75851,3589,79756,"2020-09-01",2020
"20-Sep",부산,금정구,282,80531,7767,88580,"2020-09-01",2020
"20-Sep",부산,기장군,261,76853,2502,79616,"2020-09-01",2020
"20-Sep",부산,남구,230,90955,8232,99417,"2020-09-01",2020
"20-Sep",부산,동구,184,46566,4999,51749,"2020-09-01",2020
"20-Sep",부산,동래구,172,92445,3881,96498,"2020-09-01",2020
"20-Sep",부산,부산진구,378,121743,18751,140872,"2020-09-01",2020
"20-Sep",부산,북구,234,100192,3463,103889,"2020-09-01",2020
"20-Sep",부산,사상구,288,83541,5963,89792,"2020-09-01",2020
"20-Sep",부산,사하구,261,107218,6795,114274,"2020-09-01",2020
"20-Sep",부산,서구,138,28344,1402,29884,"2020-09-01",2020
"20-Sep",부산,수영구,163,67321,32369,99853,"2020-09-01",2020
"20-Sep",부산,연제구,938,89317,10283,100538,"2020-09-01",2020
"20-Sep",부산,영도구,230,30786,2042,33058,"2020-09-01",2020
"20-Sep",부산,중구,310,27445,7017,34772,"2020-09-01",2020
"20-Sep",부산,해운대구,313,164652,12546,177511,"2020-09-01",2020
"20-Sep",부산,계,4698,1283760,131601,1420059,"2020-09-01",2020
"20-Sep",대구,남구,352,55843,1704,57899,"2020-09-01",2020
"20-Sep",대구,달서구,502,270825,14522,285849,"2020-09-01",2020
"20-Sep",대구,달성군,537,132241,5020,137798,"2020-09-01",2020
"20-Sep",대구,동구,362,152951,11250,164563,"2020-09-01",2020
"20-Sep",대구,북구,507,201006,7625,209138,"2020-09-01",2020
"20-Sep",대구,서구,245,69529,3737,73511,"2020-09-01",2020
"20-Sep",대구,수성구,577,214818,5391,220786,"2020-09-01",2020
"20-Sep",대구,중구,304,64507,2370,67181,"2020-09-01",2020
"20-Sep",대구,계,3386,1161720,51619,1216725,"2020-09-01",2020
"20-Sep",인천,강화군,328,34323,42116,76767,"2020-09-01",2020
"20-Sep",인천,계양구,287,119126,197124,316537,"2020-09-01",2020
"20-Sep",인천,남동구,847,252599,51805,305251,"2020-09-01",2020
"20-Sep",인천,동구,93,25170,4496,29759,"2020-09-01",2020
"20-Sep",인천,미추홀구,423,157519,10665,168607,"2020-09-01",2020
"20-Sep",인천,부평구,350,214122,19864,234336,"2020-09-01",2020
"20-Sep",인천,서구,435,238914,11081,250430,"2020-09-01",2020
"20-Sep",인천,연수구,410,187604,8073,196087,"2020-09-01",2020
"20-Sep",인천,옹진군,214,11913,205,12332,"2020-09-01",2020
"20-Sep",인천,중구,691,63545,13428,77664,"2020-09-01",2020
"20-Sep",인천,계,4078,1304835,358857,1667770,"2020-09-01",2020
"20-Sep",광주,광산구,508,193701,12324,206533,"2020-09-01",2020
"20-Sep",광주,남구,209,89743,2725,92677,"2020-09-01",2020
"20-Sep",광주,동구,241,41236,1242,42719,"2020-09-01",2020
"20-Sep",광주,북구,617,188370,9222,198209,"2020-09-01",2020
"20-Sep",광주,서구,644,141779,6770,149193,"2020-09-01",2020
"20-Sep",광주,계,2219,654829,32283,689331,"2020-09-01",2020
"20-Sep",대전,대덕구,235,84707,6746,91688,"2020-09-01",2020
"20-Sep",대전,동구,251,89065,4420,93736,"2020-09-01",2020
"20-Sep",대전,서구,803,206062,7393,214258,"2020-09-01",2020
"20-Sep",대전,유성구,382,177207,4837,182426,"2020-09-01",2020
"20-Sep",대전,중구,236,96814,5876,102926,"2020-09-01",2020
"20-Sep",대전,계,1907,653855,29272,685034,"2020-09-01",2020
"20-Sep",울산,남구,713,153347,7417,161477,"2020-09-01",2020
"20-Sep",울산,동구,194,61586,1052,62832,"2020-09-01",2020
"20-Sep",울산,북구,182,112869,3893,116944,"2020-09-01",2020
"20-Sep",울산,울주군,387,122125,6762,129274,"2020-09-01",2020
"20-Sep",울산,중구,346,100187,2513,103046,"2020-09-01",2020
"20-Sep",울산,계,1822,550114,21637,573573,"2020-09-01",2020
"20-Sep",세종,세종특별자치시,773,166572,2799,170144,"2020-09-01",2020
"20-Sep",세종,계,773,166572,2799,170144,"2020-09-01",2020
"20-Sep",경기,가평군,381,30489,574,31444,"2020-09-01",2020
"20-Sep",경기,고양시 덕양구,677,175558,4056,180291,"2020-09-01",2020
"20-Sep",경기,고양시 일산동구,282,122474,5700,128456,"2020-09-01",2020
"20-Sep",경기,고양시 일산서구,129,115786,4158,120073,"2020-09-01",2020
"20-Sep",경기,과천시,722,22516,617,23855,"2020-09-01",2020
"20-Sep",경기,광명시,304,101422,4274,106000,"2020-09-01",2020
"20-Sep",경기,광주시,394,188618,8351,197363,"2020-09-01",2020
"20-Sep",경기,구리시,262,70255,2646,73163,"2020-09-01",2020
"20-Sep",경기,군포시,300,98136,5120,103556,"2020-09-01",2020
"20-Sep",경기,김포시,492,214746,7657,222895,"2020-09-01",2020
"20-Sep",경기,남양주시,703,290889,8190,299782,"2020-09-01",2020
"20-Sep",경기,동두천시,214,37213,1404,38831,"2020-09-01",2020
"20-Sep",경기,부천시,704,293610,12509,306823,"2020-09-01",2020
"20-Sep",경기,성남시 분당구,370,183215,6869,190454,"2020-09-01",2020
"20-Sep",경기,성남시 수정구,362,76236,2492,79090,"2020-09-01",2020
"20-Sep",경기,성남시 중원구,340,70827,4061,75228,"2020-09-01",2020
"20-Sep",경기,수원시 권선구,502,186323,8574,195399,"2020-09-01",2020
"20-Sep",경기,수원시 영통구,225,146463,3228,149916,"2020-09-01",2020
"20-Sep",경기,수원시 장안구,468,101621,3807,105896,"2020-09-01",2020
"20-Sep",경기,수원시 팔달구,495,68056,2867,71418,"2020-09-01",2020
"20-Sep",경기,시흥시,465,238097,7618,246180,"2020-09-01",2020
"20-Sep",경기,안산시 단원구,558,152946,7806,161310,"2020-09-01",2020
"20-Sep",경기,안산시 상록구,178,139240,4883,144301,"2020-09-01",2020
"20-Sep",경기,안성시,392,101706,5033,107131,"2020-09-01",2020
"20-Sep",경기,안양시 동안구,410,115172,6278,121860,"2020-09-01",2020
"20-Sep",경기,안양시 만안구,151,83348,3884,87383,"2020-09-01",2020
"20-Sep",경기,양주시,389,105692,3139,109220,"2020-09-01",2020
"20-Sep",경기,양평군,565,59149,1814,61528,"2020-09-01",2020
"20-Sep",경기,여주시,446,62036,7506,69988,"2020-09-01",2020
"20-Sep",경기,연천군,306,23531,5284,29121,"2020-09-01",2020
"20-Sep",경기,오산시,210,105187,3421,108818,"2020-09-01",2020
"20-Sep",경기,용인시 기흥구,126,186293,6206,192625,"2020-09-01",2020
"20-Sep",경기,용인시 수지구,51,143690,2379,146120,"2020-09-01",2020
"20-Sep",경기,용인시 처인구,756,128578,7303,136637,"2020-09-01",2020
"20-Sep",경기,의왕시,287,63948,3005,67240,"2020-09-01",2020
"20-Sep",경기,의정부시,727,159317,4988,165032,"2020-09-01",2020
"20-Sep",경기,이천시,414,111309,5903,117626,"2020-09-01",2020
"20-Sep",경기,파주시,530,208837,10394,219761,"2020-09-01",2020
"20-Sep",경기,평택시,745,273212,11927,285884,"2020-09-01",2020
"20-Sep",경기,포천시,411,84571,10438,95420,"2020-09-01",2020
"20-Sep",경기,하남시,400,118335,2862,121597,"2020-09-01",2020
"20-Sep",경기,화성시,937,436281,11618,448836,"2020-09-01",2020
"20-Sep",경기,계,17780,5694928,230843,5943551,"2020-09-01",2020
"20-Sep",강원,강릉시,537,106485,4574,111596,"2020-09-01",2020
"20-Sep",강원,고성군,191,14110,228,14529,"2020-09-01",2020
"20-Sep",강원,동해시,310,44870,1425,46605,"2020-09-01",2020
"20-Sep",강원,삼척시,398,31958,746,33102,"2020-09-01",2020
"20-Sep",강원,속초시,309,37694,1373,39376,"2020-09-01",2020
"20-Sep",강원,양구군,190,11890,117,12197,"2020-09-01",2020
"20-Sep",강원,양양군,187,15600,299,16086,"2020-09-01",2020
"20-Sep",강원,영월군,333,20994,350,21677,"2020-09-01",2020
"20-Sep",강원,원주시,571,171328,5756,177655,"2020-09-01",2020
"20-Sep",강원,인제군,217,18166,284,18667,"2020-09-01",2020
"20-Sep",강원,정선군,336,20589,479,21404,"2020-09-01",2020
"20-Sep",강원,철원군,239,23945,318,24502,"2020-09-01",2020
"20-Sep",강원,춘천시,825,131099,5998,137922,"2020-09-01",2020
"20-Sep",강원,태백시,225,20037,739,21001,"2020-09-01",2020
"20-Sep",강원,평창군,297,25498,499,26294,"2020-09-01",2020
"20-Sep",강원,홍천군,433,38445,1049,39927,"2020-09-01",2020
"20-Sep",강원,화천군,229,12928,193,13350,"2020-09-01",2020
"20-Sep",강원,횡성군,256,26378,707,27341,"2020-09-01",2020
"20-Sep",강원,계,6083,772014,25134,803231,"2020-09-01",2020
"20-Sep",충북,괴산군,211,22355,399,22965,"2020-09-01",2020
"20-Sep",충북,단양군,224,15654,771,16649,"2020-09-01",2020
"20-Sep",충북,보은군,231,17874,967,19072,"2020-09-01",2020
"20-Sep",충북,영동군,253,24908,394,25555,"2020-09-01",2020
"20-Sep",충북,옥천군,206,26614,1126,27946,"2020-09-01",2020
"20-Sep",충북,음성군,236,58119,1873,60228,"2020-09-01",2020
"20-Sep",충북,제천시,337,66643,3456,70436,"2020-09-01",2020
"20-Sep",충북,증평군,92,19099,756,19947,"2020-09-01",2020
"20-Sep",충북,진천군,218,48139,1339,49696,"2020-09-01",2020
"20-Sep",충북,청원군,1,19,0,20,"2020-09-01",2020
"20-Sep",충북,청주시 상당구,521,87635,2582,90738,"2020-09-01",2020
"20-Sep",충북,청주시 서원구,240,95420,4322,99982,"2020-09-01",2020
"20-Sep",충북,청주시 청원구,350,101692,3974,106016,"2020-09-01",2020
"20-Sep",충북,청주시 흥덕구,363,127402,7989,135754,"2020-09-01",2020
"20-Sep",충북,충주시,591,108521,5919,115031,"2020-09-01",2020
"20-Sep",충북,계,4074,820094,35867,860035,"2020-09-01",2020
"20-Sep",충남,계룡시,151,21730,534,22415,"2020-09-01",2020
"20-Sep",충남,공주시,577,53609,2368,56554,"2020-09-01",2020
"20-Sep",충남,금산군,182,28509,2214,30905,"2020-09-01",2020
"20-Sep",충남,논산시,403,60699,2387,63489,"2020-09-01",2020
"20-Sep",충남,당진시,394,94102,3860,98356,"2020-09-01",2020
"20-Sep",충남,보령시,404,51973,1327,53704,"2020-09-01",2020
"20-Sep",충남,부여군,299,34092,1237,35628,"2020-09-01",2020
"20-Sep",충남,서산시,410,93511,3438,97359,"2020-09-01",2020
"20-Sep",충남,서천군,236,27041,889,28166,"2020-09-01",2020
"20-Sep",충남,아산시,519,163958,6352,170829,"2020-09-01",2020
"20-Sep",충남,예산군,406,42862,1385,44653,"2020-09-01",2020
"20-Sep",충남,천안시 동남구,272,130029,4865,135166,"2020-09-01",2020
"20-Sep",충남,천안시 서북구,534,193309,5513,199356,"2020-09-01",2020
"20-Sep",충남,청양군,248,16802,801,17851,"2020-09-01",2020
"20-Sep",충남,태안군,302,34032,517,34851,"2020-09-01",2020
"20-Sep",충남,홍성군,420,52235,1458,54113,"2020-09-01",2020
"20-Sep",충남,계,5757,1098493,39145,1143395,"2020-09-01",2020
"20-Sep",전북,고창군,289,30105,558,30952,"2020-09-01",2020
"20-Sep",전북,군산시,550,128952,6419,135921,"2020-09-01",2020
"20-Sep",전북,김제시,287,44879,2034,47200,"2020-09-01",2020
"20-Sep",전북,남원시,401,40468,4735,45604,"2020-09-01",2020
"20-Sep",전북,무주군,191,12630,394,13215,"2020-09-01",2020
"20-Sep",전북,부안군,262,27241,615,28118,"2020-09-01",2020
"20-Sep",전북,순창군,238,14512,168,14918,"2020-09-01",2020
"20-Sep",전북,완주군,399,50801,3169,54369,"2020-09-01",2020
"20-Sep",전북,익산시,514,135784,5989,142287,"2020-09-01",2020
"20-Sep",전북,임실군,217,14175,412,14804,"2020-09-01",2020
"20-Sep",전북,장수군,245,12004,174,12423,"2020-09-01",2020
"20-Sep",전북,전주시 덕진구,384,168746,7291,176421,"2020-09-01",2020
"20-Sep",전북,전주시 완산구,742,150010,4186,154938,"2020-09-01",2020
"20-Sep",전북,정읍시,349,54187,3726,58262,"2020-09-01",2020
"20-Sep",전북,진안군,244,13866,220,14330,"2020-09-01",2020
"20-Sep",전북,계,5312,898360,40090,943762,"2020-09-01",2020
"20-Sep",전남,강진군,245,18375,1112,19732,"2020-09-01",2020
"20-Sep",전남,고흥군,316,31540,622,32478,"2020-09-01",2020
"20-Sep",전남,곡성군,158,14571,720,15449,"2020-09-01",2020
"20-Sep",전남,광양시,246,81456,5916,87618,"2020-09-01",2020
"20-Sep",전남,구례군,137,12954,696,13787,"2020-09-01",2020
"20-Sep",전남,나주시,471,63201,3254,66926,"2020-09-01",2020
"20-Sep",전남,담양군,221,26177,1558,27956,"2020-09-01",2020
"20-Sep",전남,목포시,439,95647,5637,101723,"2020-09-01",2020
"20-Sep",전남,무안군,578,44380,1013,45971,"2020-09-01",2020
"20-Sep",전남,보성군,209,21329,29358,50896,"2020-09-01",2020
"20-Sep",전남,순천시,499,138452,5134,144085,"2020-09-01",2020
"20-Sep",전남,신안군,311,20845,38499,59655,"2020-09-01",2020
"20-Sep",전남,여수시,536,130173,7061,137770,"2020-09-01",2020
"20-Sep",전남,영광군,211,27377,774,28362,"2020-09-01",2020
"20-Sep",전남,영암군,267,33285,10348,43900,"2020-09-01",2020
"20-Sep",전남,완도군,247,25162,514,25923,"2020-09-01",2020
"20-Sep",전남,장성군,197,26502,1101,27800,"2020-09-01",2020
"20-Sep",전남,장흥군,216,19837,447,20500,"2020-09-01",2020
"20-Sep",전남,진도군,167,16480,293,16940,"2020-09-01",2020
"20-Sep",전남,함평군,201,17870,26903,44974,"2020-09-01",2020
"20-Sep",전남,해남군,369,38835,621,39825,"2020-09-01",2020
"20-Sep",전남,화순군,222,32282,2062,34566,"2020-09-01",2020
"20-Sep",전남,계,6463,936730,143643,1086836,"2020-09-01",2020
"20-Sep",경북,경산시,329,135144,4428,139901,"2020-09-01",2020
"20-Sep",경북,경주시,586,139518,4576,144680,"2020-09-01",2020
"20-Sep",경북,고령군,171,20306,519,20996,"2020-09-01",2020
"20-Sep",경북,구미시,523,211696,7235,219454,"2020-09-01",2020
"20-Sep",경북,군위군,126,14681,281,15088,"2020-09-01",2020
"20-Sep",경북,김천시,394,73203,1903,75500,"2020-09-01",2020
"20-Sep",경북,문경시,284,36137,849,37270,"2020-09-01",2020
"20-Sep",경북,봉화군,209,17776,197,18182,"2020-09-01",2020
"20-Sep",경북,상주시,385,52581,1829,54795,"2020-09-01",2020
"20-Sep",경북,성주군,200,30083,1352,31635,"2020-09-01",2020
"20-Sep",경북,안동시,730,81405,2619,84754,"2020-09-01",2020
"20-Sep",경북,영덕군,262,18784,303,19349,"2020-09-01",2020
"20-Sep",경북,영양군,142,9533,111,9786,"2020-09-01",2020
"20-Sep",경북,영주시,372,55162,1528,57062,"2020-09-01",2020
"20-Sep",경북,영천시,311,59127,2677,62115,"2020-09-01",2020
"20-Sep",경북,예천군,261,29180,484,29925,"2020-09-01",2020
"20-Sep",경북,울릉군,151,5106,508,5765,"2020-09-01",2020
"20-Sep",경북,울진군,321,25792,361,26474,"2020-09-01",2020
"20-Sep",경북,의성군,319,30381,970,31670,"2020-09-01",2020
"20-Sep",경북,청도군,222,24691,747,25660,"2020-09-01",2020
"20-Sep",경북,청송군,199,15365,207,15771,"2020-09-01",2020
"20-Sep",경북,칠곡군,305,67791,2287,70383,"2020-09-01",2020
"20-Sep",경북,포항시 남구,462,119296,8522,128280,"2020-09-01",2020
"20-Sep",경북,포항시 북구,335,137922,3814,142071,"2020-09-01",2020
"20-Sep",경북,계,7599,1410660,48307,1466566,"2020-09-01",2020
"20-Sep",경남,거제시,356,105355,2092,107803,"2020-09-01",2020
"20-Sep",경남,거창군,270,31822,807,32899,"2020-09-01",2020
"20-Sep",경남,고성군,226,26314,670,27210,"2020-09-01",2020
"20-Sep",경남,김해시,657,271722,7288,279667,"2020-09-01",2020
"20-Sep",경남,남해군,267,19512,469,20248,"2020-09-01",2020
"20-Sep",경남,밀양시,334,55304,3979,59617,"2020-09-01",2020
"20-Sep",경남,사천시,316,55948,1503,57767,"2020-09-01",2020
"20-Sep",경남,산청군,244,19913,793,20950,"2020-09-01",2020
"20-Sep",경남,양산시,397,163003,9993,173393,"2020-09-01",2020
"20-Sep",경남,의령군,203,14234,702,15139,"2020-09-01",2020
"20-Sep",경남,진주시,621,163602,6482,170705,"2020-09-01",2020
"20-Sep",경남,창녕군,236,35100,880,36216,"2020-09-01",2020
"20-Sep",경남,창원시 마산합포구,332,95510,2869,98711,"2020-09-01",2020
"20-Sep",경남,창원시 마산회원구,176,94173,4772,99121,"2020-09-01",2020
"20-Sep",경남,창원시 성산구,143,116182,3639,119964,"2020-09-01",2020
"20-Sep",경남,창원시 의창구,939,139604,26890,167433,"2020-09-01",2020
"20-Sep",경남,창원시 진해구,213,89953,1809,91975,"2020-09-01",2020
"20-Sep",경남,통영시,327,52308,1402,54037,"2020-09-01",2020
"20-Sep",경남,하동군,230,24059,405,24694,"2020-09-01",2020
"20-Sep",경남,함안군,199,40202,17275,57676,"2020-09-01",2020
"20-Sep",경남,함양군,224,19251,423,19898,"2020-09-01",2020
"20-Sep",경남,합천군,270,22951,632,23853,"2020-09-01",2020
"20-Sep",경남,계,7180,1656022,95774,1758976,"2020-09-01",2020
"20-Sep",제주,서귀포시,815,102950,2003,105768,"2020-09-01",2020
"20-Sep",제주,제주시,1650,275876,237268,514794,"2020-09-01",2020
"20-Sep",제주,계,2465,378826,239271,620562,"2020-09-01",2020
"20-Oct",서울,강남구,400,216615,18990,236005,"2020-10-01",2020
"20-Oct",서울,강동구,294,140008,8935,149237,"2020-10-01",2020
"20-Oct",서울,강북구,325,71294,4368,75987,"2020-10-01",2020
"20-Oct",서울,강서구,338,185362,18880,204580,"2020-10-01",2020
"20-Oct",서울,관악구,320,113893,5574,119787,"2020-10-01",2020
"20-Oct",서울,광진구,297,93102,5604,99003,"2020-10-01",2020
"20-Oct",서울,구로구,297,132203,12896,145396,"2020-10-01",2020
"20-Oct",서울,금천구,139,82286,5930,88355,"2020-10-01",2020
"20-Oct",서울,노원구,328,142986,9253,152567,"2020-10-01",2020
"20-Oct",서울,도봉구,282,88402,7417,96101,"2020-10-01",2020
"20-Oct",서울,동대문구,306,92862,4981,98149,"2020-10-01",2020
"20-Oct",서울,동작구,316,102611,2759,105686,"2020-10-01",2020
"20-Oct",서울,마포구,344,111863,6983,119190,"2020-10-01",2020
"20-Oct",서울,서대문구,461,82977,5897,89335,"2020-10-01",2020
"20-Oct",서울,서초구,545,167194,12857,180596,"2020-10-01",2020
"20-Oct",서울,성동구,346,93644,11238,105228,"2020-10-01",2020
"20-Oct",서울,성북구,293,114597,5480,120370,"2020-10-01",2020
"20-Oct",서울,송파구,397,232216,13125,245738,"2020-10-01",2020
"20-Oct",서울,양천구,320,142576,8698,151594,"2020-10-01",2020
"20-Oct",서울,영등포구,378,135415,9239,145032,"2020-10-01",2020
"20-Oct",서울,용산구,341,76021,2047,78409,"2020-10-01",2020
"20-Oct",서울,은평구,292,124784,7121,132197,"2020-10-01",2020
"20-Oct",서울,종로구,3806,44648,1704,50158,"2020-10-01",2020
"20-Oct",서울,중구,1270,45713,4097,51080,"2020-10-01",2020
"20-Oct",서울,중랑구,257,104156,9539,113952,"2020-10-01",2020
"20-Oct",서울,계,12692,2937428,203612,3153732,"2020-10-01",2020
"20-Oct",부산,강서구,313,76601,3601,80515,"2020-10-01",2020
"20-Oct",부산,금정구,280,80582,7782,88644,"2020-10-01",2020
"20-Oct",부산,기장군,258,77281,2503,80042,"2020-10-01",2020
"20-Oct",부산,남구,230,90973,8182,99385,"2020-10-01",2020
"20-Oct",부산,동구,184,46702,4998,51884,"2020-10-01",2020
"20-Oct",부산,동래구,172,92434,3884,96490,"2020-10-01",2020
"20-Oct",부산,부산진구,376,122181,19057,141614,"2020-10-01",2020
"20-Oct",부산,북구,275,100175,3456,103906,"2020-10-01",2020
"20-Oct",부산,사상구,287,83445,5956,89688,"2020-10-01",2020
"20-Oct",부산,사하구,261,107010,6783,114054,"2020-10-01",2020
"20-Oct",부산,서구,140,28620,1402,30162,"2020-10-01",2020
"20-Oct",부산,수영구,161,67338,32786,100285,"2020-10-01",2020
"20-Oct",부산,연제구,934,89743,10397,101074,"2020-10-01",2020
"20-Oct",부산,영도구,229,30812,2020,33061,"2020-10-01",2020
"20-Oct",부산,중구,309,27658,7024,34991,"2020-10-01",2020
"20-Oct",부산,해운대구,315,164588,12517,177420,"2020-10-01",2020
"20-Oct",부산,계,4724,1286143,132348,1423215,"2020-10-01",2020
"20-Oct",대구,남구,350,55663,1675,57688,"2020-10-01",2020
"20-Oct",대구,달서구,515,270317,14438,285270,"2020-10-01",2020
"20-Oct",대구,달성군,540,132133,4997,137670,"2020-10-01",2020
"20-Oct",대구,동구,364,152472,11217,164053,"2020-10-01",2020
"20-Oct",대구,북구,504,201019,7561,209084,"2020-10-01",2020
"20-Oct",대구,서구,245,69365,3728,73338,"2020-10-01",2020
"20-Oct",대구,수성구,581,214542,5240,220363,"2020-10-01",2020
"20-Oct",대구,중구,304,65682,2537,68523,"2020-10-01",2020
"20-Oct",대구,계,3403,1161193,51393,1215989,"2020-10-01",2020
"20-Oct",인천,강화군,327,34373,41113,75813,"2020-10-01",2020
"20-Oct",인천,계양구,285,119320,198115,317720,"2020-10-01",2020
"20-Oct",인천,남동구,833,252172,52024,305029,"2020-10-01",2020
"20-Oct",인천,동구,92,24964,4608,29664,"2020-10-01",2020
"20-Oct",인천,미추홀구,422,157848,10601,168871,"2020-10-01",2020
"20-Oct",인천,부평구,347,214533,20451,235331,"2020-10-01",2020
"20-Oct",인천,서구,431,239134,11106,250671,"2020-10-01",2020
"20-Oct",인천,연수구,412,189185,8112,197709,"2020-10-01",2020
"20-Oct",인천,옹진군,214,11972,206,12392,"2020-10-01",2020
"20-Oct",인천,중구,741,63651,13425,77817,"2020-10-01",2020
"20-Oct",인천,계,4104,1307152,359761,1671017,"2020-10-01",2020
"20-Oct",광주,광산구,506,193801,12342,206649,"2020-10-01",2020
"20-Oct",광주,남구,209,89840,2730,92779,"2020-10-01",2020
"20-Oct",광주,동구,235,41859,1266,43360,"2020-10-01",2020
"20-Oct",광주,북구,623,188372,9200,198195,"2020-10-01",2020
"20-Oct",광주,서구,637,141582,6764,148983,"2020-10-01",2020
"20-Oct",광주,계,2210,655454,32302,689966,"2020-10-01",2020
"20-Oct",대전,대덕구,235,85219,6782,92236,"2020-10-01",2020
"20-Oct",대전,동구,250,88888,4586,93724,"2020-10-01",2020
"20-Oct",대전,서구,800,205533,7380,213713,"2020-10-01",2020
"20-Oct",대전,유성구,382,177294,4833,182509,"2020-10-01",2020
"20-Oct",대전,중구,233,96627,5784,102644,"2020-10-01",2020
"20-Oct",대전,계,1900,653561,29365,684826,"2020-10-01",2020
"20-Oct",울산,남구,709,153300,7415,161424,"2020-10-01",2020
"20-Oct",울산,동구,188,61545,1059,62792,"2020-10-01",2020
"20-Oct",울산,북구,184,113103,3897,117184,"2020-10-01",2020
"20-Oct",울산,울주군,382,122281,6813,129476,"2020-10-01",2020
"20-Oct",울산,중구,343,100123,2506,102972,"2020-10-01",2020
"20-Oct",울산,계,1806,550352,21690,573848,"2020-10-01",2020
"20-Oct",세종,세종특별자치시,767,168189,2835,171791,"2020-10-01",2020
"20-Oct",세종,계,767,168189,2835,171791,"2020-10-01",2020
"20-Oct",경기,가평군,376,30513,574,31463,"2020-10-01",2020
"20-Oct",경기,고양시 덕양구,679,176222,4053,180954,"2020-10-01",2020
"20-Oct",경기,고양시 일산동구,282,122630,5670,128582,"2020-10-01",2020
"20-Oct",경기,고양시 일산서구,129,115947,4182,120258,"2020-10-01",2020
"20-Oct",경기,과천시,718,22595,616,23929,"2020-10-01",2020
"20-Oct",경기,광명시,303,100718,4279,105300,"2020-10-01",2020
"20-Oct",경기,광주시,389,189174,8390,197953,"2020-10-01",2020
"20-Oct",경기,구리시,262,70331,2648,73241,"2020-10-01",2020
"20-Oct",경기,군포시,300,98185,5145,103630,"2020-10-01",2020
"20-Oct",경기,김포시,489,216608,7711,224808,"2020-10-01",2020
"20-Oct",경기,남양주시,708,291930,8226,300864,"2020-10-01",2020
"20-Oct",경기,동두천시,214,37261,1399,38874,"2020-10-01",2020
"20-Oct",경기,부천시,699,293895,12514,307108,"2020-10-01",2020
"20-Oct",경기,성남시 분당구,375,183194,6922,190491,"2020-10-01",2020
"20-Oct",경기,성남시 수정구,362,76760,2504,79626,"2020-10-01",2020
"20-Oct",경기,성남시 중원구,341,70811,4054,75206,"2020-10-01",2020
"20-Oct",경기,수원시 권선구,500,187573,8639,196712,"2020-10-01",2020
"20-Oct",경기,수원시 영통구,223,146601,3223,150047,"2020-10-01",2020
"20-Oct",경기,수원시 장안구,465,101543,3803,105811,"2020-10-01",2020
"20-Oct",경기,수원시 팔달구,503,68129,2890,71522,"2020-10-01",2020
"20-Oct",경기,시흥시,457,239670,7627,247754,"2020-10-01",2020
"20-Oct",경기,안산시 단원구,558,153733,8140,162431,"2020-10-01",2020
"20-Oct",경기,안산시 상록구,174,139380,4898,144452,"2020-10-01",2020
"20-Oct",경기,안성시,391,102409,5028,107828,"2020-10-01",2020
"20-Oct",경기,안양시 동안구,410,115124,6309,121843,"2020-10-01",2020
"20-Oct",경기,안양시 만안구,149,83403,3899,87451,"2020-10-01",2020
"20-Oct",경기,양주시,387,106201,3145,109733,"2020-10-01",2020
"20-Oct",경기,양평군,564,59355,1819,61738,"2020-10-01",2020
"20-Oct",경기,여주시,446,62118,7524,70088,"2020-10-01",2020
"20-Oct",경기,연천군,310,23604,5290,29204,"2020-10-01",2020
"20-Oct",경기,오산시,210,105463,3428,109101,"2020-10-01",2020
"20-Oct",경기,용인시 기흥구,127,186839,6206,193172,"2020-10-01",2020
"20-Oct",경기,용인시 수지구,51,143901,2385,146337,"2020-10-01",2020
"20-Oct",경기,용인시 처인구,754,128921,7324,136999,"2020-10-01",2020
"20-Oct",경기,의왕시,288,64227,2960,67475,"2020-10-01",2020
"20-Oct",경기,의정부시,728,160111,5023,165862,"2020-10-01",2020
"20-Oct",경기,이천시,406,111658,5925,117989,"2020-10-01",2020
"20-Oct",경기,파주시,534,209998,10398,220930,"2020-10-01",2020
"20-Oct",경기,평택시,736,275232,12034,288002,"2020-10-01",2020
"20-Oct",경기,포천시,413,84630,10338,95381,"2020-10-01",2020
"20-Oct",경기,하남시,400,119098,2854,122352,"2020-10-01",2020
"20-Oct",경기,화성시,931,438172,11754,450857,"2020-10-01",2020
"20-Oct",경기,계,17741,5713867,231750,5963358,"2020-10-01",2020
"20-Oct",강원,강릉시,532,106801,4542,111875,"2020-10-01",2020
"20-Oct",강원,고성군,187,14135,225,14547,"2020-10-01",2020
"20-Oct",강원,동해시,311,45010,1429,46750,"2020-10-01",2020
"20-Oct",강원,삼척시,404,31999,750,33153,"2020-10-01",2020
"20-Oct",강원,속초시,308,37811,1385,39504,"2020-10-01",2020
"20-Oct",강원,양구군,193,11897,118,12208,"2020-10-01",2020
"20-Oct",강원,양양군,186,15689,299,16174,"2020-10-01",2020
"20-Oct",강원,영월군,332,21061,350,21743,"2020-10-01",2020
"20-Oct",강원,원주시,566,171763,5718,178047,"2020-10-01",2020
"20-Oct",강원,인제군,219,18210,284,18713,"2020-10-01",2020
"20-Oct",강원,정선군,338,20617,480,21435,"2020-10-01",2020
"20-Oct",강원,철원군,238,23987,316,24541,"2020-10-01",2020
"20-Oct",강원,춘천시,817,131583,5998,138398,"2020-10-01",2020
"20-Oct",강원,태백시,224,20054,740,21018,"2020-10-01",2020
"20-Oct",강원,평창군,293,25570,501,26364,"2020-10-01",2020
"20-Oct",강원,홍천군,431,38560,1044,40035,"2020-10-01",2020
"20-Oct",강원,화천군,228,12957,194,13379,"2020-10-01",2020
"20-Oct",강원,횡성군,260,26342,711,27313,"2020-10-01",2020
"20-Oct",강원,계,6067,774046,25084,805197,"2020-10-01",2020
"20-Oct",충북,괴산군,210,22445,404,23059,"2020-10-01",2020
"20-Oct",충북,단양군,225,15656,780,16661,"2020-10-01",2020
"20-Oct",충북,보은군,230,17908,1005,19143,"2020-10-01",2020
"20-Oct",충북,영동군,250,24891,391,25532,"2020-10-01",2020
"20-Oct",충북,옥천군,203,26684,1128,28015,"2020-10-01",2020
"20-Oct",충북,음성군,236,58071,1875,60182,"2020-10-01",2020
"20-Oct",충북,제천시,339,66728,3457,70524,"2020-10-01",2020
"20-Oct",충북,증평군,88,19128,755,19971,"2020-10-01",2020
"20-Oct",충북,진천군,216,48664,1341,50221,"2020-10-01",2020
"20-Oct",충북,청원군,1,19,0,20,"2020-10-01",2020
"20-Oct",충북,청주시 상당구,516,88985,2591,92092,"2020-10-01",2020
"20-Oct",충북,청주시 서원구,238,95159,4297,99694,"2020-10-01",2020
"20-Oct",충북,청주시 청원구,347,101647,3975,105969,"2020-10-01",2020
"20-Oct",충북,청주시 흥덕구,365,127507,8008,135880,"2020-10-01",2020
"20-Oct",충북,충주시,584,108570,6043,115197,"2020-10-01",2020
"20-Oct",충북,계,4048,822062,36050,862160,"2020-10-01",2020
"20-Oct",충남,계룡시,151,21781,535,22467,"2020-10-01",2020
"20-Oct",충남,공주시,571,53563,2405,56539,"2020-10-01",2020
"20-Oct",충남,금산군,181,28537,2220,30938,"2020-10-01",2020
"20-Oct",충남,논산시,398,60785,2379,63562,"2020-10-01",2020
"20-Oct",충남,당진시,395,94054,3861,98310,"2020-10-01",2020
"20-Oct",충남,보령시,405,51996,1334,53735,"2020-10-01",2020
"20-Oct",충남,부여군,296,34129,1211,35636,"2020-10-01",2020
"20-Oct",충남,서산시,410,93863,3421,97694,"2020-10-01",2020
"20-Oct",충남,서천군,236,27063,886,28185,"2020-10-01",2020
"20-Oct",충남,아산시,521,164246,6462,171229,"2020-10-01",2020
"20-Oct",충남,예산군,402,42927,1384,44713,"2020-10-01",2020
"20-Oct",충남,천안시 동남구,269,130275,4898,135442,"2020-10-01",2020
"20-Oct",충남,천안시 서북구,535,193870,5504,199909,"2020-10-01",2020
"20-Oct",충남,청양군,248,16773,805,17826,"2020-10-01",2020
"20-Oct",충남,태안군,299,34086,546,34931,"2020-10-01",2020
"20-Oct",충남,홍성군,423,52287,1459,54169,"2020-10-01",2020
"20-Oct",충남,계,5740,1100235,39310,1145285,"2020-10-01",2020
"20-Oct",전북,고창군,289,30235,555,31079,"2020-10-01",2020
"20-Oct",전북,군산시,543,129262,6392,136197,"2020-10-01",2020
"20-Oct",전북,김제시,288,44944,2022,47254,"2020-10-01",2020
"20-Oct",전북,남원시,400,40617,4682,45699,"2020-10-01",2020
"20-Oct",전북,무주군,194,12681,393,13268,"2020-10-01",2020
"20-Oct",전북,부안군,264,27238,614,28116,"2020-10-01",2020
"20-Oct",전북,순창군,239,14492,156,14887,"2020-10-01",2020
"20-Oct",전북,완주군,400,50796,3175,54371,"2020-10-01",2020
"20-Oct",전북,익산시,513,135786,5970,142269,"2020-10-01",2020
"20-Oct",전북,임실군,216,14186,418,14820,"2020-10-01",2020
"20-Oct",전북,장수군,242,12019,171,12432,"2020-10-01",2020
"20-Oct",전북,전주시 덕진구,378,169388,7291,177057,"2020-10-01",2020
"20-Oct",전북,전주시 완산구,744,150375,4203,155322,"2020-10-01",2020
"20-Oct",전북,정읍시,340,53997,3697,58034,"2020-10-01",2020
"20-Oct",전북,진안군,236,13894,218,14348,"2020-10-01",2020
"20-Oct",전북,계,5286,899910,39957,945153,"2020-10-01",2020
"20-Oct",전남,강진군,220,18427,1109,19756,"2020-10-01",2020
"20-Oct",전남,고흥군,315,31626,622,32563,"2020-10-01",2020
"20-Oct",전남,곡성군,158,14596,711,15465,"2020-10-01",2020
"20-Oct",전남,광양시,246,81533,5922,87701,"2020-10-01",2020
"20-Oct",전남,구례군,136,12956,701,13793,"2020-10-01",2020
"20-Oct",전남,나주시,470,63512,3262,67244,"2020-10-01",2020
"20-Oct",전남,담양군,217,26167,1565,27949,"2020-10-01",2020
"20-Oct",전남,목포시,435,95549,5618,101602,"2020-10-01",2020
"20-Oct",전남,무안군,566,44790,1016,46372,"2020-10-01",2020
"20-Oct",전남,보성군,213,21366,28093,49672,"2020-10-01",2020
"20-Oct",전남,순천시,499,138968,5126,144593,"2020-10-01",2020
"20-Oct",전남,신안군,308,20900,40605,61813,"2020-10-01",2020
"20-Oct",전남,여수시,531,130308,7076,137915,"2020-10-01",2020
"20-Oct",전남,영광군,208,27492,780,28480,"2020-10-01",2020
"20-Oct",전남,영암군,269,33235,10041,43545,"2020-10-01",2020
"20-Oct",전남,완도군,244,25266,513,26023,"2020-10-01",2020
"20-Oct",전남,장성군,197,26455,1113,27765,"2020-10-01",2020
"20-Oct",전남,장흥군,240,19877,447,20564,"2020-10-01",2020
"20-Oct",전남,진도군,166,16495,293,16954,"2020-10-01",2020
"20-Oct",전남,함평군,202,17941,26801,44944,"2020-10-01",2020
"20-Oct",전남,해남군,361,39008,626,39995,"2020-10-01",2020
"20-Oct",전남,화순군,221,32315,2086,34622,"2020-10-01",2020
"20-Oct",전남,계,6422,938782,144126,1089330,"2020-10-01",2020
"20-Oct",경북,경산시,324,135466,4440,140230,"2020-10-01",2020
"20-Oct",경북,경주시,587,139730,4560,144877,"2020-10-01",2020
"20-Oct",경북,고령군,170,20325,657,21152,"2020-10-01",2020
"20-Oct",경북,구미시,541,212016,7226,219783,"2020-10-01",2020
"20-Oct",경북,군위군,126,14735,283,15144,"2020-10-01",2020
"20-Oct",경북,김천시,391,73305,1903,75599,"2020-10-01",2020
"20-Oct",경북,문경시,285,36276,844,37405,"2020-10-01",2020
"20-Oct",경북,봉화군,206,17868,197,18271,"2020-10-01",2020
"20-Oct",경북,상주시,381,52723,1831,54935,"2020-10-01",2020
"20-Oct",경북,성주군,199,30211,1355,31765,"2020-10-01",2020
"20-Oct",경북,안동시,723,81562,2616,84901,"2020-10-01",2020
"20-Oct",경북,영덕군,259,18776,304,19339,"2020-10-01",2020
"20-Oct",경북,영양군,142,9563,112,9817,"2020-10-01",2020
"20-Oct",경북,영주시,366,55170,1529,57065,"2020-10-01",2020
"20-Oct",경북,영천시,310,59240,2575,62125,"2020-10-01",2020
"20-Oct",경북,예천군,259,29253,484,29996,"2020-10-01",2020
"20-Oct",경북,울릉군,150,5149,507,5806,"2020-10-01",2020
"20-Oct",경북,울진군,315,25870,362,26547,"2020-10-01",2020
"20-Oct",경북,의성군,316,30468,971,31755,"2020-10-01",2020
"20-Oct",경북,청도군,221,24707,745,25673,"2020-10-01",2020
"20-Oct",경북,청송군,199,15454,207,15860,"2020-10-01",2020
"20-Oct",경북,칠곡군,303,67824,2292,70419,"2020-10-01",2020
"20-Oct",경북,포항시 남구,459,119537,8507,128503,"2020-10-01",2020
"20-Oct",경북,포항시 북구,331,138270,3808,142409,"2020-10-01",2020
"20-Oct",경북,계,7563,1413498,48315,1469376,"2020-10-01",2020
"20-Oct",경남,거제시,371,105543,2090,108004,"2020-10-01",2020
"20-Oct",경남,거창군,265,31852,812,32929,"2020-10-01",2020
"20-Oct",경남,고성군,226,26298,629,27153,"2020-10-01",2020
"20-Oct",경남,김해시,650,272237,7272,280159,"2020-10-01",2020
"20-Oct",경남,남해군,267,19554,473,20294,"2020-10-01",2020
"20-Oct",경남,밀양시,326,55297,3998,59621,"2020-10-01",2020
"20-Oct",경남,사천시,313,55982,1508,57803,"2020-10-01",2020
"20-Oct",경남,산청군,242,19943,784,20969,"2020-10-01",2020
"20-Oct",경남,양산시,397,163154,9997,173548,"2020-10-01",2020
"20-Oct",경남,의령군,202,14261,708,15171,"2020-10-01",2020
"20-Oct",경남,진주시,613,163730,6477,170820,"2020-10-01",2020
"20-Oct",경남,창녕군,234,35215,878,36327,"2020-10-01",2020
"20-Oct",경남,창원시 마산합포구,331,95404,2875,98610,"2020-10-01",2020
"20-Oct",경남,창원시 마산회원구,176,94425,4695,99296,"2020-10-01",2020
"20-Oct",경남,창원시 성산구,143,116288,3781,120212,"2020-10-01",2020
"20-Oct",경남,창원시 의창구,935,139991,27836,168762,"2020-10-01",2020
"20-Oct",경남,창원시 진해구,210,90049,1809,92068,"2020-10-01",2020
"20-Oct",경남,통영시,326,52351,1407,54084,"2020-10-01",2020
"20-Oct",경남,하동군,226,24008,403,24637,"2020-10-01",2020
"20-Oct",경남,함안군,194,40263,17889,58346,"2020-10-01",2020
"20-Oct",경남,함양군,222,19303,424,19949,"2020-10-01",2020
"20-Oct",경남,합천군,265,22993,631,23889,"2020-10-01",2020
"20-Oct",경남,계,7134,1658141,97376,1762651,"2020-10-01",2020
"20-Oct",제주,서귀포시,816,102937,2008,105761,"2020-10-01",2020
"20-Oct",제주,제주시,1657,276527,240107,518291,"2020-10-01",2020
"20-Oct",제주,계,2473,379464,242115,624052,"2020-10-01",2020
"20-Nov",서울,강남구,396,216922,18894,236212,"2020-11-01",2020
"20-Nov",서울,강동구,292,140296,8961,149549,"2020-11-01",2020
"20-Nov",서울,강북구,317,71268,4303,75888,"2020-11-01",2020
"20-Nov",서울,강서구,335,185631,18895,204861,"2020-11-01",2020
"20-Nov",서울,관악구,321,113768,5579,119668,"2020-11-01",2020
"20-Nov",서울,광진구,295,93120,5738,99153,"2020-11-01",2020
"20-Nov",서울,구로구,296,132334,12940,145570,"2020-11-01",2020
"20-Nov",서울,금천구,137,82328,5923,88388,"2020-11-01",2020
"20-Nov",서울,노원구,328,143084,9306,152718,"2020-11-01",2020
"20-Nov",서울,도봉구,278,88408,7398,96084,"2020-11-01",2020
"20-Nov",서울,동대문구,309,92899,5001,98209,"2020-11-01",2020
"20-Nov",서울,동작구,315,102586,2806,105707,"2020-11-01",2020
"20-Nov",서울,마포구,340,111968,6994,119302,"2020-11-01",2020
"20-Nov",서울,서대문구,459,83041,5878,89378,"2020-11-01",2020
"20-Nov",서울,서초구,550,167585,12696,180831,"2020-11-01",2020
"20-Nov",서울,성동구,340,93795,11268,105403,"2020-11-01",2020
"20-Nov",서울,성북구,293,114670,5503,120466,"2020-11-01",2020
"20-Nov",서울,송파구,397,232342,13111,245850,"2020-11-01",2020
"20-Nov",서울,양천구,315,142652,8702,151669,"2020-11-01",2020
"20-Nov",서울,영등포구,377,136068,9208,145653,"2020-11-01",2020
"20-Nov",서울,용산구,342,76517,2039,78898,"2020-11-01",2020
"20-Nov",서울,은평구,297,124934,7115,132346,"2020-11-01",2020
"20-Nov",서울,종로구,3874,44669,1709,50252,"2020-11-01",2020
"20-Nov",서울,중구,1264,45755,4095,51114,"2020-11-01",2020
"20-Nov",서울,중랑구,255,104322,9532,114109,"2020-11-01",2020
"20-Nov",서울,계,12722,2940962,203594,3157278,"2020-11-01",2020
"20-Nov",부산,강서구,311,77148,3589,81048,"2020-11-01",2020
"20-Nov",부산,금정구,281,80638,7679,88598,"2020-11-01",2020
"20-Nov",부산,기장군,263,77757,2514,80534,"2020-11-01",2020
"20-Nov",부산,남구,233,91103,8222,99558,"2020-11-01",2020
"20-Nov",부산,동구,184,46920,5044,52148,"2020-11-01",2020
"20-Nov",부산,동래구,172,92534,3957,96663,"2020-11-01",2020
"20-Nov",부산,부산진구,377,122864,19272,142513,"2020-11-01",2020
"20-Nov",부산,북구,234,100165,3465,103864,"2020-11-01",2020
"20-Nov",부산,사상구,288,83452,5935,89675,"2020-11-01",2020
"20-Nov",부산,사하구,263,106912,6724,113899,"2020-11-01",2020
"20-Nov",부산,서구,140,28850,1398,30388,"2020-11-01",2020
"20-Nov",부산,수영구,161,67357,33226,100744,"2020-11-01",2020
"20-Nov",부산,연제구,941,89961,10512,101414,"2020-11-01",2020
"20-Nov",부산,영도구,227,30797,1990,33014,"2020-11-01",2020
"20-Nov",부산,중구,309,27846,6983,35138,"2020-11-01",2020
"20-Nov",부산,해운대구,317,164703,12454,177474,"2020-11-01",2020
"20-Nov",부산,계,4701,1289007,132964,1426672,"2020-11-01",2020
"20-Nov",대구,남구,350,55970,1662,57982,"2020-11-01",2020
"20-Nov",대구,달서구,539,270379,14176,285094,"2020-11-01",2020
"20-Nov",대구,달성군,548,132560,4987,138095,"2020-11-01",2020
"20-Nov",대구,동구,366,152733,11201,164300,"2020-11-01",2020
"20-Nov",대구,북구,501,201338,7529,209368,"2020-11-01",2020
"20-Nov",대구,서구,251,69158,3890,73299,"2020-11-01",2020
"20-Nov",대구,수성구,583,214646,5214,220443,"2020-11-01",2020
"20-Nov",대구,중구,305,66243,2524,69072,"2020-11-01",2020
"20-Nov",대구,계,3443,1163027,51183,1217653,"2020-11-01",2020
"20-Nov",인천,강화군,329,34473,39888,74690,"2020-11-01",2020
"20-Nov",인천,계양구,285,119472,199429,319186,"2020-11-01",2020
"20-Nov",인천,남동구,840,252623,51991,305454,"2020-11-01",2020
"20-Nov",인천,동구,92,24893,4576,29561,"2020-11-01",2020
"20-Nov",인천,미추홀구,422,158602,10507,169531,"2020-11-01",2020
"20-Nov",인천,부평구,339,214977,21185,236501,"2020-11-01",2020
"20-Nov",인천,서구,431,239261,11167,250859,"2020-11-01",2020
"20-Nov",인천,연수구,411,190955,7950,199316,"2020-11-01",2020
"20-Nov",인천,옹진군,213,11990,210,12413,"2020-11-01",2020
"20-Nov",인천,중구,700,63960,13439,78099,"2020-11-01",2020
"20-Nov",인천,계,4062,1311206,360342,1675610,"2020-11-01",2020
"20-Nov",광주,광산구,504,194069,12402,206975,"2020-11-01",2020
"20-Nov",광주,남구,211,89862,2789,92862,"2020-11-01",2020
"20-Nov",광주,동구,236,42189,1273,43698,"2020-11-01",2020
"20-Nov",광주,북구,626,188713,9158,198497,"2020-11-01",2020
"20-Nov",광주,서구,638,142044,6698,149380,"2020-11-01",2020
"20-Nov",광주,계,2215,656877,32320,691412,"2020-11-01",2020
"20-Nov",대전,대덕구,237,85551,6827,92615,"2020-11-01",2020
"20-Nov",대전,동구,255,89014,4612,93881,"2020-11-01",2020
"20-Nov",대전,서구,807,205520,7382,213709,"2020-11-01",2020
"20-Nov",대전,유성구,381,177386,4839,182606,"2020-11-01",2020
"20-Nov",대전,중구,236,96727,5787,102750,"2020-11-01",2020
"20-Nov",대전,계,1916,654198,29447,685561,"2020-11-01",2020
"20-Nov",울산,남구,708,153400,7409,161517,"2020-11-01",2020
"20-Nov",울산,동구,182,61613,1045,62840,"2020-11-01",2020
"20-Nov",울산,북구,223,113678,3900,117801,"2020-11-01",2020
"20-Nov",울산,울주군,385,122563,6799,129747,"2020-11-01",2020
"20-Nov",울산,중구,327,100135,2511,102973,"2020-11-01",2020
"20-Nov",울산,계,1825,551389,21664,574878,"2020-11-01",2020
"20-Nov",세종,세종특별자치시,766,169820,2838,173424,"2020-11-01",2020
"20-Nov",세종,계,766,169820,2838,173424,"2020-11-01",2020
"20-Nov",경기,가평군,374,30597,573,31544,"2020-11-01",2020
"20-Nov",경기,고양시 덕양구,671,177269,4004,181944,"2020-11-01",2020
"20-Nov",경기,고양시 일산동구,279,122879,5796,128954,"2020-11-01",2020
"20-Nov",경기,고양시 일산서구,127,116123,4203,120453,"2020-11-01",2020
"20-Nov",경기,과천시,719,22660,622,24001,"2020-11-01",2020
"20-Nov",경기,광명시,303,100329,4285,104917,"2020-11-01",2020
"20-Nov",경기,광주시,388,189638,8331,198357,"2020-11-01",2020
"20-Nov",경기,구리시,262,70457,2644,73363,"2020-11-01",2020
"20-Nov",경기,군포시,300,98254,5147,103701,"2020-11-01",2020
"20-Nov",경기,김포시,491,218220,7665,226376,"2020-11-01",2020
"20-Nov",경기,남양주시,719,293291,8276,302286,"2020-11-01",2020
"20-Nov",경기,동두천시,217,37481,1420,39118,"2020-11-01",2020
"20-Nov",경기,부천시,700,293838,12503,307041,"2020-11-01",2020
"20-Nov",경기,성남시 분당구,372,183324,6899,190595,"2020-11-01",2020
"20-Nov",경기,성남시 수정구,356,76913,2512,79781,"2020-11-01",2020
"20-Nov",경기,성남시 중원구,342,71000,4063,75405,"2020-11-01",2020
"20-Nov",경기,수원시 권선구,489,189386,8657,198532,"2020-11-01",2020
"20-Nov",경기,수원시 영통구,224,146932,3230,150386,"2020-11-01",2020
"20-Nov",경기,수원시 장안구,467,101603,3821,105891,"2020-11-01",2020
"20-Nov",경기,수원시 팔달구,503,68267,2922,71692,"2020-11-01",2020
"20-Nov",경기,시흥시,456,241293,7758,249507,"2020-11-01",2020
"20-Nov",경기,안산시 단원구,563,153633,8100,162296,"2020-11-01",2020
"20-Nov",경기,안산시 상록구,174,140724,4931,145829,"2020-11-01",2020
"20-Nov",경기,안성시,398,102604,4991,107993,"2020-11-01",2020
"20-Nov",경기,안양시 동안구,405,115359,6317,122081,"2020-11-01",2020
"20-Nov",경기,안양시 만안구,164,83446,3891,87501,"2020-11-01",2020
"20-Nov",경기,양주시,388,106532,3144,110064,"2020-11-01",2020
"20-Nov",경기,양평군,559,59552,1813,61924,"2020-11-01",2020
"20-Nov",경기,여주시,450,62224,7497,70171,"2020-11-01",2020
"20-Nov",경기,연천군,311,23627,5301,29239,"2020-11-01",2020
"20-Nov",경기,오산시,210,105884,3434,109528,"2020-11-01",2020
"20-Nov",경기,용인시 기흥구,131,187115,6239,193485,"2020-11-01",2020
"20-Nov",경기,용인시 수지구,52,144080,2381,146513,"2020-11-01",2020
"20-Nov",경기,용인시 처인구,756,129463,7347,137566,"2020-11-01",2020
"20-Nov",경기,의왕시,289,64387,2941,67617,"2020-11-01",2020
"20-Nov",경기,의정부시,737,160928,5065,166730,"2020-11-01",2020
"20-Nov",경기,이천시,402,111999,5954,118355,"2020-11-01",2020
"20-Nov",경기,파주시,540,210911,10340,221791,"2020-11-01",2020
"20-Nov",경기,평택시,739,277201,12179,290119,"2020-11-01",2020
"20-Nov",경기,포천시,397,84791,10216,95404,"2020-11-01",2020
"20-Nov",경기,하남시,404,120086,2880,123370,"2020-11-01",2020
"20-Nov",경기,화성시,938,440629,11840,453407,"2020-11-01",2020
"20-Nov",경기,계,17766,5734929,232132,5984827,"2020-11-01",2020
"20-Nov",강원,강릉시,539,107157,4562,112258,"2020-11-01",2020
"20-Nov",강원,고성군,187,14229,225,14641,"2020-11-01",2020
"20-Nov",강원,동해시,311,45080,1409,46800,"2020-11-01",2020
"20-Nov",강원,삼척시,404,32065,757,33226,"2020-11-01",2020
"20-Nov",강원,속초시,299,37923,1362,39584,"2020-11-01",2020
"20-Nov",강원,양구군,193,11996,119,12308,"2020-11-01",2020
"20-Nov",강원,양양군,188,15716,304,16208,"2020-11-01",2020
"20-Nov",강원,영월군,335,21098,350,21783,"2020-11-01",2020
"20-Nov",강원,원주시,580,172410,5710,178700,"2020-11-01",2020
"20-Nov",강원,인제군,220,18303,307,18830,"2020-11-01",2020
"20-Nov",강원,정선군,335,20690,480,21505,"2020-11-01",2020
"20-Nov",강원,철원군,237,24083,313,24633,"2020-11-01",2020
"20-Nov",강원,춘천시,823,132009,6006,138838,"2020-11-01",2020
"20-Nov",강원,태백시,228,20057,733,21018,"2020-11-01",2020
"20-Nov",강원,평창군,293,25544,496,26333,"2020-11-01",2020
"20-Nov",강원,홍천군,437,38633,1055,40125,"2020-11-01",2020
"20-Nov",강원,화천군,228,12985,191,13404,"2020-11-01",2020
"20-Nov",강원,횡성군,256,26426,719,27401,"2020-11-01",2020
"20-Nov",강원,계,6093,776404,25098,807595,"2020-11-01",2020
"20-Nov",충북,괴산군,207,22587,408,23202,"2020-11-01",2020
"20-Nov",충북,단양군,224,15677,775,16676,"2020-11-01",2020
"20-Nov",충북,보은군,231,17931,1000,19162,"2020-11-01",2020
"20-Nov",충북,영동군,248,24918,387,25553,"2020-11-01",2020
"20-Nov",충북,옥천군,204,26812,1127,28143,"2020-11-01",2020
"20-Nov",충북,음성군,233,58116,1885,60234,"2020-11-01",2020
"20-Nov",충북,제천시,338,66870,3443,70651,"2020-11-01",2020
"20-Nov",충북,증평군,89,19148,754,19991,"2020-11-01",2020
"20-Nov",충북,진천군,215,49083,1348,50646,"2020-11-01",2020
"20-Nov",충북,청원군,1,19,0,20,"2020-11-01",2020
"20-Nov",충북,청주시 상당구,515,89397,2587,92499,"2020-11-01",2020
"20-Nov",충북,청주시 서원구,239,94895,4355,99489,"2020-11-01",2020
"20-Nov",충북,청주시 청원구,352,102053,3988,106393,"2020-11-01",2020
"20-Nov",충북,청주시 흥덕구,361,127752,7981,136094,"2020-11-01",2020
"20-Nov",충북,충주시,591,108838,6120,115549,"2020-11-01",2020
"20-Nov",충북,계,4048,824096,36158,864302,"2020-11-01",2020
"20-Nov",충남,계룡시,154,21926,533,22613,"2020-11-01",2020
"20-Nov",충남,공주시,573,53591,2440,56604,"2020-11-01",2020
"20-Nov",충남,금산군,184,28539,2208,30931,"2020-11-01",2020
"20-Nov",충남,논산시,396,60902,2390,63688,"2020-11-01",2020
"20-Nov",충남,당진시,395,94060,3875,98330,"2020-11-01",2020
"20-Nov",충남,보령시,406,52126,1327,53859,"2020-11-01",2020
"20-Nov",충남,부여군,298,34115,1221,35634,"2020-11-01",2020
"20-Nov",충남,서산시,404,93954,3394,97752,"2020-11-01",2020
"20-Nov",충남,서천군,239,26951,883,28073,"2020-11-01",2020
"20-Nov",충남,아산시,520,165041,6694,172255,"2020-11-01",2020
"20-Nov",충남,예산군,405,42898,1380,44683,"2020-11-01",2020
"20-Nov",충남,천안시 동남구,269,130619,4911,135799,"2020-11-01",2020
"20-Nov",충남,천안시 서북구,539,194481,5496,200516,"2020-11-01",2020
"20-Nov",충남,청양군,248,16769,814,17831,"2020-11-01",2020
"20-Nov",충남,태안군,301,34152,548,35001,"2020-11-01",2020
"20-Nov",충남,홍성군,416,52400,1468,54284,"2020-11-01",2020
"20-Nov",충남,계,5747,1102524,39582,1147853,"2020-11-01",2020
"20-Nov",전북,고창군,291,30247,563,31101,"2020-11-01",2020
"20-Nov",전북,군산시,548,129581,6387,136516,"2020-11-01",2020
"20-Nov",전북,김제시,293,44953,2030,47276,"2020-11-01",2020
"20-Nov",전북,남원시,403,40731,4597,45731,"2020-11-01",2020
"20-Nov",전북,무주군,196,12744,399,13339,"2020-11-01",2020
"20-Nov",전북,부안군,266,27255,613,28134,"2020-11-01",2020
"20-Nov",전북,순창군,241,14512,156,14909,"2020-11-01",2020
"20-Nov",전북,완주군,407,50926,3162,54495,"2020-11-01",2020
"20-Nov",전북,익산시,513,135869,5946,142328,"2020-11-01",2020
"20-Nov",전북,임실군,216,14201,424,14841,"2020-11-01",2020
"20-Nov",전북,장수군,245,12010,172,12427,"2020-11-01",2020
"20-Nov",전북,전주시 덕진구,379,170490,7254,178123,"2020-11-01",2020
"20-Nov",전북,전주시 완산구,724,150852,4208,155784,"2020-11-01",2020
"20-Nov",전북,정읍시,338,54024,3683,58045,"2020-11-01",2020
"20-Nov",전북,진안군,233,13864,220,14317,"2020-11-01",2020
"20-Nov",전북,계,5293,902259,39814,947366,"2020-11-01",2020
"20-Nov",전남,강진군,221,18457,1107,19785,"2020-11-01",2020
"20-Nov",전남,고흥군,301,31733,622,32656,"2020-11-01",2020
"20-Nov",전남,곡성군,155,14636,710,15501,"2020-11-01",2020
"20-Nov",전남,광양시,246,81794,5915,87955,"2020-11-01",2020
"20-Nov",전남,구례군,135,12996,704,13835,"2020-11-01",2020
"20-Nov",전남,나주시,469,63703,3259,67431,"2020-11-01",2020
"20-Nov",전남,담양군,226,26214,1574,28014,"2020-11-01",2020
"20-Nov",전남,목포시,433,95752,5610,101795,"2020-11-01",2020
"20-Nov",전남,무안군,566,45111,1022,46699,"2020-11-01",2020
"20-Nov",전남,보성군,209,21457,26872,48538,"2020-11-01",2020
"20-Nov",전남,순천시,501,139336,5171,145008,"2020-11-01",2020
"20-Nov",전남,신안군,311,20905,42992,64208,"2020-11-01",2020
"20-Nov",전남,여수시,530,130699,7100,138329,"2020-11-01",2020
"20-Nov",전남,영광군,207,27525,780,28512,"2020-11-01",2020
"20-Nov",전남,영암군,269,33184,9757,43210,"2020-11-01",2020
"20-Nov",전남,완도군,244,25378,513,26135,"2020-11-01",2020
"20-Nov",전남,장성군,195,26491,1127,27813,"2020-11-01",2020
"20-Nov",전남,장흥군,242,19933,447,20622,"2020-11-01",2020
"20-Nov",전남,진도군,165,16783,290,17238,"2020-11-01",2020
"20-Nov",전남,함평군,203,17970,26681,44854,"2020-11-01",2020
"20-Nov",전남,해남군,357,39163,624,40144,"2020-11-01",2020
"20-Nov",전남,화순군,219,32360,2091,34670,"2020-11-01",2020
"20-Nov",전남,계,6404,941580,144968,1092952,"2020-11-01",2020
"20-Nov",경북,경산시,321,136014,4441,140776,"2020-11-01",2020
"20-Nov",경북,경주시,586,139992,4563,145141,"2020-11-01",2020
"20-Nov",경북,고령군,170,20380,682,21232,"2020-11-01",2020
"20-Nov",경북,구미시,550,212218,7244,220012,"2020-11-01",2020
"20-Nov",경북,군위군,123,14764,306,15193,"2020-11-01",2020
"20-Nov",경북,김천시,389,73595,1903,75887,"2020-11-01",2020
"20-Nov",경북,문경시,275,36352,841,37468,"2020-11-01",2020
"20-Nov",경북,봉화군,207,17873,198,18278,"2020-11-01",2020
"20-Nov",경북,상주시,380,52774,1836,54990,"2020-11-01",2020
"20-Nov",경북,성주군,199,30279,1348,31826,"2020-11-01",2020
"20-Nov",경북,안동시,715,81790,2619,85124,"2020-11-01",2020
"20-Nov",경북,영덕군,258,18803,303,19364,"2020-11-01",2020
"20-Nov",경북,영양군,143,9617,112,9872,"2020-11-01",2020
"20-Nov",경북,영주시,370,55270,1533,57173,"2020-11-01",2020
"20-Nov",경북,영천시,308,59260,2553,62121,"2020-11-01",2020
"20-Nov",경북,예천군,259,29438,483,30180,"2020-11-01",2020
"20-Nov",경북,울릉군,150,5162,496,5808,"2020-11-01",2020
"20-Nov",경북,울진군,312,25962,359,26633,"2020-11-01",2020
"20-Nov",경북,의성군,315,30566,982,31863,"2020-11-01",2020
"20-Nov",경북,청도군,219,24757,775,25751,"2020-11-01",2020
"20-Nov",경북,청송군,198,15514,207,15919,"2020-11-01",2020
"20-Nov",경북,칠곡군,310,68011,2300,70621,"2020-11-01",2020
"20-Nov",경북,포항시 남구,456,119792,8522,128770,"2020-11-01",2020
"20-Nov",경북,포항시 북구,330,138637,3827,142794,"2020-11-01",2020
"20-Nov",경북,계,7543,1416820,48433,1472796,"2020-11-01",2020
"20-Nov",경남,거제시,367,105700,2105,108172,"2020-11-01",2020
"20-Nov",경남,거창군,263,31875,814,32952,"2020-11-01",2020
"20-Nov",경남,고성군,223,26234,601,27058,"2020-11-01",2020
"20-Nov",경남,김해시,655,272917,7312,280884,"2020-11-01",2020
"20-Nov",경남,남해군,275,19640,465,20380,"2020-11-01",2020
"20-Nov",경남,밀양시,329,55386,4009,59724,"2020-11-01",2020
"20-Nov",경남,사천시,313,56107,1523,57943,"2020-11-01",2020
"20-Nov",경남,산청군,241,19966,787,20994,"2020-11-01",2020
"20-Nov",경남,양산시,398,163286,10017,173701,"2020-11-01",2020
"20-Nov",경남,의령군,202,14272,712,15186,"2020-11-01",2020
"20-Nov",경남,진주시,624,163726,6465,170815,"2020-11-01",2020
"20-Nov",경남,창녕군,235,35205,876,36316,"2020-11-01",2020
"20-Nov",경남,창원시 마산합포구,325,95234,2889,98448,"2020-11-01",2020
"20-Nov",경남,창원시 마산회원구,172,94602,4665,99439,"2020-11-01",2020
"20-Nov",경남,창원시 성산구,142,116697,3832,120671,"2020-11-01",2020
"20-Nov",경남,창원시 의창구,942,140423,28825,170190,"2020-11-01",2020
"20-Nov",경남,창원시 진해구,212,90360,1815,92387,"2020-11-01",2020
"20-Nov",경남,통영시,326,52402,1404,54132,"2020-11-01",2020
"20-Nov",경남,하동군,228,24004,399,24631,"2020-11-01",2020
"20-Nov",경남,함안군,192,40293,18693,59178,"2020-11-01",2020
"20-Nov",경남,함양군,216,19300,422,19938,"2020-11-01",2020
"20-Nov",경남,합천군,268,23034,632,23934,"2020-11-01",2020
"20-Nov",경남,계,7148,1660663,99262,1767073,"2020-11-01",2020
"20-Nov",제주,서귀포시,816,103187,2020,106023,"2020-11-01",2020
"20-Nov",제주,제주시,1643,277348,242809,521800,"2020-11-01",2020
"20-Nov",제주,계,2459,380535,244829,627823,"2020-11-01",2020
"20-Dec",서울,강남구,393,216919,18904,236216,"2020-12-01",2020
"20-Dec",서울,강동구,291,140678,8897,149866,"2020-12-01",2020
"20-Dec",서울,강북구,316,71077,4286,75679,"2020-12-01",2020
"20-Dec",서울,강서구,336,185718,19000,205054,"2020-12-01",2020
"20-Dec",서울,관악구,319,113494,5580,119393,"2020-12-01",2020
"20-Dec",서울,광진구,294,92897,5692,98883,"2020-12-01",2020
"20-Dec",서울,구로구,293,132134,12840,145267,"2020-12-01",2020
"20-Dec",서울,금천구,135,82333,5927,88395,"2020-12-01",2020
"20-Dec",서울,노원구,325,143093,9311,152729,"2020-12-01",2020
"20-Dec",서울,도봉구,275,88203,7361,95839,"2020-12-01",2020
"20-Dec",서울,동대문구,307,92787,4936,98030,"2020-12-01",2020
"20-Dec",서울,동작구,316,102483,2789,105588,"2020-12-01",2020
"20-Dec",서울,마포구,340,112049,7000,119389,"2020-12-01",2020
"20-Dec",서울,서대문구,457,83162,5877,89496,"2020-12-01",2020
"20-Dec",서울,서초구,535,167856,12662,181053,"2020-12-01",2020
"20-Dec",서울,성동구,341,93992,11823,106156,"2020-12-01",2020
"20-Dec",서울,성북구,291,114489,5489,120269,"2020-12-01",2020
"20-Dec",서울,송파구,392,232320,13121,245833,"2020-12-01",2020
"20-Dec",서울,양천구,315,142468,8666,151449,"2020-12-01",2020
"20-Dec",서울,영등포구,374,136630,9167,146171,"2020-12-01",2020
"20-Dec",서울,용산구,340,76624,2031,78995,"2020-12-01",2020
"20-Dec",서울,은평구,297,124829,7072,132198,"2020-12-01",2020
"20-Dec",서울,종로구,3856,44697,1714,50267,"2020-12-01",2020
"20-Dec",서울,중구,1330,45710,4086,51126,"2020-12-01",2020
"20-Dec",서울,중랑구,255,104250,9515,114020,"2020-12-01",2020
"20-Dec",서울,계,12723,2940892,203746,3157361,"2020-12-01",2020
"20-Dec",부산,강서구,310,77602,3569,81481,"2020-12-01",2020
"20-Dec",부산,금정구,278,80578,7665,88521,"2020-12-01",2020
"20-Dec",부산,기장군,260,78232,2519,81011,"2020-12-01",2020
"20-Dec",부산,남구,228,91171,8191,99590,"2020-12-01",2020
"20-Dec",부산,동구,180,47264,5046,52490,"2020-12-01",2020
"20-Dec",부산,동래구,176,92494,3987,96657,"2020-12-01",2020
"20-Dec",부산,부산진구,368,123231,19407,143006,"2020-12-01",2020
"20-Dec",부산,북구,233,99968,3450,103651,"2020-12-01",2020
"20-Dec",부산,사상구,287,83468,5938,89693,"2020-12-01",2020
"20-Dec",부산,사하구,261,106831,6712,113804,"2020-12-01",2020
"20-Dec",부산,서구,138,28913,1396,30447,"2020-12-01",2020
"20-Dec",부산,수영구,159,67317,33525,101001,"2020-12-01",2020
"20-Dec",부산,연제구,931,90185,10598,101714,"2020-12-01",2020
"20-Dec",부산,영도구,225,30769,1971,32965,"2020-12-01",2020
"20-Dec",부산,중구,307,28100,7001,35408,"2020-12-01",2020
"20-Dec",부산,해운대구,317,164894,12390,177601,"2020-12-01",2020
"20-Dec",부산,계,4658,1291017,133365,1429040,"2020-12-01",2020
"20-Dec",대구,남구,351,56056,1656,58063,"2020-12-01",2020
"20-Dec",대구,달서구,493,270482,14045,285020,"2020-12-01",2020
"20-Dec",대구,달성군,545,132991,5048,138584,"2020-12-01",2020
"20-Dec",대구,동구,358,153099,11172,164629,"2020-12-01",2020
"20-Dec",대구,북구,502,201427,7533,209462,"2020-12-01",2020
"20-Dec",대구,서구,250,69369,3911,73530,"2020-12-01",2020
"20-Dec",대구,수성구,579,214842,5271,220692,"2020-12-01",2020
"20-Dec",대구,중구,304,66408,2504,69216,"2020-12-01",2020
"20-Dec",대구,계,3382,1164674,51140,1219196,"2020-12-01",2020
"20-Dec",인천,강화군,333,34590,38913,73836,"2020-12-01",2020
"20-Dec",인천,계양구,287,119360,200932,320579,"2020-12-01",2020
"20-Dec",인천,남동구,829,253019,51846,305694,"2020-12-01",2020
"20-Dec",인천,동구,92,24738,2557,27387,"2020-12-01",2020
"20-Dec",인천,미추홀구,423,160194,10409,171026,"2020-12-01",2020
"20-Dec",인천,부평구,336,214955,21746,237037,"2020-12-01",2020
"20-Dec",인천,서구,426,239763,11294,251483,"2020-12-01",2020
"20-Dec",인천,연수구,408,192021,7979,200408,"2020-12-01",2020
"20-Dec",인천,옹진군,211,11998,209,12418,"2020-12-01",2020
"20-Dec",인천,중구,703,64054,11817,76574,"2020-12-01",2020
"20-Dec",인천,계,4048,1314692,357702,1676442,"2020-12-01",2020
"20-Dec",광주,광산구,507,194041,12394,206942,"2020-12-01",2020
"20-Dec",광주,남구,213,90058,2797,93068,"2020-12-01",2020
"20-Dec",광주,동구,234,42317,1268,43819,"2020-12-01",2020
"20-Dec",광주,북구,631,188528,9070,198229,"2020-12-01",2020
"20-Dec",광주,서구,632,142379,6671,149682,"2020-12-01",2020
"20-Dec",광주,계,2217,657323,32200,691740,"2020-12-01",2020
"20-Dec",대전,대덕구,235,85791,6828,92854,"2020-12-01",2020
"20-Dec",대전,동구,247,89522,4671,94440,"2020-12-01",2020
"20-Dec",대전,서구,805,205514,7395,213714,"2020-12-01",2020
"20-Dec",대전,유성구,377,177758,4790,182925,"2020-12-01",2020
"20-Dec",대전,중구,235,96492,5769,102496,"2020-12-01",2020
"20-Dec",대전,계,1899,655077,29453,686429,"2020-12-01",2020
"20-Dec",울산,남구,713,153353,7360,161426,"2020-12-01",2020
"20-Dec",울산,동구,181,61595,1070,62846,"2020-12-01",2020
"20-Dec",울산,북구,223,114212,3907,118342,"2020-12-01",2020
"20-Dec",울산,울주군,385,122862,6834,130081,"2020-12-01",2020
"20-Dec",울산,중구,336,100156,2513,103005,"2020-12-01",2020
"20-Dec",울산,계,1838,552178,21684,575700,"2020-12-01",2020
"20-Dec",세종,세종특별자치시,772,171127,2843,174742,"2020-12-01",2020
"20-Dec",세종,계,772,171127,2843,174742,"2020-12-01",2020
"20-Dec",경기,가평군,375,30599,566,31540,"2020-12-01",2020
"20-Dec",경기,고양시 덕양구,668,177802,3981,182451,"2020-12-01",2020
"20-Dec",경기,고양시 일산동구,278,123430,5738,129446,"2020-12-01",2020
"20-Dec",경기,고양시 일산서구,125,116326,4244,120695,"2020-12-01",2020
"20-Dec",경기,과천시,715,23076,618,24409,"2020-12-01",2020
"20-Dec",경기,광명시,304,99931,4302,104537,"2020-12-01",2020
"20-Dec",경기,광주시,389,190189,8413,198991,"2020-12-01",2020
"20-Dec",경기,구리시,262,70594,2647,73503,"2020-12-01",2020
"20-Dec",경기,군포시,301,98149,5133,103583,"2020-12-01",2020
"20-Dec",경기,김포시,491,220592,7717,228800,"2020-12-01",2020
"20-Dec",경기,남양주시,742,294089,8298,303129,"2020-12-01",2020
"20-Dec",경기,동두천시,215,37609,1439,39263,"2020-12-01",2020
"20-Dec",경기,부천시,695,294081,12486,307262,"2020-12-01",2020
"20-Dec",경기,성남시 분당구,371,183364,6870,190605,"2020-12-01",2020
"20-Dec",경기,성남시 수정구,350,76959,2512,79821,"2020-12-01",2020
"20-Dec",경기,성남시 중원구,341,71069,4066,75476,"2020-12-01",2020
"20-Dec",경기,수원시 권선구,487,192360,8630,201477,"2020-12-01",2020
"20-Dec",경기,수원시 영통구,226,147103,3228,150557,"2020-12-01",2020
"20-Dec",경기,수원시 장안구,462,101364,3866,105692,"2020-12-01",2020
"20-Dec",경기,수원시 팔달구,505,68433,2914,71852,"2020-12-01",2020
"20-Dec",경기,시흥시,457,242624,7785,250866,"2020-12-01",2020
"20-Dec",경기,안산시 단원구,555,153987,8086,162628,"2020-12-01",2020
"20-Dec",경기,안산시 상록구,173,141752,4952,146877,"2020-12-01",2020
"20-Dec",경기,안성시,395,103140,4920,108455,"2020-12-01",2020
"20-Dec",경기,안양시 동안구,401,115239,6330,121970,"2020-12-01",2020
"20-Dec",경기,안양시 만안구,162,83272,3893,87327,"2020-12-01",2020
"20-Dec",경기,양주시,384,106652,3145,110181,"2020-12-01",2020
"20-Dec",경기,양평군,559,59754,1821,62134,"2020-12-01",2020
"20-Dec",경기,여주시,445,62428,7479,70352,"2020-12-01",2020
"20-Dec",경기,연천군,316,23691,5296,29303,"2020-12-01",2020
"20-Dec",경기,오산시,211,105711,3452,109374,"2020-12-01",2020
"20-Dec",경기,용인시 기흥구,129,187711,6276,194116,"2020-12-01",2020
"20-Dec",경기,용인시 수지구,50,144104,2404,146558,"2020-12-01",2020
"20-Dec",경기,용인시 처인구,763,129926,7364,138053,"2020-12-01",2020
"20-Dec",경기,의왕시,297,64354,2953,67604,"2020-12-01",2020
"20-Dec",경기,의정부시,723,161651,5087,167461,"2020-12-01",2020
"20-Dec",경기,이천시,406,112259,5972,118637,"2020-12-01",2020
"20-Dec",경기,파주시,537,211671,10314,222522,"2020-12-01",2020
"20-Dec",경기,평택시,730,278805,12200,291735,"2020-12-01",2020
"20-Dec",경기,포천시,395,84982,10062,95439,"2020-12-01",2020
"20-Dec",경기,하남시,397,121048,2864,124309,"2020-12-01",2020
"20-Dec",경기,화성시,925,442245,11966,455136,"2020-12-01",2020
"20-Dec",경기,계,17712,5754125,232289,6004126,"2020-12-01",2020
"20-Dec",강원,강릉시,538,107259,4599,112396,"2020-12-01",2020
"20-Dec",강원,고성군,188,14258,225,14671,"2020-12-01",2020
"20-Dec",강원,동해시,309,45109,1430,46848,"2020-12-01",2020
"20-Dec",강원,삼척시,400,32144,768,33312,"2020-12-01",2020
"20-Dec",강원,속초시,300,38054,1357,39711,"2020-12-01",2020
"20-Dec",강원,양구군,192,11954,121,12267,"2020-12-01",2020
"20-Dec",강원,양양군,189,15740,306,16235,"2020-12-01",2020
"20-Dec",강원,영월군,335,21098,356,21789,"2020-12-01",2020
"20-Dec",강원,원주시,584,172966,5701,179251,"2020-12-01",2020
"20-Dec",강원,인제군,218,18391,304,18913,"2020-12-01",2020
"20-Dec",강원,정선군,335,20659,482,21476,"2020-12-01",2020
"20-Dec",강원,철원군,234,24105,313,24652,"2020-12-01",2020
"20-Dec",강원,춘천시,826,132283,6044,139153,"2020-12-01",2020
"20-Dec",강원,태백시,231,20047,737,21015,"2020-12-01",2020
"20-Dec",강원,평창군,293,25517,510,26320,"2020-12-01",2020
"20-Dec",강원,홍천군,433,38773,1054,40260,"2020-12-01",2020
"20-Dec",강원,화천군,227,12973,189,13389,"2020-12-01",2020
"20-Dec",강원,횡성군,252,26485,704,27441,"2020-12-01",2020
"20-Dec",강원,계,6084,777815,25200,809099,"2020-12-01",2020
"20-Dec",충북,괴산군,209,23401,409,24019,"2020-12-01",2020
"20-Dec",충북,단양군,223,15640,772,16635,"2020-12-01",2020
"20-Dec",충북,보은군,231,17957,1003,19191,"2020-12-01",2020
"20-Dec",충북,영동군,247,24935,392,25574,"2020-12-01",2020
"20-Dec",충북,옥천군,203,26833,1130,28166,"2020-12-01",2020
"20-Dec",충북,음성군,231,58189,1893,60313,"2020-12-01",2020
"20-Dec",충북,제천시,336,66954,3421,70711,"2020-12-01",2020
"20-Dec",충북,증평군,88,19096,765,19949,"2020-12-01",2020
"20-Dec",충북,진천군,216,49228,1350,50794,"2020-12-01",2020
"20-Dec",충북,청원군,1,19,0,20,"2020-12-01",2020
"20-Dec",충북,청주시 상당구,517,89595,2598,92710,"2020-12-01",2020
"20-Dec",충북,청주시 서원구,239,94381,4315,98935,"2020-12-01",2020
"20-Dec",충북,청주시 청원구,351,102365,3999,106715,"2020-12-01",2020
"20-Dec",충북,청주시 흥덕구,364,128062,7871,136297,"2020-12-01",2020
"20-Dec",충북,충주시,592,108914,6085,115591,"2020-12-01",2020
"20-Dec",충북,계,4048,825569,36003,865620,"2020-12-01",2020
"20-Dec",충남,계룡시,156,21959,531,22646,"2020-12-01",2020
"20-Dec",충남,공주시,570,53568,2510,56648,"2020-12-01",2020
"20-Dec",충남,금산군,186,28493,2212,30891,"2020-12-01",2020
"20-Dec",충남,논산시,399,60740,2395,63534,"2020-12-01",2020
"20-Dec",충남,당진시,393,94352,3959,98704,"2020-12-01",2020
"20-Dec",충남,보령시,405,52178,1322,53905,"2020-12-01",2020
"20-Dec",충남,부여군,305,34110,1185,35600,"2020-12-01",2020
"20-Dec",충남,서산시,404,94211,3421,98036,"2020-12-01",2020
"20-Dec",충남,서천군,239,26884,880,28003,"2020-12-01",2020
"20-Dec",충남,아산시,527,165936,6697,173160,"2020-12-01",2020
"20-Dec",충남,예산군,398,42806,1373,44577,"2020-12-01",2020
"20-Dec",충남,천안시 동남구,270,130765,4918,135953,"2020-12-01",2020
"20-Dec",충남,천안시 서북구,534,194785,5453,200772,"2020-12-01",2020
"20-Dec",충남,청양군,250,16835,821,17906,"2020-12-01",2020
"20-Dec",충남,태안군,303,34203,552,35058,"2020-12-01",2020
"20-Dec",충남,홍성군,415,52577,1460,54452,"2020-12-01",2020
"20-Dec",충남,계,5754,1104402,39689,1149845,"2020-12-01",2020
"20-Dec",전북,고창군,293,30300,574,31167,"2020-12-01",2020
"20-Dec",전북,군산시,550,129738,6359,136647,"2020-12-01",2020
"20-Dec",전북,김제시,294,44966,2013,47273,"2020-12-01",2020
"20-Dec",전북,남원시,404,40624,4548,45576,"2020-12-01",2020
"20-Dec",전북,무주군,195,12802,398,13395,"2020-12-01",2020
"20-Dec",전북,부안군,260,27277,618,28155,"2020-12-01",2020
"20-Dec",전북,순창군,241,14533,153,14927,"2020-12-01",2020
"20-Dec",전북,완주군,409,51136,3163,54708,"2020-12-01",2020
"20-Dec",전북,익산시,512,135856,5932,142300,"2020-12-01",2020
"20-Dec",전북,임실군,216,14204,422,14842,"2020-12-01",2020
"20-Dec",전북,장수군,251,12038,172,12461,"2020-12-01",2020
"20-Dec",전북,전주시 덕진구,377,170997,7207,178581,"2020-12-01",2020
"20-Dec",전북,전주시 완산구,718,150873,4214,155805,"2020-12-01",2020
"20-Dec",전북,정읍시,336,53956,3638,57930,"2020-12-01",2020
"20-Dec",전북,진안군,234,13921,225,14380,"2020-12-01",2020
"20-Dec",전북,계,5290,903221,39636,948147,"2020-12-01",2020
"20-Dec",전남,강진군,219,18505,1104,19828,"2020-12-01",2020
"20-Dec",전남,고흥군,299,31813,615,32727,"2020-12-01",2020
"20-Dec",전남,곡성군,155,14654,728,15537,"2020-12-01",2020
"20-Dec",전남,광양시,249,82523,5888,88660,"2020-12-01",2020
"20-Dec",전남,구례군,136,13087,705,13928,"2020-12-01",2020
"20-Dec",전남,나주시,473,64011,3242,67726,"2020-12-01",2020
"20-Dec",전남,담양군,225,26469,1596,28290,"2020-12-01",2020
"20-Dec",전남,목포시,432,95404,5588,101424,"2020-12-01",2020
"20-Dec",전남,무안군,548,45661,1029,47238,"2020-12-01",2020
"20-Dec",전남,보성군,202,21557,25541,47300,"2020-12-01",2020
"20-Dec",전남,순천시,489,139377,5156,145022,"2020-12-01",2020
"20-Dec",전남,신안군,310,20961,45192,66463,"2020-12-01",2020
"20-Dec",전남,여수시,529,130803,7122,138454,"2020-12-01",2020
"20-Dec",전남,영광군,206,27555,781,28542,"2020-12-01",2020
"20-Dec",전남,영암군,263,33245,9542,43050,"2020-12-01",2020
"20-Dec",전남,완도군,244,25349,514,26107,"2020-12-01",2020
"20-Dec",전남,장성군,195,26472,1143,27810,"2020-12-01",2020
"20-Dec",전남,장흥군,243,19975,446,20664,"2020-12-01",2020
"20-Dec",전남,진도군,167,17024,296,17487,"2020-12-01",2020
"20-Dec",전남,함평군,201,18009,28168,46378,"2020-12-01",2020
"20-Dec",전남,해남군,362,39250,2911,42523,"2020-12-01",2020
"20-Dec",전남,화순군,220,32445,2071,34736,"2020-12-01",2020
"20-Dec",전남,계,6367,944149,149378,1099894,"2020-12-01",2020
"20-Dec",경북,경산시,326,136495,4453,141274,"2020-12-01",2020
"20-Dec",경북,경주시,586,140376,4558,145520,"2020-12-01",2020
"20-Dec",경북,고령군,174,20352,676,21202,"2020-12-01",2020
"20-Dec",경북,구미시,549,212504,7264,220317,"2020-12-01",2020
"20-Dec",경북,군위군,125,14821,303,15249,"2020-12-01",2020
"20-Dec",경북,김천시,389,73766,1908,76063,"2020-12-01",2020
"20-Dec",경북,문경시,274,36573,837,37684,"2020-12-01",2020
"20-Dec",경북,봉화군,209,17875,198,18282,"2020-12-01",2020
"20-Dec",경북,상주시,382,52742,1833,54957,"2020-12-01",2020
"20-Dec",경북,성주군,201,30462,1340,32003,"2020-12-01",2020
"20-Dec",경북,안동시,717,81989,2618,85324,"2020-12-01",2020
"20-Dec",경북,영덕군,255,18804,304,19363,"2020-12-01",2020
"20-Dec",경북,영양군,142,9650,112,9904,"2020-12-01",2020
"20-Dec",경북,영주시,370,55323,1532,57225,"2020-12-01",2020
"20-Dec",경북,영천시,305,59342,2552,62199,"2020-12-01",2020
"20-Dec",경북,예천군,260,29532,490,30282,"2020-12-01",2020
"20-Dec",경북,울릉군,151,5109,493,5753,"2020-12-01",2020
"20-Dec",경북,울진군,309,26009,363,26681,"2020-12-01",2020
"20-Dec",경북,의성군,317,30572,982,31871,"2020-12-01",2020
"20-Dec",경북,청도군,221,24789,780,25790,"2020-12-01",2020
"20-Dec",경북,청송군,197,15551,209,15957,"2020-12-01",2020
"20-Dec",경북,칠곡군,316,67889,2324,70529,"2020-12-01",2020
"20-Dec",경북,포항시 남구,456,119897,8471,128824,"2020-12-01",2020
"20-Dec",경북,포항시 북구,332,138989,3815,143136,"2020-12-01",2020
"20-Dec",경북,계,7563,1419411,48415,1475389,"2020-12-01",2020
"20-Dec",경남,거제시,357,105850,2089,108296,"2020-12-01",2020
"20-Dec",경남,거창군,263,31903,808,32974,"2020-12-01",2020
"20-Dec",경남,고성군,225,26198,602,27025,"2020-12-01",2020
"20-Dec",경남,김해시,650,273530,7322,281502,"2020-12-01",2020
"20-Dec",경남,남해군,276,19646,461,20383,"2020-12-01",2020
"20-Dec",경남,밀양시,326,55459,3988,59773,"2020-12-01",2020
"20-Dec",경남,사천시,311,56161,1531,58003,"2020-12-01",2020
"20-Dec",경남,산청군,242,19963,784,20989,"2020-12-01",2020
"20-Dec",경남,양산시,421,163760,10078,174259,"2020-12-01",2020
"20-Dec",경남,의령군,202,14340,708,15250,"2020-12-01",2020
"20-Dec",경남,진주시,634,164161,6425,171220,"2020-12-01",2020
"20-Dec",경남,창녕군,237,35237,877,36351,"2020-12-01",2020
"20-Dec",경남,창원시 마산합포구,322,95564,2878,98764,"2020-12-01",2020
"20-Dec",경남,창원시 마산회원구,179,94751,4626,99556,"2020-12-01",2020
"20-Dec",경남,창원시 성산구,142,117102,3222,120466,"2020-12-01",2020
"20-Dec",경남,창원시 의창구,930,140850,46179,187959,"2020-12-01",2020
"20-Dec",경남,창원시 진해구,210,90571,1810,92591,"2020-12-01",2020
"20-Dec",경남,통영시,324,52356,1399,54079,"2020-12-01",2020
"20-Dec",경남,하동군,228,24013,399,24640,"2020-12-01",2020
"20-Dec",경남,함안군,191,40330,19383,59904,"2020-12-01",2020
"20-Dec",경남,함양군,217,19276,425,19918,"2020-12-01",2020
"20-Dec",경남,합천군,267,23073,625,23965,"2020-12-01",2020
"20-Dec",경남,계,7154,1664094,116619,1787867,"2020-12-01",2020
"20-Dec",제주,서귀포시,812,103336,2013,106161,"2020-12-01",2020
"20-Dec",제주,제주시,1636,278584,228961,509181,"2020-12-01",2020
"20-Dec",제주,계,2448,381920,230974,615342,"2020-12-01",2020
"21-Jan",서울,강남구,396,217198,19127,236721,"2021-01-01",2021
"21-Jan",서울,강동구,292,141172,8888,150352,"2021-01-01",2021
"21-Jan",서울,강북구,316,71178,4268,75762,"2021-01-01",2021
"21-Jan",서울,강서구,334,185637,18956,204927,"2021-01-01",2021
"21-Jan",서울,관악구,319,113410,5577,119306,"2021-01-01",2021
"21-Jan",서울,광진구,295,92893,5568,98756,"2021-01-01",2021
"21-Jan",서울,구로구,294,132055,12680,145029,"2021-01-01",2021
"21-Jan",서울,금천구,136,82523,5967,88626,"2021-01-01",2021
"21-Jan",서울,노원구,322,143259,9247,152828,"2021-01-01",2021
"21-Jan",서울,도봉구,277,88108,7382,95767,"2021-01-01",2021
"21-Jan",서울,동대문구,307,92814,4952,98073,"2021-01-01",2021
"21-Jan",서울,동작구,322,102432,2793,105547,"2021-01-01",2021
"21-Jan",서울,마포구,337,112145,6960,119442,"2021-01-01",2021
"21-Jan",서울,서대문구,457,83247,5865,89569,"2021-01-01",2021
"21-Jan",서울,서초구,533,168092,10729,179354,"2021-01-01",2021
"21-Jan",서울,성동구,345,94040,11833,106218,"2021-01-01",2021
"21-Jan",서울,성북구,291,114988,5204,120483,"2021-01-01",2021
"21-Jan",서울,송파구,389,232407,13093,245889,"2021-01-01",2021
"21-Jan",서울,양천구,313,142323,8638,151274,"2021-01-01",2021
"21-Jan",서울,영등포구,372,136935,9171,146478,"2021-01-01",2021
"21-Jan",서울,용산구,338,76654,2041,79033,"2021-01-01",2021
"21-Jan",서울,은평구,297,124914,7063,132274,"2021-01-01",2021
"21-Jan",서울,종로구,3833,44722,1699,50254,"2021-01-01",2021
"21-Jan",서울,중구,1320,45674,6300,53294,"2021-01-01",2021
"21-Jan",서울,중랑구,254,104594,9448,114296,"2021-01-01",2021
"21-Jan",서울,계,12689,2943414,203449,3159552,"2021-01-01",2021
"21-Jan",부산,강서구,308,78166,3559,82033,"2021-01-01",2021
"21-Jan",부산,금정구,277,80505,7637,88419,"2021-01-01",2021
"21-Jan",부산,기장군,261,78893,2520,81674,"2021-01-01",2021
"21-Jan",부산,남구,227,91342,8265,99834,"2021-01-01",2021
"21-Jan",부산,동구,180,47702,4965,52847,"2021-01-01",2021
"21-Jan",부산,동래구,177,92830,4024,97031,"2021-01-01",2021
"21-Jan",부산,부산진구,365,123715,20060,144140,"2021-01-01",2021
"21-Jan",부산,북구,236,100062,3456,103754,"2021-01-01",2021
"21-Jan",부산,사상구,286,83457,5927,89670,"2021-01-01",2021
"21-Jan",부산,사하구,259,106912,6671,113842,"2021-01-01",2021
"21-Jan",부산,서구,138,28978,1395,30511,"2021-01-01",2021
"21-Jan",부산,수영구,164,67186,33658,101008,"2021-01-01",2021
"21-Jan",부산,연제구,934,90151,10696,101781,"2021-01-01",2021
"21-Jan",부산,영도구,225,30803,1970,32998,"2021-01-01",2021
"21-Jan",부산,중구,305,28453,7016,35774,"2021-01-01",2021
"21-Jan",부산,해운대구,317,165232,12323,177872,"2021-01-01",2021
"21-Jan",부산,계,4659,1294387,134142,1433188,"2021-01-01",2021
"21-Jan",대구,남구,347,56106,1659,58112,"2021-01-01",2021
"21-Jan",대구,달서구,525,270794,14060,285379,"2021-01-01",2021
"21-Jan",대구,달성군,539,133503,5063,139105,"2021-01-01",2021
"21-Jan",대구,동구,349,153537,11098,164984,"2021-01-01",2021
"21-Jan",대구,북구,498,201790,7547,209835,"2021-01-01",2021
"21-Jan",대구,서구,247,69371,3920,73538,"2021-01-01",2021
"21-Jan",대구,수성구,568,215196,5262,221026,"2021-01-01",2021
"21-Jan",대구,중구,297,66107,2552,68956,"2021-01-01",2021
"21-Jan",대구,계,3370,1166404,51161,1220935,"2021-01-01",2021
"21-Jan",인천,강화군,345,34797,37877,73019,"2021-01-01",2021
"21-Jan",인천,계양구,282,119255,197611,317148,"2021-01-01",2021
"21-Jan",인천,남동구,830,254739,51615,307184,"2021-01-01",2021
"21-Jan",인천,동구,92,24892,2566,27550,"2021-01-01",2021
"21-Jan",인천,미추홀구,423,161147,10332,171902,"2021-01-01",2021
"21-Jan",인천,부평구,336,215717,22318,238371,"2021-01-01",2021
"21-Jan",인천,서구,426,240327,11283,252036,"2021-01-01",2021
"21-Jan",인천,연수구,407,193187,8042,201636,"2021-01-01",2021
"21-Jan",인천,옹진군,210,12017,210,12437,"2021-01-01",2021
"21-Jan",인천,중구,684,64247,11790,76721,"2021-01-01",2021
"21-Jan",인천,계,4035,1320325,353644,1678004,"2021-01-01",2021
"21-Jan",광주,광산구,508,194575,12409,207492,"2021-01-01",2021
"21-Jan",광주,남구,211,90221,2831,93263,"2021-01-01",2021
"21-Jan",광주,동구,234,42417,1269,43920,"2021-01-01",2021
"21-Jan",광주,북구,607,189165,9025,198797,"2021-01-01",2021
"21-Jan",광주,서구,632,142537,6559,149728,"2021-01-01",2021
"21-Jan",광주,계,2192,658915,32093,693200,"2021-01-01",2021
"21-Jan",대전,대덕구,236,85918,6830,92984,"2021-01-01",2021
"21-Jan",대전,동구,246,90290,4677,95213,"2021-01-01",2021
"21-Jan",대전,서구,804,205648,7472,213924,"2021-01-01",2021
"21-Jan",대전,유성구,377,178176,4916,183469,"2021-01-01",2021
"21-Jan",대전,중구,233,96605,5722,102560,"2021-01-01",2021
"21-Jan",대전,계,1896,656637,29617,688150,"2021-01-01",2021
"21-Jan",울산,남구,706,153748,7339,161793,"2021-01-01",2021
"21-Jan",울산,동구,184,61711,1062,62957,"2021-01-01",2021
"21-Jan",울산,북구,219,114765,3828,118812,"2021-01-01",2021
"21-Jan",울산,울주군,379,123289,6806,130474,"2021-01-01",2021
"21-Jan",울산,중구,330,100299,2559,103188,"2021-01-01",2021
"21-Jan",울산,계,1818,553812,21594,577224,"2021-01-01",2021
"21-Jan",세종,세종특별자치시,776,172543,2870,176189,"2021-01-01",2021
"21-Jan",세종,계,776,172543,2870,176189,"2021-01-01",2021
"21-Jan",경기,가평군,373,30677,563,31613,"2021-01-01",2021
"21-Jan",경기,고양시 덕양구,667,178841,3917,183425,"2021-01-01",2021
"21-Jan",경기,고양시 일산동구,276,124076,5773,130125,"2021-01-01",2021
"21-Jan",경기,고양시 일산서구,125,116441,4231,120797,"2021-01-01",2021
"21-Jan",경기,과천시,718,23603,616,24937,"2021-01-01",2021
"21-Jan",경기,광명시,304,99788,4293,104385,"2021-01-01",2021
"21-Jan",경기,광주시,387,191019,8350,199756,"2021-01-01",2021
"21-Jan",경기,구리시,262,70619,2662,73543,"2021-01-01",2021
"21-Jan",경기,군포시,296,98290,5125,103711,"2021-01-01",2021
"21-Jan",경기,김포시,509,222254,7651,230414,"2021-01-01",2021
"21-Jan",경기,남양주시,739,295575,8305,304619,"2021-01-01",2021
"21-Jan",경기,동두천시,214,37786,1439,39439,"2021-01-01",2021
"21-Jan",경기,부천시,691,294411,12473,307575,"2021-01-01",2021
"21-Jan",경기,성남시 분당구,369,183620,6844,190833,"2021-01-01",2021
"21-Jan",경기,성남시 수정구,348,77130,2519,79997,"2021-01-01",2021
"21-Jan",경기,성남시 중원구,341,71280,4141,75762,"2021-01-01",2021
"21-Jan",경기,수원시 권선구,488,192476,8689,201653,"2021-01-01",2021
"21-Jan",경기,수원시 영통구,225,147171,3143,150539,"2021-01-01",2021
"21-Jan",경기,수원시 장안구,459,101320,3854,105633,"2021-01-01",2021
"21-Jan",경기,수원시 팔달구,505,68637,2952,72094,"2021-01-01",2021
"21-Jan",경기,시흥시,458,245313,7864,253635,"2021-01-01",2021
"21-Jan",경기,안산시 단원구,554,154326,8107,162987,"2021-01-01",2021
"21-Jan",경기,안산시 상록구,173,142677,5009,147859,"2021-01-01",2021
"21-Jan",경기,안성시,392,103713,4903,109008,"2021-01-01",2021
"21-Jan",경기,안양시 동안구,399,115655,6280,122334,"2021-01-01",2021
"21-Jan",경기,안양시 만안구,165,83390,3882,87437,"2021-01-01",2021
"21-Jan",경기,양주시,377,107335,3169,110881,"2021-01-01",2021
"21-Jan",경기,양평군,564,60006,1832,62402,"2021-01-01",2021
"21-Jan",경기,여주시,443,62694,7478,70615,"2021-01-01",2021
"21-Jan",경기,연천군,305,23757,5283,29345,"2021-01-01",2021
"21-Jan",경기,오산시,209,106246,3459,109914,"2021-01-01",2021
"21-Jan",경기,용인시 기흥구,128,188041,6404,194573,"2021-01-01",2021
"21-Jan",경기,용인시 수지구,49,144541,2441,147031,"2021-01-01",2021
"21-Jan",경기,용인시 처인구,757,130677,7409,138843,"2021-01-01",2021
"21-Jan",경기,의왕시,297,64433,2929,67659,"2021-01-01",2021
"21-Jan",경기,의정부시,719,162617,5096,168432,"2021-01-01",2021
"21-Jan",경기,이천시,406,112818,5970,119194,"2021-01-01",2021
"21-Jan",경기,파주시,542,212908,10293,223743,"2021-01-01",2021
"21-Jan",경기,평택시,723,281338,12253,294314,"2021-01-01",2021
"21-Jan",경기,포천시,388,85388,9878,95654,"2021-01-01",2021
"21-Jan",경기,하남시,396,121853,2866,125115,"2021-01-01",2021
"21-Jan",경기,화성시,917,444626,12007,457550,"2021-01-01",2021
"21-Jan",경기,계,17657,5779366,232352,6029375,"2021-01-01",2021
"21-Jan",강원,강릉시,538,107646,4585,112769,"2021-01-01",2021
"21-Jan",강원,고성군,188,14268,228,14684,"2021-01-01",2021
"21-Jan",강원,동해시,306,45134,1432,46872,"2021-01-01",2021
"21-Jan",강원,삼척시,398,32200,767,33365,"2021-01-01",2021
"21-Jan",강원,속초시,302,38213,1379,39894,"2021-01-01",2021
"21-Jan",강원,양구군,192,11979,121,12292,"2021-01-01",2021
"21-Jan",강원,양양군,187,15769,299,16255,"2021-01-01",2021
"21-Jan",강원,영월군,334,21145,354,21833,"2021-01-01",2021
"21-Jan",강원,원주시,583,173743,5682,180008,"2021-01-01",2021
"21-Jan",강원,인제군,215,18421,288,18924,"2021-01-01",2021
"21-Jan",강원,정선군,335,20721,484,21540,"2021-01-01",2021
"21-Jan",강원,철원군,234,24106,304,24644,"2021-01-01",2021
"21-Jan",강원,춘천시,820,132686,6049,139555,"2021-01-01",2021
"21-Jan",강원,태백시,230,20032,711,20973,"2021-01-01",2021
"21-Jan",강원,평창군,292,25544,497,26333,"2021-01-01",2021
"21-Jan",강원,홍천군,427,38892,1032,40351,"2021-01-01",2021
"21-Jan",강원,화천군,226,12965,187,13378,"2021-01-01",2021
"21-Jan",강원,횡성군,252,26550,714,27516,"2021-01-01",2021
"21-Jan",강원,계,6059,780014,25113,811186,"2021-01-01",2021
"21-Jan",충북,괴산군,210,23055,407,23672,"2021-01-01",2021
"21-Jan",충북,단양군,223,15652,772,16647,"2021-01-01",2021
"21-Jan",충북,보은군,231,18006,999,19236,"2021-01-01",2021
"21-Jan",충북,영동군,247,24970,392,25609,"2021-01-01",2021
"21-Jan",충북,옥천군,203,26936,1128,28267,"2021-01-01",2021
"21-Jan",충북,음성군,232,58253,1919,60404,"2021-01-01",2021
"21-Jan",충북,제천시,338,66907,3421,70666,"2021-01-01",2021
"21-Jan",충북,증평군,88,19153,768,20009,"2021-01-01",2021
"21-Jan",충북,진천군,213,49494,1361,51068,"2021-01-01",2021
"21-Jan",충북,청원군,1,19,0,20,"2021-01-01",2021
"21-Jan",충북,청주시 상당구,516,90536,2601,93653,"2021-01-01",2021
"21-Jan",충북,청주시 서원구,239,94349,4318,98906,"2021-01-01",2021
"21-Jan",충북,청주시 청원구,347,102380,4008,106735,"2021-01-01",2021
"21-Jan",충북,청주시 흥덕구,362,128516,7818,136696,"2021-01-01",2021
"21-Jan",충북,충주시,593,109289,6277,116159,"2021-01-01",2021
"21-Jan",충북,계,4043,827515,36189,867747,"2021-01-01",2021
"21-Jan",충남,계룡시,157,22069,534,22760,"2021-01-01",2021
"21-Jan",충남,공주시,567,53822,2548,56937,"2021-01-01",2021
"21-Jan",충남,금산군,186,28566,2060,30812,"2021-01-01",2021
"21-Jan",충남,논산시,407,60900,2386,63693,"2021-01-01",2021
"21-Jan",충남,당진시,394,94633,3944,98971,"2021-01-01",2021
"21-Jan",충남,보령시,404,52130,1326,53860,"2021-01-01",2021
"21-Jan",충남,부여군,305,34215,1200,35720,"2021-01-01",2021
"21-Jan",충남,서산시,404,94565,3399,98368,"2021-01-01",2021
"21-Jan",충남,서천군,240,26939,884,28063,"2021-01-01",2021
"21-Jan",충남,아산시,531,166890,6682,174103,"2021-01-01",2021
"21-Jan",충남,예산군,398,42966,1363,44727,"2021-01-01",2021
"21-Jan",충남,천안시 동남구,270,131013,4861,136144,"2021-01-01",2021
"21-Jan",충남,천안시 서북구,532,195256,5509,201297,"2021-01-01",2021
"21-Jan",충남,청양군,250,16891,817,17958,"2021-01-01",2021
"21-Jan",충남,태안군,303,34202,554,35059,"2021-01-01",2021
"21-Jan",충남,홍성군,415,52701,1478,54594,"2021-01-01",2021
"21-Jan",충남,계,5763,1107758,39545,1153066,"2021-01-01",2021
"21-Jan",전북,고창군,292,30404,574,31270,"2021-01-01",2021
"21-Jan",전북,군산시,544,130168,6311,137023,"2021-01-01",2021
"21-Jan",전북,김제시,289,45173,2011,47473,"2021-01-01",2021
"21-Jan",전북,남원시,402,40747,4466,45615,"2021-01-01",2021
"21-Jan",전북,무주군,194,12853,400,13447,"2021-01-01",2021
"21-Jan",전북,부안군,256,27334,617,28207,"2021-01-01",2021
"21-Jan",전북,순창군,237,14559,153,14949,"2021-01-01",2021
"21-Jan",전북,완주군,410,51199,3161,54770,"2021-01-01",2021
"21-Jan",전북,익산시,512,136054,5914,142480,"2021-01-01",2021
"21-Jan",전북,임실군,217,14226,420,14863,"2021-01-01",2021
"21-Jan",전북,장수군,250,12103,174,12527,"2021-01-01",2021
"21-Jan",전북,전주시 덕진구,374,171219,7154,178747,"2021-01-01",2021
"21-Jan",전북,전주시 완산구,722,151174,4210,156106,"2021-01-01",2021
"21-Jan",전북,정읍시,336,54109,3689,58134,"2021-01-01",2021
"21-Jan",전북,진안군,234,13957,226,14417,"2021-01-01",2021
"21-Jan",전북,계,5269,905279,39480,950028,"2021-01-01",2021
"21-Jan",전남,강진군,218,18567,1110,19895,"2021-01-01",2021
"21-Jan",전남,고흥군,299,31989,617,32905,"2021-01-01",2021
"21-Jan",전남,곡성군,155,14704,728,15587,"2021-01-01",2021
"21-Jan",전남,광양시,248,82513,5893,88654,"2021-01-01",2021
"21-Jan",전남,구례군,137,13066,713,13916,"2021-01-01",2021
"21-Jan",전남,나주시,469,64406,3235,68110,"2021-01-01",2021
"21-Jan",전남,담양군,225,26761,1574,28560,"2021-01-01",2021
"21-Jan",전남,목포시,430,95320,5596,101346,"2021-01-01",2021
"21-Jan",전남,무안군,532,46375,1036,47943,"2021-01-01",2021
"21-Jan",전남,보성군,201,21601,24383,46185,"2021-01-01",2021
"21-Jan",전남,순천시,487,140169,5155,145811,"2021-01-01",2021
"21-Jan",전남,신안군,309,20998,47414,68721,"2021-01-01",2021
"21-Jan",전남,여수시,531,131367,7129,139027,"2021-01-01",2021
"21-Jan",전남,영광군,207,27626,780,28613,"2021-01-01",2021
"21-Jan",전남,영암군,263,33412,9292,42967,"2021-01-01",2021
"21-Jan",전남,완도군,279,25371,526,26176,"2021-01-01",2021
"21-Jan",전남,장성군,195,26530,1144,27869,"2021-01-01",2021
"21-Jan",전남,장흥군,259,20033,448,20740,"2021-01-01",2021
"21-Jan",전남,진도군,167,16934,296,17397,"2021-01-01",2021
"21-Jan",전남,함평군,200,18092,27856,46148,"2021-01-01",2021
"21-Jan",전남,해남군,327,39401,6289,46017,"2021-01-01",2021
"21-Jan",전남,화순군,220,32510,2106,34836,"2021-01-01",2021
"21-Jan",전남,계,6358,947745,153320,1107423,"2021-01-01",2021
"21-Jan",경북,경산시,326,137233,4460,142019,"2021-01-01",2021
"21-Jan",경북,경주시,580,140866,4542,145988,"2021-01-01",2021
"21-Jan",경북,고령군,171,20466,685,21322,"2021-01-01",2021
"21-Jan",경북,구미시,546,212747,7124,220417,"2021-01-01",2021
"21-Jan",경북,군위군,125,14868,303,15296,"2021-01-01",2021
"21-Jan",경북,김천시,385,74018,1921,76324,"2021-01-01",2021
"21-Jan",경북,문경시,270,36531,845,37646,"2021-01-01",2021
"21-Jan",경북,봉화군,205,17926,195,18326,"2021-01-01",2021
"21-Jan",경북,상주시,377,52951,1838,55166,"2021-01-01",2021
"21-Jan",경북,성주군,200,30494,1336,32030,"2021-01-01",2021
"21-Jan",경북,안동시,709,82164,2622,85495,"2021-01-01",2021
"21-Jan",경북,영덕군,252,18844,303,19399,"2021-01-01",2021
"21-Jan",경북,영양군,139,9650,115,9904,"2021-01-01",2021
"21-Jan",경북,영주시,368,55424,1529,57321,"2021-01-01",2021
"21-Jan",경북,영천시,311,59412,2558,62281,"2021-01-01",2021
"21-Jan",경북,예천군,262,29741,491,30494,"2021-01-01",2021
"21-Jan",경북,울릉군,150,5125,493,5768,"2021-01-01",2021
"21-Jan",경북,울진군,308,26113,361,26782,"2021-01-01",2021
"21-Jan",경북,의성군,311,30739,1111,32161,"2021-01-01",2021
"21-Jan",경북,청도군,221,24923,781,25925,"2021-01-01",2021
"21-Jan",경북,청송군,194,15634,207,16035,"2021-01-01",2021
"21-Jan",경북,칠곡군,305,68045,2335,70685,"2021-01-01",2021
"21-Jan",경북,포항시 남구,451,120253,8468,129172,"2021-01-01",2021
"21-Jan",경북,포항시 북구,331,139368,3784,143483,"2021-01-01",2021
"21-Jan",경북,계,7497,1423535,48407,1479439,"2021-01-01",2021
"21-Jan",경남,거제시,360,106080,2084,108524,"2021-01-01",2021
"21-Jan",경남,거창군,263,32057,808,33128,"2021-01-01",2021
"21-Jan",경남,고성군,226,26306,601,27133,"2021-01-01",2021
"21-Jan",경남,김해시,656,274368,7299,282323,"2021-01-01",2021
"21-Jan",경남,남해군,276,19720,461,20457,"2021-01-01",2021
"21-Jan",경남,밀양시,329,55609,3993,59931,"2021-01-01",2021
"21-Jan",경남,사천시,310,56257,1535,58102,"2021-01-01",2021
"21-Jan",경남,산청군,242,20038,781,21061,"2021-01-01",2021
"21-Jan",경남,양산시,417,164491,10115,175023,"2021-01-01",2021
"21-Jan",경남,의령군,202,14433,708,15343,"2021-01-01",2021
"21-Jan",경남,진주시,631,164658,6408,171697,"2021-01-01",2021
"21-Jan",경남,창녕군,238,35322,892,36452,"2021-01-01",2021
"21-Jan",경남,창원시 마산합포구,320,95831,2881,99032,"2021-01-01",2021
"21-Jan",경남,창원시 마산회원구,179,94838,4616,99633,"2021-01-01",2021
"21-Jan",경남,창원시 성산구,142,117543,2848,120533,"2021-01-01",2021
"21-Jan",경남,창원시 의창구,935,141195,47026,189156,"2021-01-01",2021
"21-Jan",경남,창원시 진해구,211,91006,1807,93024,"2021-01-01",2021
"21-Jan",경남,통영시,324,52440,1411,54175,"2021-01-01",2021
"21-Jan",경남,하동군,229,24066,401,24696,"2021-01-01",2021
"21-Jan",경남,함안군,193,40414,19855,60462,"2021-01-01",2021
"21-Jan",경남,함양군,219,19314,427,19960,"2021-01-01",2021
"21-Jan",경남,합천군,267,23089,622,23978,"2021-01-01",2021
"21-Jan",경남,계,7169,1669075,117579,1793823,"2021-01-01",2021
"21-Jan",제주,서귀포시,814,103458,2019,106291,"2021-01-01",2021
"21-Jan",제주,제주시,1638,279425,230586,511649,"2021-01-01",2021
"21-Jan",제주,계,2452,382883,232605,617940,"2021-01-01",2021
"21-Feb",서울,강남구,395,217161,18459,236015,"2021-02-01",2021
"21-Feb",서울,강동구,292,142118,8902,151312,"2021-02-01",2021
"21-Feb",서울,강북구,317,71001,4256,75574,"2021-02-01",2021
"21-Feb",서울,강서구,336,185158,18859,204353,"2021-02-01",2021
"21-Feb",서울,관악구,317,113192,5549,119058,"2021-02-01",2021
"21-Feb",서울,광진구,296,92802,5540,98638,"2021-02-01",2021
"21-Feb",서울,구로구,298,131995,12034,144327,"2021-02-01",2021
"21-Feb",서울,금천구,136,82433,6337,88906,"2021-02-01",2021
"21-Feb",서울,노원구,322,143132,9235,152689,"2021-02-01",2021
"21-Feb",서울,도봉구,274,88003,7352,95629,"2021-02-01",2021
"21-Feb",서울,동대문구,307,92848,4959,98114,"2021-02-01",2021
"21-Feb",서울,동작구,323,102373,2785,105481,"2021-02-01",2021
"21-Feb",서울,마포구,337,112054,6952,119343,"2021-02-01",2021
"21-Feb",서울,서대문구,456,83184,5865,89505,"2021-02-01",2021
"21-Feb",서울,서초구,533,167875,10780,179188,"2021-02-01",2021
"21-Feb",서울,성동구,344,94010,12161,106515,"2021-02-01",2021
"21-Feb",서울,성북구,292,115241,5191,120724,"2021-02-01",2021
"21-Feb",서울,송파구,390,232072,13105,245567,"2021-02-01",2021
"21-Feb",서울,양천구,315,142714,8648,151677,"2021-02-01",2021
"21-Feb",서울,영등포구,373,137067,9132,146572,"2021-02-01",2021
"21-Feb",서울,용산구,338,76662,2047,79047,"2021-02-01",2021
"21-Feb",서울,은평구,297,124785,7063,132145,"2021-02-01",2021
"21-Feb",서울,종로구,3831,44729,1700,50260,"2021-02-01",2021
"21-Feb",서울,중구,1319,45636,6251,53206,"2021-02-01",2021
"21-Feb",서울,중랑구,253,104545,9459,114257,"2021-02-01",2021
"21-Feb",서울,계,12691,2942790,202621,3158102,"2021-02-01",2021
"21-Feb",부산,강서구,308,78573,3568,82449,"2021-02-01",2021
"21-Feb",부산,금정구,276,80513,7585,88374,"2021-02-01",2021
"21-Feb",부산,기장군,258,79351,2548,82157,"2021-02-01",2021
"21-Feb",부산,남구,223,91307,8311,99841,"2021-02-01",2021
"21-Feb",부산,동구,180,47926,4940,53046,"2021-02-01",2021
"21-Feb",부산,동래구,173,93084,3999,97256,"2021-02-01",2021
"21-Feb",부산,부산진구,359,123970,20228,144557,"2021-02-01",2021
"21-Feb",부산,북구,230,100076,3444,103750,"2021-02-01",2021
"21-Feb",부산,사상구,282,83407,5935,89624,"2021-02-01",2021
"21-Feb",부산,사하구,261,106842,6659,113762,"2021-02-01",2021
"21-Feb",부산,서구,135,29035,1391,30561,"2021-02-01",2021
"21-Feb",부산,수영구,164,67146,33687,100997,"2021-02-01",2021
"21-Feb",부산,연제구,930,90230,10884,102044,"2021-02-01",2021
"21-Feb",부산,영도구,222,30877,1967,33066,"2021-02-01",2021
"21-Feb",부산,중구,304,28724,7027,36055,"2021-02-01",2021
"21-Feb",부산,해운대구,315,165396,12224,177935,"2021-02-01",2021
"21-Feb",부산,계,4620,1296457,134397,1435474,"2021-02-01",2021
"21-Feb",대구,남구,348,56167,1656,58171,"2021-02-01",2021
"21-Feb",대구,달서구,487,270806,14057,285350,"2021-02-01",2021
"21-Feb",대구,달성군,538,133919,5065,139522,"2021-02-01",2021
"21-Feb",대구,동구,348,153691,11063,165102,"2021-02-01",2021
"21-Feb",대구,북구,497,201770,7539,209806,"2021-02-01",2021
"21-Feb",대구,서구,246,69305,3923,73474,"2021-02-01",2021
"21-Feb",대구,수성구,572,215625,5271,221468,"2021-02-01",2021
"21-Feb",대구,중구,297,65839,2544,68680,"2021-02-01",2021
"21-Feb",대구,계,3333,1167122,51118,1221573,"2021-02-01",2021
"21-Feb",인천,강화군,342,34940,36514,71796,"2021-02-01",2021
"21-Feb",인천,계양구,291,119601,194918,314810,"2021-02-01",2021
"21-Feb",인천,남동구,826,255378,51441,307645,"2021-02-01",2021
"21-Feb",인천,동구,92,24767,2580,27439,"2021-02-01",2021
"21-Feb",인천,미추홀구,424,161632,10202,172258,"2021-02-01",2021
"21-Feb",인천,부평구,324,215692,22831,238847,"2021-02-01",2021
"21-Feb",인천,서구,426,239983,11319,251728,"2021-02-01",2021
"21-Feb",인천,연수구,410,194274,8138,202822,"2021-02-01",2021
"21-Feb",인천,옹진군,208,12049,212,12469,"2021-02-01",2021
"21-Feb",인천,중구,638,64456,11835,76929,"2021-02-01",2021
"21-Feb",인천,계,3981,1322772,349990,1676743,"2021-02-01",2021
"21-Feb",광주,광산구,516,195069,12402,207987,"2021-02-01",2021
"21-Feb",광주,남구,211,90436,2828,93475,"2021-02-01",2021
"21-Feb",광주,동구,232,42436,1276,43944,"2021-02-01",2021
"21-Feb",광주,북구,607,189497,8984,199088,"2021-02-01",2021
"21-Feb",광주,서구,633,141973,6494,149100,"2021-02-01",2021
"21-Feb",광주,계,2199,659411,31984,693594,"2021-02-01",2021
"21-Feb",대전,대덕구,237,85945,6825,93007,"2021-02-01",2021
"21-Feb",대전,동구,246,90747,4670,95663,"2021-02-01",2021
"21-Feb",대전,서구,805,205695,7454,213954,"2021-02-01",2021
"21-Feb",대전,유성구,378,177747,4961,183086,"2021-02-01",2021
"21-Feb",대전,중구,231,96546,5725,102502,"2021-02-01",2021
"21-Feb",대전,계,1897,656680,29635,688212,"2021-02-01",2021
"21-Feb",울산,남구,705,153925,7358,161988,"2021-02-01",2021
"21-Feb",울산,동구,184,61726,1067,62977,"2021-02-01",2021
"21-Feb",울산,북구,219,114770,3789,118778,"2021-02-01",2021
"21-Feb",울산,울주군,380,123522,6822,130724,"2021-02-01",2021
"21-Feb",울산,중구,330,100374,2561,103265,"2021-02-01",2021
"21-Feb",울산,계,1818,554317,21597,577732,"2021-02-01",2021
"21-Feb",세종,세종특별자치시,781,173564,2874,177219,"2021-02-01",2021
"21-Feb",세종,계,781,173564,2874,177219,"2021-02-01",2021
"21-Feb",경기,가평군,375,30735,564,31674,"2021-02-01",2021
"21-Feb",경기,고양시 덕양구,663,179601,3897,184161,"2021-02-01",2021
"21-Feb",경기,고양시 일산동구,273,124297,5715,130285,"2021-02-01",2021
"21-Feb",경기,고양시 일산서구,123,116427,4275,120825,"2021-02-01",2021
"21-Feb",경기,과천시,719,24631,612,25962,"2021-02-01",2021
"21-Feb",경기,광명시,302,99583,4283,104168,"2021-02-01",2021
"21-Feb",경기,광주시,386,191323,8341,200050,"2021-02-01",2021
"21-Feb",경기,구리시,263,70545,2659,73467,"2021-02-01",2021
"21-Feb",경기,군포시,297,98061,5125,103483,"2021-02-01",2021
"21-Feb",경기,김포시,510,223354,7702,231566,"2021-02-01",2021
"21-Feb",경기,남양주시,756,297199,8338,306293,"2021-02-01",2021
"21-Feb",경기,동두천시,216,37895,1445,39556,"2021-02-01",2021
"21-Feb",경기,부천시,690,293910,12406,307006,"2021-02-01",2021
"21-Feb",경기,성남시 분당구,367,183714,6825,190906,"2021-02-01",2021
"21-Feb",경기,성남시 수정구,358,77083,2516,79957,"2021-02-01",2021
"21-Feb",경기,성남시 중원구,341,71381,4143,75865,"2021-02-01",2021
"21-Feb",경기,수원시 권선구,487,191086,8703,200276,"2021-02-01",2021
"21-Feb",경기,수원시 영통구,225,147081,3140,150446,"2021-02-01",2021
"21-Feb",경기,수원시 장안구,459,101273,3864,105596,"2021-02-01",2021
"21-Feb",경기,수원시 팔달구,504,69603,2974,73081,"2021-02-01",2021
"21-Feb",경기,시흥시,458,246668,7857,254983,"2021-02-01",2021
"21-Feb",경기,안산시 단원구,555,154484,8086,163125,"2021-02-01",2021
"21-Feb",경기,안산시 상록구,173,143071,4996,148240,"2021-02-01",2021
"21-Feb",경기,안성시,395,103813,4907,109115,"2021-02-01",2021
"21-Feb",경기,안양시 동안구,402,116644,6302,123348,"2021-02-01",2021
"21-Feb",경기,안양시 만안구,153,82857,3865,86875,"2021-02-01",2021
"21-Feb",경기,양주시,377,108161,3186,111724,"2021-02-01",2021
"21-Feb",경기,양평군,568,60285,1843,62696,"2021-02-01",2021
"21-Feb",경기,여주시,443,62987,7490,70920,"2021-02-01",2021
"21-Feb",경기,연천군,305,23798,5283,29386,"2021-02-01",2021
"21-Feb",경기,오산시,209,106827,3449,110485,"2021-02-01",2021
"21-Feb",경기,용인시 기흥구,122,188162,6361,194645,"2021-02-01",2021
"21-Feb",경기,용인시 수지구,50,145066,2473,147589,"2021-02-01",2021
"21-Feb",경기,용인시 처인구,756,131130,7399,139285,"2021-02-01",2021
"21-Feb",경기,의왕시,296,64418,2900,67614,"2021-02-01",2021
"21-Feb",경기,의정부시,720,162890,5129,168739,"2021-02-01",2021
"21-Feb",경기,이천시,407,112892,5959,119258,"2021-02-01",2021
"21-Feb",경기,파주시,531,213839,10247,224617,"2021-02-01",2021
"21-Feb",경기,평택시,727,283145,12259,296131,"2021-02-01",2021
"21-Feb",경기,포천시,386,85581,9722,95689,"2021-02-01",2021
"21-Feb",경기,하남시,397,123195,2865,126457,"2021-02-01",2021
"21-Feb",경기,화성시,920,446245,12050,459215,"2021-02-01",2021
"21-Feb",경기,계,17664,5794940,232155,6044759,"2021-02-01",2021
"21-Feb",강원,강릉시,537,107856,4540,112933,"2021-02-01",2021
"21-Feb",강원,고성군,189,14345,227,14761,"2021-02-01",2021
"21-Feb",강원,동해시,305,45215,1429,46949,"2021-02-01",2021
"21-Feb",강원,삼척시,392,32231,771,33394,"2021-02-01",2021
"21-Feb",강원,속초시,302,38260,1395,39957,"2021-02-01",2021
"21-Feb",강원,양구군,191,12002,139,12332,"2021-02-01",2021
"21-Feb",강원,양양군,187,15847,299,16333,"2021-02-01",2021
"21-Feb",강원,영월군,329,21169,354,21852,"2021-02-01",2021
"21-Feb",강원,원주시,582,174870,5659,181111,"2021-02-01",2021
"21-Feb",강원,인제군,214,18450,283,18947,"2021-02-01",2021
"21-Feb",강원,정선군,336,20773,486,21595,"2021-02-01",2021
"21-Feb",강원,철원군,239,24131,306,24676,"2021-02-01",2021
"21-Feb",강원,춘천시,822,133199,6050,140071,"2021-02-01",2021
"21-Feb",강원,태백시,229,20004,726,20959,"2021-02-01",2021
"21-Feb",강원,평창군,291,25567,502,26360,"2021-02-01",2021
"21-Feb",강원,홍천군,425,38999,1023,40447,"2021-02-01",2021
"21-Feb",강원,화천군,226,12965,186,13377,"2021-02-01",2021
"21-Feb",강원,횡성군,252,26644,719,27615,"2021-02-01",2021
"21-Feb",강원,계,6048,782527,25094,813669,"2021-02-01",2021
"21-Feb",충북,괴산군,209,23003,407,23619,"2021-02-01",2021
"21-Feb",충북,단양군,223,15685,789,16697,"2021-02-01",2021
"21-Feb",충북,보은군,230,18104,998,19332,"2021-02-01",2021
"21-Feb",충북,영동군,247,24993,393,25633,"2021-02-01",2021
"21-Feb",충북,옥천군,204,27008,1130,28342,"2021-02-01",2021
"21-Feb",충북,음성군,230,58338,1927,60495,"2021-02-01",2021
"21-Feb",충북,제천시,336,66948,3417,70701,"2021-02-01",2021
"21-Feb",충북,증평군,88,19202,768,20058,"2021-02-01",2021
"21-Feb",충북,진천군,213,49748,1349,51310,"2021-02-01",2021
"21-Feb",충북,청원군,1,19,0,20,"2021-02-01",2021
"21-Feb",충북,청주시 상당구,515,91593,2652,94760,"2021-02-01",2021
"21-Feb",충북,청주시 서원구,236,94134,4279,98649,"2021-02-01",2021
"21-Feb",충북,청주시 청원구,339,102446,3998,106783,"2021-02-01",2021
"21-Feb",충북,청주시 흥덕구,354,128975,7761,137090,"2021-02-01",2021
"21-Feb",충북,충주시,590,109637,6533,116760,"2021-02-01",2021
"21-Feb",충북,계,4015,829833,36401,870249,"2021-02-01",2021
"21-Feb",충남,계룡시,157,22326,532,23015,"2021-02-01",2021
"21-Feb",충남,공주시,571,53906,2526,57003,"2021-02-01",2021
"21-Feb",충남,금산군,187,28742,2063,30992,"2021-02-01",2021
"21-Feb",충남,논산시,409,60920,2383,63712,"2021-02-01",2021
"21-Feb",충남,당진시,395,94911,3983,99289,"2021-02-01",2021
"21-Feb",충남,보령시,406,52158,1326,53890,"2021-02-01",2021
"21-Feb",충남,부여군,306,34263,1202,35771,"2021-02-01",2021
"21-Feb",충남,서산시,412,94896,3372,98680,"2021-02-01",2021
"21-Feb",충남,서천군,239,27012,883,28134,"2021-02-01",2021
"21-Feb",충남,아산시,519,167837,6671,175027,"2021-02-01",2021
"21-Feb",충남,예산군,399,43035,1372,44806,"2021-02-01",2021
"21-Feb",충남,천안시 동남구,272,131044,4928,136244,"2021-02-01",2021
"21-Feb",충남,천안시 서북구,530,195606,5485,201621,"2021-02-01",2021
"21-Feb",충남,청양군,249,16926,824,17999,"2021-02-01",2021
"21-Feb",충남,태안군,305,34174,555,35034,"2021-02-01",2021
"21-Feb",충남,홍성군,415,52765,1477,54657,"2021-02-01",2021
"21-Feb",충남,계,5771,1110521,39582,1155874,"2021-02-01",2021
"21-Feb",전북,고창군,295,30516,573,31384,"2021-02-01",2021
"21-Feb",전북,군산시,543,130360,6295,137198,"2021-02-01",2021
"21-Feb",전북,김제시,288,45321,2009,47618,"2021-02-01",2021
"21-Feb",전북,남원시,402,40791,4388,45581,"2021-02-01",2021
"21-Feb",전북,무주군,196,12879,401,13476,"2021-02-01",2021
"21-Feb",전북,부안군,261,27448,615,28324,"2021-02-01",2021
"21-Feb",전북,순창군,241,14582,150,14973,"2021-02-01",2021
"21-Feb",전북,완주군,408,51326,3158,54892,"2021-02-01",2021
"21-Feb",전북,익산시,512,135971,5908,142391,"2021-02-01",2021
"21-Feb",전북,임실군,216,14183,428,14827,"2021-02-01",2021
"21-Feb",전북,장수군,233,12145,175,12553,"2021-02-01",2021
"21-Feb",전북,전주시 덕진구,367,171921,7076,179364,"2021-02-01",2021
"21-Feb",전북,전주시 완산구,729,151481,4239,156449,"2021-02-01",2021
"21-Feb",전북,정읍시,337,54263,3633,58233,"2021-02-01",2021
"21-Feb",전북,진안군,255,13999,227,14481,"2021-02-01",2021
"21-Feb",전북,계,5283,907186,39275,951744,"2021-02-01",2021
"21-Feb",전남,강진군,218,18582,1109,19909,"2021-02-01",2021
"21-Feb",전남,고흥군,301,32093,617,33011,"2021-02-01",2021
"21-Feb",전남,곡성군,157,14806,724,15687,"2021-02-01",2021
"21-Feb",전남,광양시,248,82887,5902,89037,"2021-02-01",2021
"21-Feb",전남,구례군,139,13078,719,13936,"2021-02-01",2021
"21-Feb",전남,나주시,472,64694,3209,68375,"2021-02-01",2021
"21-Feb",전남,담양군,224,26884,1579,28687,"2021-02-01",2021
"21-Feb",전남,목포시,428,95166,5589,101183,"2021-02-01",2021
"21-Feb",전남,무안군,526,46802,1042,48370,"2021-02-01",2021
"21-Feb",전남,보성군,202,21669,23461,45332,"2021-02-01",2021
"21-Feb",전남,순천시,487,140336,5171,145994,"2021-02-01",2021
"21-Feb",전남,신안군,303,21261,49929,71493,"2021-02-01",2021
"21-Feb",전남,여수시,529,131756,7144,139429,"2021-02-01",2021
"21-Feb",전남,영광군,206,27705,779,28690,"2021-02-01",2021
"21-Feb",전남,영암군,262,33456,8963,42681,"2021-02-01",2021
"21-Feb",전남,완도군,279,25421,534,26234,"2021-02-01",2021
"21-Feb",전남,장성군,195,26682,1146,28023,"2021-02-01",2021
"21-Feb",전남,장흥군,256,20014,448,20718,"2021-02-01",2021
"21-Feb",전남,진도군,167,16987,297,17451,"2021-02-01",2021
"21-Feb",전남,함평군,200,18131,27712,46043,"2021-02-01",2021
"21-Feb",전남,해남군,324,39503,9116,48943,"2021-02-01",2021
"21-Feb",전남,화순군,222,32557,2124,34903,"2021-02-01",2021
"21-Feb",전남,계,6345,950470,157314,1114129,"2021-02-01",2021
"21-Feb",경북,경산시,326,136986,4429,141741,"2021-02-01",2021
"21-Feb",경북,경주시,581,141357,4555,146493,"2021-02-01",2021
"21-Feb",경북,고령군,171,20511,684,21366,"2021-02-01",2021
"21-Feb",경북,구미시,545,212794,7133,220472,"2021-02-01",2021
"21-Feb",경북,군위군,125,14895,301,15321,"2021-02-01",2021
"21-Feb",경북,김천시,387,74258,1922,76567,"2021-02-01",2021
"21-Feb",경북,문경시,269,36745,844,37858,"2021-02-01",2021
"21-Feb",경북,봉화군,205,17922,195,18322,"2021-02-01",2021
"21-Feb",경북,상주시,380,53136,1837,55353,"2021-02-01",2021
"21-Feb",경북,성주군,199,30531,1330,32060,"2021-02-01",2021
"21-Feb",경북,안동시,713,82347,2635,85695,"2021-02-01",2021
"21-Feb",경북,영덕군,252,18946,308,19506,"2021-02-01",2021
"21-Feb",경북,영양군,140,9703,113,9956,"2021-02-01",2021
"21-Feb",경북,영주시,366,55608,1527,57501,"2021-02-01",2021
"21-Feb",경북,영천시,315,59656,2556,62527,"2021-02-01",2021
"21-Feb",경북,예천군,265,29868,494,30627,"2021-02-01",2021
"21-Feb",경북,울릉군,151,5189,499,5839,"2021-02-01",2021
"21-Feb",경북,울진군,308,26126,357,26791,"2021-02-01",2021
"21-Feb",경북,의성군,312,30782,1106,32200,"2021-02-01",2021
"21-Feb",경북,청도군,220,24976,784,25980,"2021-02-01",2021
"21-Feb",경북,청송군,194,15698,206,16098,"2021-02-01",2021
"21-Feb",경북,칠곡군,305,68299,2333,70937,"2021-02-01",2021
"21-Feb",경북,포항시 남구,452,120578,8492,129522,"2021-02-01",2021
"21-Feb",경북,포항시 북구,333,139683,3760,143776,"2021-02-01",2021
"21-Feb",경북,계,7514,1426594,48400,1482508,"2021-02-01",2021
"21-Feb",경남,거제시,366,106286,2077,108729,"2021-02-01",2021
"21-Feb",경남,거창군,264,32235,810,33309,"2021-02-01",2021
"21-Feb",경남,고성군,224,26363,596,27183,"2021-02-01",2021
"21-Feb",경남,김해시,650,275061,7340,283051,"2021-02-01",2021
"21-Feb",경남,남해군,273,19800,457,20530,"2021-02-01",2021
"21-Feb",경남,밀양시,329,55738,3975,60042,"2021-02-01",2021
"21-Feb",경남,사천시,313,56428,1541,58282,"2021-02-01",2021
"21-Feb",경남,산청군,242,20129,786,21157,"2021-02-01",2021
"21-Feb",경남,양산시,416,165033,10088,175537,"2021-02-01",2021
"21-Feb",경남,의령군,202,14486,706,15394,"2021-02-01",2021
"21-Feb",경남,진주시,631,164915,6385,171931,"2021-02-01",2021
"21-Feb",경남,창녕군,241,35428,888,36557,"2021-02-01",2021
"21-Feb",경남,창원시 마산합포구,320,96411,2893,99624,"2021-02-01",2021
"21-Feb",경남,창원시 마산회원구,178,94874,4601,99653,"2021-02-01",2021
"21-Feb",경남,창원시 성산구,144,117980,2871,120995,"2021-02-01",2021
"21-Feb",경남,창원시 의창구,932,141650,47733,190315,"2021-02-01",2021
"21-Feb",경남,창원시 진해구,212,91191,1821,93224,"2021-02-01",2021
"21-Feb",경남,통영시,321,52419,1407,54147,"2021-02-01",2021
"21-Feb",경남,하동군,227,24055,401,24683,"2021-02-01",2021
"21-Feb",경남,함안군,193,40489,20407,61089,"2021-02-01",2021
"21-Feb",경남,함양군,214,19364,433,20011,"2021-02-01",2021
"21-Feb",경남,합천군,269,23173,616,24058,"2021-02-01",2021
"21-Feb",경남,계,7161,1673508,118832,1799501,"2021-02-01",2021
"21-Feb",제주,서귀포시,816,103680,2015,106511,"2021-02-01",2021
"21-Feb",제주,제주시,1644,280091,233192,514927,"2021-02-01",2021
"21-Feb",제주,계,2460,383771,235207,621438,"2021-02-01",2021
"21-Mar",서울,강남구,395,217099,18302,235796,"2021-03-01",2021
"21-Mar",서울,강동구,294,142863,8846,152003,"2021-03-01",2021
"21-Mar",서울,강북구,317,70991,4262,75570,"2021-03-01",2021
"21-Mar",서울,강서구,335,185126,18785,204246,"2021-03-01",2021
"21-Mar",서울,관악구,318,113079,5546,118943,"2021-03-01",2021
"21-Mar",서울,광진구,297,92800,5561,98658,"2021-03-01",2021
"21-Mar",서울,구로구,299,132157,12211,144667,"2021-03-01",2021
"21-Mar",서울,금천구,136,82489,6320,88945,"2021-03-01",2021
"21-Mar",서울,노원구,321,143175,9205,152701,"2021-03-01",2021
"21-Mar",서울,도봉구,263,87880,7319,95462,"2021-03-01",2021
"21-Mar",서울,동대문구,303,92917,4950,98170,"2021-03-01",2021
"21-Mar",서울,동작구,322,102606,2794,105722,"2021-03-01",2021
"21-Mar",서울,마포구,340,112108,6932,119380,"2021-03-01",2021
"21-Mar",서울,서대문구,457,83289,5832,89578,"2021-03-01",2021
"21-Mar",서울,서초구,537,167500,10741,178778,"2021-03-01",2021
"21-Mar",서울,성동구,347,93727,12361,106435,"2021-03-01",2021
"21-Mar",서울,성북구,293,115427,5189,120909,"2021-03-01",2021
"21-Mar",서울,송파구,388,232009,13168,245565,"2021-03-01",2021
"21-Mar",서울,양천구,316,142698,8612,151626,"2021-03-01",2021
"21-Mar",서울,영등포구,372,137119,9134,146625,"2021-03-01",2021
"21-Mar",서울,용산구,339,77084,2063,79486,"2021-03-01",2021
"21-Mar",서울,은평구,298,124723,7031,132052,"2021-03-01",2021
"21-Mar",서울,종로구,3755,44600,1694,50049,"2021-03-01",2021
"21-Mar",서울,중구,1317,45642,6148,53107,"2021-03-01",2021
"21-Mar",서울,중랑구,251,104570,9416,114237,"2021-03-01",2021
"21-Mar",서울,계,12610,2943678,202422,3158710,"2021-03-01",2021
"21-Mar",부산,강서구,308,78999,3615,82922,"2021-03-01",2021
"21-Mar",부산,금정구,273,80519,7522,88314,"2021-03-01",2021
"21-Mar",부산,기장군,259,79704,2572,82535,"2021-03-01",2021
"21-Mar",부산,남구,218,91269,8315,99802,"2021-03-01",2021
"21-Mar",부산,동구,180,48571,4985,53736,"2021-03-01",2021
"21-Mar",부산,동래구,172,93062,3988,97222,"2021-03-01",2021
"21-Mar",부산,부산진구,371,124229,20669,145269,"2021-03-01",2021
"21-Mar",부산,북구,228,100133,3439,103800,"2021-03-01",2021
"21-Mar",부산,사상구,281,83186,5916,89383,"2021-03-01",2021
"21-Mar",부산,사하구,263,106891,6668,113822,"2021-03-01",2021
"21-Mar",부산,서구,134,29062,1394,30590,"2021-03-01",2021
"21-Mar",부산,수영구,162,67049,33636,100847,"2021-03-01",2021
"21-Mar",부산,연제구,940,90215,11080,102235,"2021-03-01",2021
"21-Mar",부산,영도구,222,30862,1956,33040,"2021-03-01",2021
"21-Mar",부산,중구,306,28966,7003,36275,"2021-03-01",2021
"21-Mar",부산,해운대구,317,165448,12199,177964,"2021-03-01",2021
"21-Mar",부산,계,4634,1298165,134957,1437756,"2021-03-01",2021
"21-Mar",대구,남구,340,56178,1654,58172,"2021-03-01",2021
"21-Mar",대구,달서구,490,271167,14127,285784,"2021-03-01",2021
"21-Mar",대구,달성군,534,134426,5075,140035,"2021-03-01",2021
"21-Mar",대구,동구,348,154531,11140,166019,"2021-03-01",2021
"21-Mar",대구,북구,497,201734,7557,209788,"2021-03-01",2021
"21-Mar",대구,서구,248,69180,3929,73357,"2021-03-01",2021
"21-Mar",대구,수성구,570,215720,5265,221555,"2021-03-01",2021
"21-Mar",대구,중구,297,65359,2527,68183,"2021-03-01",2021
"21-Mar",대구,계,3324,1168295,51274,1222893,"2021-03-01",2021
"21-Mar",인천,강화군,340,34984,35340,70664,"2021-03-01",2021
"21-Mar",인천,계양구,289,120038,193176,313503,"2021-03-01",2021
"21-Mar",인천,남동구,833,255845,51376,308054,"2021-03-01",2021
"21-Mar",인천,동구,92,24559,2573,27224,"2021-03-01",2021
"21-Mar",인천,미추홀구,421,162288,10023,172732,"2021-03-01",2021
"21-Mar",인천,부평구,329,216217,23566,240112,"2021-03-01",2021
"21-Mar",인천,서구,433,239727,11221,251381,"2021-03-01",2021
"21-Mar",인천,연수구,412,195160,8209,203781,"2021-03-01",2021
"21-Mar",인천,옹진군,212,12063,212,12487,"2021-03-01",2021
"21-Mar",인천,중구,632,64692,11915,77239,"2021-03-01",2021
"21-Mar",인천,계,3993,1325573,347611,1677177,"2021-03-01",2021
"21-Mar",광주,광산구,517,195789,12312,208618,"2021-03-01",2021
"21-Mar",광주,남구,211,90807,2831,93849,"2021-03-01",2021
"21-Mar",광주,동구,232,42435,1340,44007,"2021-03-01",2021
"21-Mar",광주,북구,594,189808,8862,199264,"2021-03-01",2021
"21-Mar",광주,서구,633,141718,6529,148880,"2021-03-01",2021
"21-Mar",광주,계,2187,660557,31874,694618,"2021-03-01",2021
"21-Mar",대전,대덕구,235,85799,6803,92837,"2021-03-01",2021
"21-Mar",대전,동구,244,91108,4642,95994,"2021-03-01",2021
"21-Mar",대전,서구,804,205967,7455,214226,"2021-03-01",2021
"21-Mar",대전,유성구,374,177563,4929,182866,"2021-03-01",2021
"21-Mar",대전,중구,233,96710,5744,102687,"2021-03-01",2021
"21-Mar",대전,계,1890,657147,29573,688610,"2021-03-01",2021
"21-Mar",울산,남구,706,154132,7332,162170,"2021-03-01",2021
"21-Mar",울산,동구,184,61902,1068,63154,"2021-03-01",2021
"21-Mar",울산,북구,221,114987,3767,118975,"2021-03-01",2021
"21-Mar",울산,울주군,382,123853,6826,131061,"2021-03-01",2021
"21-Mar",울산,중구,329,100471,2556,103356,"2021-03-01",2021
"21-Mar",울산,계,1822,555345,21549,578716,"2021-03-01",2021
"21-Mar",세종,세종특별자치시,791,174607,2892,178290,"2021-03-01",2021
"21-Mar",세종,계,791,174607,2892,178290,"2021-03-01",2021
"21-Mar",경기,가평군,378,30849,568,31795,"2021-03-01",2021
"21-Mar",경기,고양시 덕양구,664,180241,3891,184796,"2021-03-01",2021
"21-Mar",경기,고양시 일산동구,269,124469,5659,130397,"2021-03-01",2021
"21-Mar",경기,고양시 일산서구,123,116281,4292,120696,"2021-03-01",2021
"21-Mar",경기,과천시,717,25088,614,26419,"2021-03-01",2021
"21-Mar",경기,광명시,302,99471,4415,104188,"2021-03-01",2021
"21-Mar",경기,광주시,378,191720,8356,200454,"2021-03-01",2021
"21-Mar",경기,구리시,263,70505,2664,73432,"2021-03-01",2021
"21-Mar",경기,군포시,298,97932,5115,103345,"2021-03-01",2021
"21-Mar",경기,김포시,510,224288,7742,232540,"2021-03-01",2021
"21-Mar",경기,남양주시,748,298425,8351,307524,"2021-03-01",2021
"21-Mar",경기,동두천시,213,37813,1439,39465,"2021-03-01",2021
"21-Mar",경기,부천시,698,293433,12489,306620,"2021-03-01",2021
"21-Mar",경기,성남시 분당구,366,183567,6801,190734,"2021-03-01",2021
"21-Mar",경기,성남시 수정구,356,76847,2502,79705,"2021-03-01",2021
"21-Mar",경기,성남시 중원구,346,71568,4143,76057,"2021-03-01",2021
"21-Mar",경기,수원시 권선구,487,189366,8750,198603,"2021-03-01",2021
"21-Mar",경기,수원시 영통구,226,146851,3133,150210,"2021-03-01",2021
"21-Mar",경기,수원시 장안구,463,100940,3811,105214,"2021-03-01",2021
"21-Mar",경기,수원시 팔달구,506,71393,3016,74915,"2021-03-01",2021
"21-Mar",경기,시흥시,457,247487,7919,255863,"2021-03-01",2021
"21-Mar",경기,안산시 단원구,555,154432,8050,163037,"2021-03-01",2021
"21-Mar",경기,안산시 상록구,173,143330,5008,148511,"2021-03-01",2021
"21-Mar",경기,안성시,393,104116,4901,109410,"2021-03-01",2021
"21-Mar",경기,안양시 동안구,403,117252,6326,123981,"2021-03-01",2021
"21-Mar",경기,안양시 만안구,158,83074,3864,87096,"2021-03-01",2021
"21-Mar",경기,양주시,373,108892,3190,112455,"2021-03-01",2021
"21-Mar",경기,양평군,555,60220,1833,62608,"2021-03-01",2021
"21-Mar",경기,여주시,445,63021,7400,70866,"2021-03-01",2021
"21-Mar",경기,연천군,304,23841,5272,29417,"2021-03-01",2021
"21-Mar",경기,오산시,207,107291,3459,110957,"2021-03-01",2021
"21-Mar",경기,용인시 기흥구,121,187923,6355,194399,"2021-03-01",2021
"21-Mar",경기,용인시 수지구,50,145398,2485,147933,"2021-03-01",2021
"21-Mar",경기,용인시 처인구,760,131516,7476,139752,"2021-03-01",2021
"21-Mar",경기,의왕시,296,64338,2874,67508,"2021-03-01",2021
"21-Mar",경기,의정부시,724,162603,5146,168473,"2021-03-01",2021
"21-Mar",경기,이천시,408,113011,5952,119371,"2021-03-01",2021
"21-Mar",경기,파주시,528,214932,10179,225639,"2021-03-01",2021
"21-Mar",경기,평택시,731,284876,12304,297911,"2021-03-01",2021
"21-Mar",경기,포천시,385,85600,9503,95488,"2021-03-01",2021
"21-Mar",경기,하남시,398,124423,2900,127721,"2021-03-01",2021
"21-Mar",경기,화성시,925,447311,12119,460355,"2021-03-01",2021
"21-Mar",경기,계,17660,5805934,232266,6055860,"2021-03-01",2021
"21-Mar",강원,강릉시,539,108234,4506,113279,"2021-03-01",2021
"21-Mar",강원,고성군,184,14381,230,14795,"2021-03-01",2021
"21-Mar",강원,동해시,306,45347,1437,47090,"2021-03-01",2021
"21-Mar",강원,삼척시,396,32380,772,33548,"2021-03-01",2021
"21-Mar",강원,속초시,301,38190,1385,39876,"2021-03-01",2021
"21-Mar",강원,양구군,195,12057,139,12391,"2021-03-01",2021
"21-Mar",강원,양양군,187,15906,304,16397,"2021-03-01",2021
"21-Mar",강원,영월군,327,21115,353,21795,"2021-03-01",2021
"21-Mar",강원,원주시,581,175682,5620,181883,"2021-03-01",2021
"21-Mar",강원,인제군,216,18449,277,18942,"2021-03-01",2021
"21-Mar",강원,정선군,337,20741,482,21560,"2021-03-01",2021
"21-Mar",강원,철원군,236,24199,305,24740,"2021-03-01",2021
"21-Mar",강원,춘천시,821,133513,6067,140401,"2021-03-01",2021
"21-Mar",강원,태백시,223,19961,721,20905,"2021-03-01",2021
"21-Mar",강원,평창군,290,25571,504,26365,"2021-03-01",2021
"21-Mar",강원,홍천군,422,39141,1029,40592,"2021-03-01",2021
"21-Mar",강원,화천군,225,12999,184,13408,"2021-03-01",2021
"21-Mar",강원,횡성군,252,26766,729,27747,"2021-03-01",2021
"21-Mar",강원,계,6038,784632,25044,815714,"2021-03-01",2021
"21-Mar",충북,괴산군,209,23044,412,23665,"2021-03-01",2021
"21-Mar",충북,단양군,221,15645,784,16650,"2021-03-01",2021
"21-Mar",충북,보은군,229,18056,1024,19309,"2021-03-01",2021
"21-Mar",충북,영동군,248,25041,393,25682,"2021-03-01",2021
"21-Mar",충북,옥천군,208,27206,1135,28549,"2021-03-01",2021
"21-Mar",충북,음성군,233,58499,1921,60653,"2021-03-01",2021
"21-Mar",충북,제천시,337,66833,3431,70601,"2021-03-01",2021
"21-Mar",충북,증평군,88,19202,763,20053,"2021-03-01",2021
"21-Mar",충북,진천군,213,50033,1349,51595,"2021-03-01",2021
"21-Mar",충북,청원군,1,19,0,20,"2021-03-01",2021
"21-Mar",충북,청주시 상당구,515,92311,2623,95449,"2021-03-01",2021
"21-Mar",충북,청주시 서원구,234,94436,4303,98973,"2021-03-01",2021
"21-Mar",충북,청주시 청원구,339,102602,4017,106958,"2021-03-01",2021
"21-Mar",충북,청주시 흥덕구,354,129296,7699,137349,"2021-03-01",2021
"21-Mar",충북,충주시,592,109951,6669,117212,"2021-03-01",2021
"21-Mar",충북,계,4021,832174,36523,872718,"2021-03-01",2021
"21-Mar",충남,계룡시,155,22358,536,23049,"2021-03-01",2021
"21-Mar",충남,공주시,574,53917,2525,57016,"2021-03-01",2021
"21-Mar",충남,금산군,187,28754,2084,31025,"2021-03-01",2021
"21-Mar",충남,논산시,412,61112,2385,63909,"2021-03-01",2021
"21-Mar",충남,당진시,396,95331,3992,99719,"2021-03-01",2021
"21-Mar",충남,보령시,407,52289,1344,54040,"2021-03-01",2021
"21-Mar",충남,부여군,302,34395,1203,35900,"2021-03-01",2021
"21-Mar",충남,서산시,409,95416,3430,99255,"2021-03-01",2021
"21-Mar",충남,서천군,236,27099,892,28227,"2021-03-01",2021
"21-Mar",충남,아산시,516,169026,6641,176183,"2021-03-01",2021
"21-Mar",충남,예산군,401,43188,1381,44970,"2021-03-01",2021
"21-Mar",충남,천안시 동남구,277,131147,4952,136376,"2021-03-01",2021
"21-Mar",충남,천안시 서북구,525,196231,5475,202231,"2021-03-01",2021
"21-Mar",충남,청양군,249,16882,825,17956,"2021-03-01",2021
"21-Mar",충남,태안군,314,34251,559,35124,"2021-03-01",2021
"21-Mar",충남,홍성군,417,53027,1435,54879,"2021-03-01",2021
"21-Mar",충남,계,5777,1114423,39659,1159859,"2021-03-01",2021
"21-Mar",전북,고창군,303,30590,574,31467,"2021-03-01",2021
"21-Mar",전북,군산시,544,130896,6294,137734,"2021-03-01",2021
"21-Mar",전북,김제시,287,45496,1984,47767,"2021-03-01",2021
"21-Mar",전북,남원시,404,40960,4312,45676,"2021-03-01",2021
"21-Mar",전북,무주군,201,12963,400,13564,"2021-03-01",2021
"21-Mar",전북,부안군,259,27591,617,28467,"2021-03-01",2021
"21-Mar",전북,순창군,234,14657,150,15041,"2021-03-01",2021
"21-Mar",전북,완주군,409,51526,3218,55153,"2021-03-01",2021
"21-Mar",전북,익산시,514,136188,5889,142591,"2021-03-01",2021
"21-Mar",전북,임실군,218,14203,426,14847,"2021-03-01",2021
"21-Mar",전북,장수군,232,12119,175,12526,"2021-03-01",2021
"21-Mar",전북,전주시 덕진구,371,172299,7005,179675,"2021-03-01",2021
"21-Mar",전북,전주시 완산구,740,151815,4160,156715,"2021-03-01",2021
"21-Mar",전북,정읍시,350,54457,3640,58447,"2021-03-01",2021
"21-Mar",전북,진안군,257,14104,224,14585,"2021-03-01",2021
"21-Mar",전북,계,5323,909864,39068,954255,"2021-03-01",2021
"21-Mar",전남,강진군,220,18601,1107,19928,"2021-03-01",2021
"21-Mar",전남,고흥군,300,32246,636,33182,"2021-03-01",2021
"21-Mar",전남,곡성군,159,14777,715,15651,"2021-03-01",2021
"21-Mar",전남,광양시,246,83231,5912,89389,"2021-03-01",2021
"21-Mar",전남,구례군,139,13153,722,14014,"2021-03-01",2021
"21-Mar",전남,나주시,470,64926,3164,68560,"2021-03-01",2021
"21-Mar",전남,담양군,224,26995,1583,28802,"2021-03-01",2021
"21-Mar",전남,목포시,412,95156,5519,101087,"2021-03-01",2021
"21-Mar",전남,무안군,528,47320,1065,48913,"2021-03-01",2021
"21-Mar",전남,보성군,201,21624,22723,44548,"2021-03-01",2021
"21-Mar",전남,순천시,486,140744,5174,146404,"2021-03-01",2021
"21-Mar",전남,신안군,313,21333,52448,74094,"2021-03-01",2021
"21-Mar",전남,여수시,524,132063,7167,139754,"2021-03-01",2021
"21-Mar",전남,영광군,206,27695,764,28665,"2021-03-01",2021
"21-Mar",전남,영암군,262,33121,8481,41864,"2021-03-01",2021
"21-Mar",전남,완도군,281,25520,535,26336,"2021-03-01",2021
"21-Mar",전남,장성군,194,26709,1154,28057,"2021-03-01",2021
"21-Mar",전남,장흥군,255,20023,448,20726,"2021-03-01",2021
"21-Mar",전남,진도군,167,16875,297,17339,"2021-03-01",2021
"21-Mar",전남,함평군,200,18190,27396,45786,"2021-03-01",2021
"21-Mar",전남,해남군,324,39703,12224,52251,"2021-03-01",2021
"21-Mar",전남,화순군,224,32689,2126,35039,"2021-03-01",2021
"21-Mar",전남,계,6335,952694,161360,1120389,"2021-03-01",2021
"21-Mar",경북,경산시,322,137447,4449,142218,"2021-03-01",2021
"21-Mar",경북,경주시,588,141939,4533,147060,"2021-03-01",2021
"21-Mar",경북,고령군,170,20592,685,21447,"2021-03-01",2021
"21-Mar",경북,구미시,545,213254,7186,220985,"2021-03-01",2021
"21-Mar",경북,군위군,125,14962,300,15387,"2021-03-01",2021
"21-Mar",경북,김천시,388,74563,1915,76866,"2021-03-01",2021
"21-Mar",경북,문경시,275,37214,843,38332,"2021-03-01",2021
"21-Mar",경북,봉화군,201,17992,194,18387,"2021-03-01",2021
"21-Mar",경북,상주시,385,53407,1845,55637,"2021-03-01",2021
"21-Mar",경북,성주군,196,30688,1326,32210,"2021-03-01",2021
"21-Mar",경북,안동시,721,82644,2639,86004,"2021-03-01",2021
"21-Mar",경북,영덕군,255,19000,307,19562,"2021-03-01",2021
"21-Mar",경북,영양군,140,9705,112,9957,"2021-03-01",2021
"21-Mar",경북,영주시,370,55769,1520,57659,"2021-03-01",2021
"21-Mar",경북,영천시,316,60119,2570,63005,"2021-03-01",2021
"21-Mar",경북,예천군,266,30009,494,30769,"2021-03-01",2021
"21-Mar",경북,울릉군,154,5177,509,5840,"2021-03-01",2021
"21-Mar",경북,울진군,307,26095,353,26755,"2021-03-01",2021
"21-Mar",경북,의성군,313,30826,1124,32263,"2021-03-01",2021
"21-Mar",경북,청도군,223,25007,785,26015,"2021-03-01",2021
"21-Mar",경북,청송군,194,15711,206,16111,"2021-03-01",2021
"21-Mar",경북,칠곡군,302,68454,2343,71099,"2021-03-01",2021
"21-Mar",경북,포항시 남구,453,121107,8420,129980,"2021-03-01",2021
"21-Mar",경북,포항시 북구,333,140271,3811,144415,"2021-03-01",2021
"21-Mar",경북,계,7542,1431952,48469,1487963,"2021-03-01",2021
"21-Mar",경남,거제시,373,106435,2080,108888,"2021-03-01",2021
"21-Mar",경남,거창군,266,32441,805,33512,"2021-03-01",2021
"21-Mar",경남,고성군,223,26354,587,27164,"2021-03-01",2021
"21-Mar",경남,김해시,649,274832,7325,282806,"2021-03-01",2021
"21-Mar",경남,남해군,273,19870,450,20593,"2021-03-01",2021
"21-Mar",경남,밀양시,330,55898,3962,60190,"2021-03-01",2021
"21-Mar",경남,사천시,315,56287,1545,58147,"2021-03-01",2021
"21-Mar",경남,산청군,245,20132,783,21160,"2021-03-01",2021
"21-Mar",경남,양산시,411,165724,10109,176244,"2021-03-01",2021
"21-Mar",경남,의령군,203,14523,704,15430,"2021-03-01",2021
"21-Mar",경남,진주시,633,165078,6364,172075,"2021-03-01",2021
"21-Mar",경남,창녕군,234,35427,884,36545,"2021-03-01",2021
"21-Mar",경남,창원시 마산합포구,322,96468,2883,99673,"2021-03-01",2021
"21-Mar",경남,창원시 마산회원구,177,95142,4587,99906,"2021-03-01",2021
"21-Mar",경남,창원시 성산구,143,118613,2892,121648,"2021-03-01",2021
"21-Mar",경남,창원시 의창구,933,142096,48675,191704,"2021-03-01",2021
"21-Mar",경남,창원시 진해구,213,91472,1795,93480,"2021-03-01",2021
"21-Mar",경남,통영시,322,52304,1403,54029,"2021-03-01",2021
"21-Mar",경남,하동군,222,23971,399,24592,"2021-03-01",2021
"21-Mar",경남,함안군,195,40532,21056,61783,"2021-03-01",2021
"21-Mar",경남,함양군,214,19504,434,20152,"2021-03-01",2021
"21-Mar",경남,합천군,268,23329,618,24215,"2021-03-01",2021
"21-Mar",경남,계,7164,1676432,120340,1803936,"2021-03-01",2021
"21-Mar",제주,서귀포시,799,104130,2004,106933,"2021-03-01",2021
"21-Mar",제주,제주시,1625,281308,236465,519398,"2021-03-01",2021
"21-Mar",제주,계,2424,385438,238469,626331,"2021-03-01",2021
"21-Apr",서울,강남구,395,217129,18245,235769,"2021-04-01",2021
"21-Apr",서울,강동구,293,143117,8786,152196,"2021-04-01",2021
"21-Apr",서울,강북구,317,71036,4247,75600,"2021-04-01",2021
"21-Apr",서울,강서구,336,185293,18776,204405,"2021-04-01",2021
"21-Apr",서울,관악구,315,113094,5538,118947,"2021-04-01",2021
"21-Apr",서울,광진구,297,92849,5448,98594,"2021-04-01",2021
"21-Apr",서울,구로구,298,132105,12308,144711,"2021-04-01",2021
"21-Apr",서울,금천구,139,82655,6289,89083,"2021-04-01",2021
"21-Apr",서울,노원구,322,143259,9165,152746,"2021-04-01",2021
"21-Apr",서울,도봉구,263,88001,7309,95573,"2021-04-01",2021
"21-Apr",서울,동대문구,299,92930,4995,98224,"2021-04-01",2021
"21-Apr",서울,동작구,322,102756,2794,105872,"2021-04-01",2021
"21-Apr",서울,마포구,339,112636,7009,119984,"2021-04-01",2021
"21-Apr",서울,서대문구,456,83274,5802,89532,"2021-04-01",2021
"21-Apr",서울,서초구,514,167156,10601,178271,"2021-04-01",2021
"21-Apr",서울,성동구,345,93724,12482,106551,"2021-04-01",2021
"21-Apr",서울,성북구,293,115494,5198,120985,"2021-04-01",2021
"21-Apr",서울,송파구,389,231943,13079,245411,"2021-04-01",2021
"21-Apr",서울,양천구,315,142584,8605,151504,"2021-04-01",2021
"21-Apr",서울,영등포구,370,137152,9115,146637,"2021-04-01",2021
"21-Apr",서울,용산구,335,77028,2084,79447,"2021-04-01",2021
"21-Apr",서울,은평구,298,124620,7024,131942,"2021-04-01",2021
"21-Apr",서울,종로구,3697,44541,1688,49926,"2021-04-01",2021
"21-Apr",서울,중구,1224,45619,6051,52894,"2021-04-01",2021
"21-Apr",서울,중랑구,250,104568,9453,114271,"2021-04-01",2021
"21-Apr",서울,계,12421,2944563,202091,3159075,"2021-04-01",2021
"21-Apr",부산,강서구,309,79375,3616,83300,"2021-04-01",2021
"21-Apr",부산,금정구,273,80485,7571,88329,"2021-04-01",2021
"21-Apr",부산,기장군,258,79905,2571,82734,"2021-04-01",2021
"21-Apr",부산,남구,219,91307,8312,99838,"2021-04-01",2021
"21-Apr",부산,동구,179,48876,5046,54101,"2021-04-01",2021
"21-Apr",부산,동래구,170,92926,3977,97073,"2021-04-01",2021
"21-Apr",부산,부산진구,367,124233,20664,145264,"2021-04-01",2021
"21-Apr",부산,북구,227,100302,3474,104003,"2021-04-01",2021
"21-Apr",부산,사상구,281,83166,5886,89333,"2021-04-01",2021
"21-Apr",부산,사하구,262,106847,6632,113741,"2021-04-01",2021
"21-Apr",부산,서구,134,29105,1404,30643,"2021-04-01",2021
"21-Apr",부산,수영구,162,67007,33895,101064,"2021-04-01",2021
"21-Apr",부산,연제구,942,90277,11316,102535,"2021-04-01",2021
"21-Apr",부산,영도구,223,30889,1962,33074,"2021-04-01",2021
"21-Apr",부산,중구,304,29315,7009,36628,"2021-04-01",2021
"21-Apr",부산,해운대구,317,165513,12746,178576,"2021-04-01",2021
"21-Apr",부산,계,4627,1299528,136081,1440236,"2021-04-01",2021
"21-Apr",대구,남구,340,56323,1642,58305,"2021-04-01",2021
"21-Apr",대구,달서구,491,271442,14132,286065,"2021-04-01",2021
"21-Apr",대구,달성군,533,134794,5084,140411,"2021-04-01",2021
"21-Apr",대구,동구,348,154538,11117,166003,"2021-04-01",2021
"21-Apr",대구,북구,497,201968,7510,209975,"2021-04-01",2021
"21-Apr",대구,서구,248,68963,3943,73154,"2021-04-01",2021
"21-Apr",대구,수성구,571,215514,5232,221317,"2021-04-01",2021
"21-Apr",대구,중구,297,61830,2499,64626,"2021-04-01",2021
"21-Apr",대구,계,3325,1165372,51159,1219856,"2021-04-01",2021
"21-Apr",인천,강화군,343,35153,28452,63948,"2021-04-01",2021
"21-Apr",인천,계양구,286,120531,192513,313330,"2021-04-01",2021
"21-Apr",인천,남동구,832,256256,51064,308152,"2021-04-01",2021
"21-Apr",인천,동구,94,24628,2583,27305,"2021-04-01",2021
"21-Apr",인천,미추홀구,422,163018,9912,173352,"2021-04-01",2021
"21-Apr",인천,부평구,329,216976,24345,241650,"2021-04-01",2021
"21-Apr",인천,서구,431,240162,11239,251832,"2021-04-01",2021
"21-Apr",인천,연수구,419,196094,8293,204806,"2021-04-01",2021
"21-Apr",인천,옹진군,212,12082,205,12499,"2021-04-01",2021
"21-Apr",인천,중구,633,64896,11910,77439,"2021-04-01",2021
"21-Apr",인천,계,4001,1329796,340516,1674313,"2021-04-01",2021
"21-Apr",광주,광산구,512,195760,12381,208653,"2021-04-01",2021
"21-Apr",광주,남구,213,90690,2821,93724,"2021-04-01",2021
"21-Apr",광주,동구,232,42699,1317,44248,"2021-04-01",2021
"21-Apr",광주,북구,596,189723,8890,199209,"2021-04-01",2021
"21-Apr",광주,서구,636,141096,6445,148177,"2021-04-01",2021
"21-Apr",광주,계,2189,659968,31854,694011,"2021-04-01",2021
"21-Apr",대전,대덕구,235,85940,6776,92951,"2021-04-01",2021
"21-Apr",대전,동구,245,91321,4629,96195,"2021-04-01",2021
"21-Apr",대전,서구,804,206528,7747,215079,"2021-04-01",2021
"21-Apr",대전,유성구,375,177855,4913,183143,"2021-04-01",2021
"21-Apr",대전,중구,238,96716,5551,102505,"2021-04-01",2021
"21-Apr",대전,계,1897,658360,29616,689873,"2021-04-01",2021
"21-Apr",울산,남구,714,154084,7355,162153,"2021-04-01",2021
"21-Apr",울산,동구,185,61877,1072,63134,"2021-04-01",2021
"21-Apr",울산,북구,220,115145,3718,119083,"2021-04-01",2021
"21-Apr",울산,울주군,384,123954,6822,131160,"2021-04-01",2021
"21-Apr",울산,중구,330,100287,2552,103169,"2021-04-01",2021
"21-Apr",울산,계,1833,555347,21519,578699,"2021-04-01",2021
"21-Apr",세종,세종특별자치시,795,175042,2925,178762,"2021-04-01",2021
"21-Apr",세종,계,795,175042,2925,178762,"2021-04-01",2021
"21-Apr",경기,가평군,375,30932,578,31885,"2021-04-01",2021
"21-Apr",경기,고양시 덕양구,661,180893,3888,185442,"2021-04-01",2021
"21-Apr",경기,고양시 일산동구,264,124732,5627,130623,"2021-04-01",2021
"21-Apr",경기,고양시 일산서구,123,116126,4358,120607,"2021-04-01",2021
"21-Apr",경기,과천시,715,25318,612,26645,"2021-04-01",2021
"21-Apr",경기,광명시,303,99536,4401,104240,"2021-04-01",2021
"21-Apr",경기,광주시,376,192241,8384,201001,"2021-04-01",2021
"21-Apr",경기,구리시,263,70344,2716,73323,"2021-04-01",2021
"21-Apr",경기,군포시,298,97944,5135,103377,"2021-04-01",2021
"21-Apr",경기,김포시,511,225262,7789,233562,"2021-04-01",2021
"21-Apr",경기,남양주시,746,299578,8430,308754,"2021-04-01",2021
"21-Apr",경기,동두천시,208,37884,1436,39528,"2021-04-01",2021
"21-Apr",경기,부천시,703,293277,12489,306469,"2021-04-01",2021
"21-Apr",경기,성남시 분당구,368,183521,6761,190650,"2021-04-01",2021
"21-Apr",경기,성남시 수정구,358,76860,2490,79708,"2021-04-01",2021
"21-Apr",경기,성남시 중원구,342,71799,4154,76295,"2021-04-01",2021
"21-Apr",경기,수원시 권선구,487,189352,8745,198584,"2021-04-01",2021
"21-Apr",경기,수원시 영통구,224,146880,3107,150211,"2021-04-01",2021
"21-Apr",경기,수원시 장안구,463,100718,3858,105039,"2021-04-01",2021
"21-Apr",경기,수원시 팔달구,504,72287,2959,75750,"2021-04-01",2021
"21-Apr",경기,시흥시,456,248890,7946,257292,"2021-04-01",2021
"21-Apr",경기,안산시 단원구,555,154723,8024,163302,"2021-04-01",2021
"21-Apr",경기,안산시 상록구,172,143618,5006,148796,"2021-04-01",2021
"21-Apr",경기,안성시,389,104662,4868,109919,"2021-04-01",2021
"21-Apr",경기,안양시 동안구,400,117399,6299,124098,"2021-04-01",2021
"21-Apr",경기,안양시 만안구,153,83346,3890,87389,"2021-04-01",2021
"21-Apr",경기,양주시,372,109452,3190,113014,"2021-04-01",2021
"21-Apr",경기,양평군,556,60434,1827,62817,"2021-04-01",2021
"21-Apr",경기,여주시,446,63131,7396,70973,"2021-04-01",2021
"21-Apr",경기,연천군,304,23798,5259,29361,"2021-04-01",2021
"21-Apr",경기,오산시,205,107244,3487,110936,"2021-04-01",2021
"21-Apr",경기,용인시 기흥구,121,188034,6237,194392,"2021-04-01",2021
"21-Apr",경기,용인시 수지구,49,145614,2490,148153,"2021-04-01",2021
"21-Apr",경기,용인시 처인구,768,131944,7610,140322,"2021-04-01",2021
"21-Apr",경기,의왕시,294,64364,2879,67537,"2021-04-01",2021
"21-Apr",경기,의정부시,718,162818,5219,168755,"2021-04-01",2021
"21-Apr",경기,이천시,411,113453,5925,119789,"2021-04-01",2021
"21-Apr",경기,파주시,528,216134,10157,226819,"2021-04-01",2021
"21-Apr",경기,평택시,734,286466,12300,299500,"2021-04-01",2021
"21-Apr",경기,포천시,388,85960,9342,95690,"2021-04-01",2021
"21-Apr",경기,하남시,397,125282,2927,128606,"2021-04-01",2021
"21-Apr",경기,화성시,923,450023,12189,463135,"2021-04-01",2021
"21-Apr",경기,계,17631,5822273,232384,6072288,"2021-04-01",2021
"21-Apr",강원,강릉시,542,108426,4558,113526,"2021-04-01",2021
"21-Apr",강원,고성군,185,14393,224,14802,"2021-04-01",2021
"21-Apr",강원,동해시,307,45324,1452,47083,"2021-04-01",2021
"21-Apr",강원,삼척시,399,32222,777,33398,"2021-04-01",2021
"21-Apr",강원,속초시,301,38251,1410,39962,"2021-04-01",2021
"21-Apr",강원,양구군,198,12018,140,12356,"2021-04-01",2021
"21-Apr",강원,양양군,189,15916,293,16398,"2021-04-01",2021
"21-Apr",강원,영월군,330,21127,359,21816,"2021-04-01",2021
"21-Apr",강원,원주시,583,175298,5603,181484,"2021-04-01",2021
"21-Apr",강원,인제군,216,18454,272,18942,"2021-04-01",2021
"21-Apr",강원,정선군,339,20654,474,21467,"2021-04-01",2021
"21-Apr",강원,철원군,240,24109,294,24643,"2021-04-01",2021
"21-Apr",강원,춘천시,822,133217,6093,140132,"2021-04-01",2021
"21-Apr",강원,태백시,221,20003,780,21004,"2021-04-01",2021
"21-Apr",강원,평창군,290,25547,490,26327,"2021-04-01",2021
"21-Apr",강원,홍천군,421,38959,1022,40402,"2021-04-01",2021
"21-Apr",강원,화천군,229,12993,185,13407,"2021-04-01",2021
"21-Apr",강원,횡성군,255,26787,731,27773,"2021-04-01",2021
"21-Apr",강원,계,6067,783698,25157,814922,"2021-04-01",2021
"21-Apr",충북,괴산군,209,22868,412,23489,"2021-04-01",2021
"21-Apr",충북,단양군,222,15608,781,16611,"2021-04-01",2021
"21-Apr",충북,보은군,230,18038,1027,19295,"2021-04-01",2021
"21-Apr",충북,영동군,249,24887,397,25533,"2021-04-01",2021
"21-Apr",충북,옥천군,207,27232,1136,28575,"2021-04-01",2021
"21-Apr",충북,음성군,234,58313,1923,60470,"2021-04-01",2021
"21-Apr",충북,제천시,336,66857,3421,70614,"2021-04-01",2021
"21-Apr",충북,증평군,89,19219,752,20060,"2021-04-01",2021
"21-Apr",충북,진천군,213,50101,1328,51642,"2021-04-01",2021
"21-Apr",충북,청원군,1,19,0,20,"2021-04-01",2021
"21-Apr",충북,청주시 상당구,517,92348,2625,95490,"2021-04-01",2021
"21-Apr",충북,청주시 서원구,236,97612,4306,102154,"2021-04-01",2021
"21-Apr",충북,청주시 청원구,339,102483,4031,106853,"2021-04-01",2021
"21-Apr",충북,청주시 흥덕구,356,129436,7650,137442,"2021-04-01",2021
"21-Apr",충북,충주시,597,109515,6612,116724,"2021-04-01",2021
"21-Apr",충북,계,4035,834536,36401,874972,"2021-04-01",2021
"21-Apr",충남,계룡시,156,22414,533,23103,"2021-04-01",2021
"21-Apr",충남,공주시,571,53821,2571,56963,"2021-04-01",2021
"21-Apr",충남,금산군,188,28830,2092,31110,"2021-04-01",2021
"21-Apr",충남,논산시,410,60838,2386,63634,"2021-04-01",2021
"21-Apr",충남,당진시,398,95810,3999,100207,"2021-04-01",2021
"21-Apr",충남,보령시,409,52127,1349,53885,"2021-04-01",2021
"21-Apr",충남,부여군,303,34548,1198,36049,"2021-04-01",2021
"21-Apr",충남,서산시,414,95143,3458,99015,"2021-04-01",2021
"21-Apr",충남,서천군,237,27095,883,28215,"2021-04-01",2021
"21-Apr",충남,아산시,518,169338,6656,176512,"2021-04-01",2021
"21-Apr",충남,예산군,400,43083,1378,44861,"2021-04-01",2021
"21-Apr",충남,천안시 동남구,278,131089,4950,136317,"2021-04-01",2021
"21-Apr",충남,천안시 서북구,523,196270,5530,202323,"2021-04-01",2021
"21-Apr",충남,청양군,250,16847,836,17933,"2021-04-01",2021
"21-Apr",충남,태안군,314,34199,563,35076,"2021-04-01",2021
"21-Apr",충남,홍성군,414,52901,1426,54741,"2021-04-01",2021
"21-Apr",충남,계,5783,1114353,39808,1159944,"2021-04-01",2021
"21-Apr",전북,고창군,307,30394,569,31270,"2021-04-01",2021
"21-Apr",전북,군산시,543,130734,6289,137566,"2021-04-01",2021
"21-Apr",전북,김제시,287,45301,1966,47554,"2021-04-01",2021
"21-Apr",전북,남원시,404,41102,4247,45753,"2021-04-01",2021
"21-Apr",전북,무주군,199,12873,398,13470,"2021-04-01",2021
"21-Apr",전북,부안군,258,27384,609,28251,"2021-04-01",2021
"21-Apr",전북,순창군,233,14621,148,15002,"2021-04-01",2021
"21-Apr",전북,완주군,409,51386,3184,54979,"2021-04-01",2021
"21-Apr",전북,익산시,518,136058,5872,142448,"2021-04-01",2021
"21-Apr",전북,임실군,217,14213,427,14857,"2021-04-01",2021
"21-Apr",전북,장수군,233,12131,176,12540,"2021-04-01",2021
"21-Apr",전북,전주시 덕진구,373,172353,6986,179712,"2021-04-01",2021
"21-Apr",전북,전주시 완산구,739,151647,4157,156543,"2021-04-01",2021
"21-Apr",전북,정읍시,350,54422,3602,58374,"2021-04-01",2021
"21-Apr",전북,진안군,259,14096,225,14580,"2021-04-01",2021
"21-Apr",전북,계,5329,908715,38855,952899,"2021-04-01",2021
"21-Apr",전남,강진군,220,18558,1094,19872,"2021-04-01",2021
"21-Apr",전남,고흥군,299,32132,632,33063,"2021-04-01",2021
"21-Apr",전남,곡성군,161,14807,711,15679,"2021-04-01",2021
"21-Apr",전남,광양시,246,83167,5925,89338,"2021-04-01",2021
"21-Apr",전남,구례군,140,13140,725,14005,"2021-04-01",2021
"21-Apr",전남,나주시,468,65017,3168,68653,"2021-04-01",2021
"21-Apr",전남,담양군,226,27072,1584,28882,"2021-04-01",2021
"21-Apr",전남,목포시,410,94988,5489,100887,"2021-04-01",2021
"21-Apr",전남,무안군,538,47461,1063,49062,"2021-04-01",2021
"21-Apr",전남,보성군,201,21621,24110,45932,"2021-04-01",2021
"21-Apr",전남,순천시,491,140597,5159,146247,"2021-04-01",2021
"21-Apr",전남,신안군,313,21363,61415,83091,"2021-04-01",2021
"21-Apr",전남,여수시,524,131768,7139,139431,"2021-04-01",2021
"21-Apr",전남,영광군,205,27735,756,28696,"2021-04-01",2021
"21-Apr",전남,영암군,261,33188,6891,40340,"2021-04-01",2021
"21-Apr",전남,완도군,280,25446,537,26263,"2021-04-01",2021
"21-Apr",전남,장성군,195,26666,1157,28018,"2021-04-01",2021
"21-Apr",전남,장흥군,255,20007,443,20705,"2021-04-01",2021
"21-Apr",전남,진도군,166,16970,294,17430,"2021-04-01",2021
"21-Apr",전남,함평군,201,18217,25755,44173,"2021-04-01",2021
"21-Apr",전남,해남군,324,39469,14951,54744,"2021-04-01",2021
"21-Apr",전남,화순군,224,32554,2113,34891,"2021-04-01",2021
"21-Apr",전남,계,6348,951943,171111,1129402,"2021-04-01",2021
"21-Apr",경북,경산시,323,137498,4431,142252,"2021-04-01",2021
"21-Apr",경북,경주시,583,142460,4527,147570,"2021-04-01",2021
"21-Apr",경북,고령군,170,20436,676,21282,"2021-04-01",2021
"21-Apr",경북,구미시,546,213636,7153,221335,"2021-04-01",2021
"21-Apr",경북,군위군,126,14882,299,15307,"2021-04-01",2021
"21-Apr",경북,김천시,391,74541,1920,76852,"2021-04-01",2021
"21-Apr",경북,문경시,276,36935,842,38053,"2021-04-01",2021
"21-Apr",경북,봉화군,201,18010,198,18409,"2021-04-01",2021
"21-Apr",경북,상주시,385,53114,1844,55343,"2021-04-01",2021
"21-Apr",경북,성주군,195,30568,1319,32082,"2021-04-01",2021
"21-Apr",경북,안동시,719,82584,2638,85941,"2021-04-01",2021
"21-Apr",경북,영덕군,254,18936,308,19498,"2021-04-01",2021
"21-Apr",경북,영양군,141,9717,114,9972,"2021-04-01",2021
"21-Apr",경북,영주시,365,55705,1524,57594,"2021-04-01",2021
"21-Apr",경북,영천시,320,60134,2581,63035,"2021-04-01",2021
"21-Apr",경북,예천군,270,29999,492,30761,"2021-04-01",2021
"21-Apr",경북,울릉군,153,5170,520,5843,"2021-04-01",2021
"21-Apr",경북,울진군,310,26128,353,26791,"2021-04-01",2021
"21-Apr",경북,의성군,312,30826,1125,32263,"2021-04-01",2021
"21-Apr",경북,청도군,217,24935,779,25931,"2021-04-01",2021
"21-Apr",경북,청송군,198,15623,207,16028,"2021-04-01",2021
"21-Apr",경북,칠곡군,299,68364,2359,71022,"2021-04-01",2021
"21-Apr",경북,포항시 남구,455,120932,8385,129772,"2021-04-01",2021
"21-Apr",경북,포항시 북구,331,140093,3785,144209,"2021-04-01",2021
"21-Apr",경북,계,7540,1431226,48379,1487145,"2021-04-01",2021
"21-Apr",경남,거제시,366,106188,2094,108648,"2021-04-01",2021
"21-Apr",경남,거창군,266,32462,804,33532,"2021-04-01",2021
"21-Apr",경남,고성군,225,26383,585,27193,"2021-04-01",2021
"21-Apr",경남,김해시,653,275040,7327,283020,"2021-04-01",2021
"21-Apr",경남,남해군,276,19825,452,20553,"2021-04-01",2021
"21-Apr",경남,밀양시,330,55948,3964,60242,"2021-04-01",2021
"21-Apr",경남,사천시,316,56255,1541,58112,"2021-04-01",2021
"21-Apr",경남,산청군,244,20180,784,21208,"2021-04-01",2021
"21-Apr",경남,양산시,410,166084,10108,176602,"2021-04-01",2021
"21-Apr",경남,의령군,200,14535,702,15437,"2021-04-01",2021
"21-Apr",경남,진주시,635,165180,6259,172074,"2021-04-01",2021
"21-Apr",경남,창녕군,234,35436,884,36554,"2021-04-01",2021
"21-Apr",경남,창원시 마산합포구,320,96424,2883,99627,"2021-04-01",2021
"21-Apr",경남,창원시 마산회원구,177,95229,4624,100030,"2021-04-01",2021
"21-Apr",경남,창원시 성산구,138,118901,3067,122106,"2021-04-01",2021
"21-Apr",경남,창원시 의창구,929,142306,49627,192862,"2021-04-01",2021
"21-Apr",경남,창원시 진해구,213,91593,1800,93606,"2021-04-01",2021
"21-Apr",경남,통영시,321,52281,1412,54014,"2021-04-01",2021
"21-Apr",경남,하동군,220,24003,396,24619,"2021-04-01",2021
"21-Apr",경남,함안군,195,40411,21019,61625,"2021-04-01",2021
"21-Apr",경남,함양군,212,19444,434,20090,"2021-04-01",2021
"21-Apr",경남,합천군,267,23278,615,24160,"2021-04-01",2021
"21-Apr",경남,계,7147,1677386,121381,1805914,"2021-04-01",2021
"21-Apr",제주,서귀포시,798,103858,1999,106655,"2021-04-01",2021
"21-Apr",제주,제주시,1628,281287,240326,523241,"2021-04-01",2021
"21-Apr",제주,계,2426,385145,242325,629896,"2021-04-01",2021
"21-May",서울,강남구,392,216784,18419,235595,"2021-05-01",2021
"21-May",서울,강동구,298,143382,8701,152381,"2021-05-01",2021
"21-May",서울,강북구,314,71013,4260,75587,"2021-05-01",2021
"21-May",서울,강서구,336,185387,18695,204418,"2021-05-01",2021
"21-May",서울,관악구,312,113023,5560,118895,"2021-05-01",2021
"21-May",서울,광진구,297,92863,5440,98600,"2021-05-01",2021
"21-May",서울,구로구,300,132216,12179,144695,"2021-05-01",2021
"21-May",서울,금천구,139,82892,6281,89312,"2021-05-01",2021
"21-May",서울,노원구,323,143321,9133,152777,"2021-05-01",2021
"21-May",서울,도봉구,264,88029,7279,95572,"2021-05-01",2021
"21-May",서울,동대문구,299,92846,4993,98138,"2021-05-01",2021
"21-May",서울,동작구,321,102885,2793,105999,"2021-05-01",2021
"21-May",서울,마포구,338,113004,7037,120379,"2021-05-01",2021
"21-May",서울,서대문구,464,83200,5792,89456,"2021-05-01",2021
"21-May",서울,서초구,513,167349,10518,178380,"2021-05-01",2021
"21-May",서울,성동구,344,93677,12672,106693,"2021-05-01",2021
"21-May",서울,성북구,292,115602,5206,121100,"2021-05-01",2021
"21-May",서울,송파구,389,231906,13196,245491,"2021-05-01",2021
"21-May",서울,양천구,315,142558,8605,151478,"2021-05-01",2021
"21-May",서울,영등포구,369,137245,9089,146703,"2021-05-01",2021
"21-May",서울,용산구,333,77235,2108,79676,"2021-05-01",2021
"21-May",서울,은평구,298,124856,6998,132152,"2021-05-01",2021
"21-May",서울,종로구,3706,44590,2055,50351,"2021-05-01",2021
"21-May",서울,중구,1221,45577,5691,52489,"2021-05-01",2021
"21-May",서울,중랑구,249,104636,9427,114312,"2021-05-01",2021
"21-May",서울,계,12426,2946076,202127,3160629,"2021-05-01",2021
"21-May",부산,강서구,310,79725,3752,83787,"2021-05-01",2021
"21-May",부산,금정구,274,80452,7460,88186,"2021-05-01",2021
"21-May",부산,기장군,260,80132,2633,83025,"2021-05-01",2021
"21-May",부산,남구,219,91110,8338,99667,"2021-05-01",2021
"21-May",부산,동구,180,49456,5054,54690,"2021-05-01",2021
"21-May",부산,동래구,170,92812,3941,96923,"2021-05-01",2021
"21-May",부산,부산진구,370,124119,20884,145373,"2021-05-01",2021
"21-May",부산,북구,226,100973,3497,104696,"2021-05-01",2021
"21-May",부산,사상구,282,83144,5895,89321,"2021-05-01",2021
"21-May",부산,사하구,262,106814,6550,113626,"2021-05-01",2021
"21-May",부산,서구,134,29126,1418,30678,"2021-05-01",2021
"21-May",부산,수영구,163,67343,34546,102052,"2021-05-01",2021
"21-May",부산,연제구,952,90358,11502,102812,"2021-05-01",2021
"21-May",부산,영도구,224,31034,1971,33229,"2021-05-01",2021
"21-May",부산,중구,305,29498,6995,36798,"2021-05-01",2021
"21-May",부산,해운대구,319,165689,13237,179245,"2021-05-01",2021
"21-May",부산,계,4650,1301785,137673,1444108,"2021-05-01",2021
"21-May",대구,남구,342,56266,1650,58258,"2021-05-01",2021
"21-May",대구,달서구,497,270877,14060,285434,"2021-05-01",2021
"21-May",대구,달성군,534,134670,5094,140298,"2021-05-01",2021
"21-May",대구,동구,350,153864,11205,165419,"2021-05-01",2021
"21-May",대구,북구,495,201527,7533,209555,"2021-05-01",2021
"21-May",대구,서구,249,68531,3959,72739,"2021-05-01",2021
"21-May",대구,수성구,583,214949,5235,220767,"2021-05-01",2021
"21-May",대구,중구,300,61438,2545,64283,"2021-05-01",2021
"21-May",대구,계,3350,1162122,51281,1216753,"2021-05-01",2021
"21-May",인천,강화군,347,35320,27467,63134,"2021-05-01",2021
"21-May",인천,계양구,286,120604,190528,311418,"2021-05-01",2021
"21-May",인천,남동구,845,256079,50664,307588,"2021-05-01",2021
"21-May",인천,동구,94,24539,2567,27200,"2021-05-01",2021
"21-May",인천,미추홀구,421,163663,9767,173851,"2021-05-01",2021
"21-May",인천,부평구,332,218000,24950,243282,"2021-05-01",2021
"21-May",인천,서구,433,240236,11283,251952,"2021-05-01",2021
"21-May",인천,연수구,420,196978,8380,205778,"2021-05-01",2021
"21-May",인천,옹진군,213,12106,212,12531,"2021-05-01",2021
"21-May",인천,중구,637,65193,11944,77774,"2021-05-01",2021
"21-May",인천,계,4028,1332718,337762,1674508,"2021-05-01",2021
"21-May",광주,광산구,514,195712,12501,208727,"2021-05-01",2021
"21-May",광주,남구,214,90618,2854,93686,"2021-05-01",2021
"21-May",광주,동구,242,42875,1305,44422,"2021-05-01",2021
"21-May",광주,북구,600,189466,8922,198988,"2021-05-01",2021
"21-May",광주,서구,643,140688,6544,147875,"2021-05-01",2021
"21-May",광주,계,2213,659359,32126,693698,"2021-05-01",2021
"21-May",대전,대덕구,237,85488,6784,92509,"2021-05-01",2021
"21-May",대전,동구,245,90943,4692,95880,"2021-05-01",2021
"21-May",대전,서구,809,205762,7734,214305,"2021-05-01",2021
"21-May",대전,유성구,373,177074,4950,182397,"2021-05-01",2021
"21-May",대전,중구,241,96346,5556,102143,"2021-05-01",2021
"21-May",대전,계,1905,655613,29716,687234,"2021-05-01",2021
"21-May",울산,남구,715,153992,7372,162079,"2021-05-01",2021
"21-May",울산,동구,187,61790,1072,63049,"2021-05-01",2021
"21-May",울산,북구,222,114919,3671,118812,"2021-05-01",2021
"21-May",울산,울주군,388,123910,6854,131152,"2021-05-01",2021
"21-May",울산,중구,337,100132,2566,103035,"2021-05-01",2021
"21-May",울산,계,1849,554743,21535,578127,"2021-05-01",2021
"21-May",세종,세종특별자치시,797,175448,2996,179241,"2021-05-01",2021
"21-May",세종,계,797,175448,2996,179241,"2021-05-01",2021
"21-May",경기,가평군,369,31038,589,31996,"2021-05-01",2021
"21-May",경기,고양시 덕양구,659,181373,3897,185929,"2021-05-01",2021
"21-May",경기,고양시 일산동구,266,125125,5592,130983,"2021-05-01",2021
"21-May",경기,고양시 일산서구,121,116248,4390,120759,"2021-05-01",2021
"21-May",경기,과천시,715,25477,607,26799,"2021-05-01",2021
"21-May",경기,광명시,305,99933,4426,104664,"2021-05-01",2021
"21-May",경기,광주시,378,192877,8387,201642,"2021-05-01",2021
"21-May",경기,구리시,259,70390,2715,73364,"2021-05-01",2021
"21-May",경기,군포시,298,98065,5156,103519,"2021-05-01",2021
"21-May",경기,김포시,512,225743,7842,234097,"2021-05-01",2021
"21-May",경기,남양주시,747,300725,8479,309951,"2021-05-01",2021
"21-May",경기,동두천시,209,37973,1432,39614,"2021-05-01",2021
"21-May",경기,부천시,705,293208,12490,306403,"2021-05-01",2021
"21-May",경기,성남시 분당구,368,183772,6845,190985,"2021-05-01",2021
"21-May",경기,성남시 수정구,356,76897,2494,79747,"2021-05-01",2021
"21-May",경기,성남시 중원구,343,71896,4139,76378,"2021-05-01",2021
"21-May",경기,수원시 권선구,490,188726,8804,198020,"2021-05-01",2021
"21-May",경기,수원시 영통구,225,147157,3121,150503,"2021-05-01",2021
"21-May",경기,수원시 장안구,473,100811,3859,105143,"2021-05-01",2021
"21-May",경기,수원시 팔달구,503,72602,2950,76055,"2021-05-01",2021
"21-May",경기,시흥시,458,249308,7996,257762,"2021-05-01",2021
"21-May",경기,안산시 단원구,556,155032,8111,163699,"2021-05-01",2021
"21-May",경기,안산시 상록구,175,143818,4995,148988,"2021-05-01",2021
"21-May",경기,안성시,389,104972,4910,110271,"2021-05-01",2021
"21-May",경기,안양시 동안구,400,117491,6348,124239,"2021-05-01",2021
"21-May",경기,안양시 만안구,152,83576,3887,87615,"2021-05-01",2021
"21-May",경기,양주시,374,109751,3203,113328,"2021-05-01",2021
"21-May",경기,양평군,557,60723,1818,63098,"2021-05-01",2021
"21-May",경기,여주시,452,63264,7324,71040,"2021-05-01",2021
"21-May",경기,연천군,302,23820,5255,29377,"2021-05-01",2021
"21-May",경기,오산시,205,107535,3513,111253,"2021-05-01",2021
"21-May",경기,용인시 기흥구,125,188113,6290,194528,"2021-05-01",2021
"21-May",경기,용인시 수지구,49,145941,2571,148561,"2021-05-01",2021
"21-May",경기,용인시 처인구,767,132415,7639,140821,"2021-05-01",2021
"21-May",경기,의왕시,294,64511,2895,67700,"2021-05-01",2021
"21-May",경기,의정부시,729,163238,5252,169219,"2021-05-01",2021
"21-May",경기,이천시,412,113830,5937,120179,"2021-05-01",2021
"21-May",경기,파주시,529,217164,10171,227864,"2021-05-01",2021
"21-May",경기,평택시,735,287753,12391,300879,"2021-05-01",2021
"21-May",경기,포천시,390,86194,9181,95765,"2021-05-01",2021
"21-May",경기,하남시,392,125894,2963,129249,"2021-05-01",2021
"21-May",경기,화성시,926,452245,12321,465492,"2021-05-01",2021
"21-May",경기,계,17669,5836624,233185,6087478,"2021-05-01",2021
"21-May",강원,강릉시,537,108505,4575,113617,"2021-05-01",2021
"21-May",강원,고성군,185,14490,228,14903,"2021-05-01",2021
"21-May",강원,동해시,307,45411,1456,47174,"2021-05-01",2021
"21-May",강원,삼척시,393,32175,778,33346,"2021-05-01",2021
"21-May",강원,속초시,301,38313,1391,40005,"2021-05-01",2021
"21-May",강원,양구군,196,12019,139,12354,"2021-05-01",2021
"21-May",강원,양양군,189,15978,282,16449,"2021-05-01",2021
"21-May",강원,영월군,329,21156,358,21843,"2021-05-01",2021
"21-May",강원,원주시,584,175610,5624,181818,"2021-05-01",2021
"21-May",강원,인제군,216,18515,272,19003,"2021-05-01",2021
"21-May",강원,정선군,338,20669,472,21479,"2021-05-01",2021
"21-May",강원,철원군,240,24113,316,24669,"2021-05-01",2021
"21-May",강원,춘천시,823,133383,6094,140300,"2021-05-01",2021
"21-May",강원,태백시,223,19967,759,20949,"2021-05-01",2021
"21-May",강원,평창군,290,25600,489,26379,"2021-05-01",2021
"21-May",강원,홍천군,420,38980,1027,40427,"2021-05-01",2021
"21-May",강원,화천군,230,12994,184,13408,"2021-05-01",2021
"21-May",강원,횡성군,254,26785,721,27760,"2021-05-01",2021
"21-May",강원,계,6055,784663,25165,815883,"2021-05-01",2021
"21-May",충북,괴산군,209,22801,411,23421,"2021-05-01",2021
"21-May",충북,단양군,223,15598,792,16613,"2021-05-01",2021
"21-May",충북,보은군,231,18104,1028,19363,"2021-05-01",2021
"21-May",충북,영동군,247,24882,401,25530,"2021-05-01",2021
"21-May",충북,옥천군,208,27268,1149,28625,"2021-05-01",2021
"21-May",충북,음성군,235,58315,1938,60488,"2021-05-01",2021
"21-May",충북,제천시,338,66994,3423,70755,"2021-05-01",2021
"21-May",충북,증평군,91,19201,745,20037,"2021-05-01",2021
"21-May",충북,진천군,213,50216,1326,51755,"2021-05-01",2021
"21-May",충북,청원군,1,19,0,20,"2021-05-01",2021
"21-May",충북,청주시 상당구,521,92413,2642,95576,"2021-05-01",2021
"21-May",충북,청주시 서원구,236,97726,4329,102291,"2021-05-01",2021
"21-May",충북,청주시 청원구,349,102550,4048,106947,"2021-05-01",2021
"21-May",충북,청주시 흥덕구,356,129532,7746,137634,"2021-05-01",2021
"21-May",충북,충주시,601,109630,6872,117103,"2021-05-01",2021
"21-May",충북,계,4059,835249,36850,876158,"2021-05-01",2021
"21-May",충남,계룡시,154,22439,533,23126,"2021-05-01",2021
"21-May",충남,공주시,571,53799,2566,56936,"2021-05-01",2021
"21-May",충남,금산군,194,28568,2099,30861,"2021-05-01",2021
"21-May",충남,논산시,408,60744,2388,63540,"2021-05-01",2021
"21-May",충남,당진시,401,95780,3999,100180,"2021-05-01",2021
"21-May",충남,보령시,410,52157,1353,53920,"2021-05-01",2021
"21-May",충남,부여군,302,34208,1231,35741,"2021-05-01",2021
"21-May",충남,서산시,412,95416,3441,99269,"2021-05-01",2021
"21-May",충남,서천군,239,27081,862,28182,"2021-05-01",2021
"21-May",충남,아산시,520,169669,6679,176868,"2021-05-01",2021
"21-May",충남,예산군,406,43091,1382,44879,"2021-05-01",2021
"21-May",충남,천안시 동남구,284,131032,4953,136269,"2021-05-01",2021
"21-May",충남,천안시 서북구,523,196656,5508,202687,"2021-05-01",2021
"21-May",충남,청양군,252,16801,831,17884,"2021-05-01",2021
"21-May",충남,태안군,315,34167,565,35047,"2021-05-01",2021
"21-May",충남,홍성군,417,52906,1427,54750,"2021-05-01",2021
"21-May",충남,계,5808,1114514,39817,1160139,"2021-05-01",2021
"21-May",전북,고창군,305,30362,571,31238,"2021-05-01",2021
"21-May",전북,군산시,544,130618,6317,137479,"2021-05-01",2021
"21-May",전북,김제시,282,45267,1946,47495,"2021-05-01",2021
"21-May",전북,남원시,405,41005,4211,45621,"2021-05-01",2021
"21-May",전북,무주군,197,12876,397,13470,"2021-05-01",2021
"21-May",전북,부안군,259,27399,614,28272,"2021-05-01",2021
"21-May",전북,순창군,231,14571,147,14949,"2021-05-01",2021
"21-May",전북,완주군,409,51377,3173,54959,"2021-05-01",2021
"21-May",전북,익산시,514,135876,5913,142303,"2021-05-01",2021
"21-May",전북,임실군,215,14218,426,14859,"2021-05-01",2021
"21-May",전북,장수군,235,12129,176,12540,"2021-05-01",2021
"21-May",전북,전주시 덕진구,376,172158,6967,179501,"2021-05-01",2021
"21-May",전북,전주시 완산구,737,151698,4173,156608,"2021-05-01",2021
"21-May",전북,정읍시,353,54528,3523,58404,"2021-05-01",2021
"21-May",전북,진안군,259,14094,224,14577,"2021-05-01",2021
"21-May",전북,계,5321,908176,38778,952275,"2021-05-01",2021
"21-May",전남,강진군,222,18571,1094,19887,"2021-05-01",2021
"21-May",전남,고흥군,298,32125,621,33044,"2021-05-01",2021
"21-May",전남,곡성군,165,14841,714,15720,"2021-05-01",2021
"21-May",전남,광양시,248,83215,5932,89395,"2021-05-01",2021
"21-May",전남,구례군,142,13181,728,14051,"2021-05-01",2021
"21-May",전남,나주시,467,65135,3174,68776,"2021-05-01",2021
"21-May",전남,담양군,224,27187,1573,28984,"2021-05-01",2021
"21-May",전남,목포시,413,94782,5473,100668,"2021-05-01",2021
"21-May",전남,무안군,547,47629,1069,49245,"2021-05-01",2021
"21-May",전남,보성군,215,21669,22413,44297,"2021-05-01",2021
"21-May",전남,순천시,493,140540,5210,146243,"2021-05-01",2021
"21-May",전남,신안군,314,21368,63717,85399,"2021-05-01",2021
"21-May",전남,여수시,526,131707,7210,139443,"2021-05-01",2021
"21-May",전남,영광군,207,27766,766,28739,"2021-05-01",2021
"21-May",전남,영암군,260,33373,4280,37913,"2021-05-01",2021
"21-May",전남,완도군,281,25434,539,26254,"2021-05-01",2021
"21-May",전남,장성군,195,26615,1196,28006,"2021-05-01",2021
"21-May",전남,장흥군,255,20019,440,20714,"2021-05-01",2021
"21-May",전남,진도군,166,17052,293,17511,"2021-05-01",2021
"21-May",전남,함평군,201,18163,27957,46321,"2021-05-01",2021
"21-May",전남,해남군,325,39441,17875,57641,"2021-05-01",2021
"21-May",전남,화순군,222,32510,2107,34839,"2021-05-01",2021
"21-May",전남,계,6386,952323,174381,1133090,"2021-05-01",2021
"21-May",경북,경산시,323,137956,4456,142735,"2021-05-01",2021
"21-May",경북,경주시,581,141517,4611,146709,"2021-05-01",2021
"21-May",경북,고령군,174,20449,677,21300,"2021-05-01",2021
"21-May",경북,구미시,544,213611,7148,221303,"2021-05-01",2021
"21-May",경북,군위군,126,14837,300,15263,"2021-05-01",2021
"21-May",경북,김천시,388,74490,1939,76817,"2021-05-01",2021
"21-May",경북,문경시,279,36840,843,37962,"2021-05-01",2021
"21-May",경북,봉화군,200,18020,199,18419,"2021-05-01",2021
"21-May",경북,상주시,387,52984,1833,55204,"2021-05-01",2021
"21-May",경북,성주군,196,30586,1306,32088,"2021-05-01",2021
"21-May",경북,안동시,724,82587,2696,86007,"2021-05-01",2021
"21-May",경북,영덕군,253,18938,308,19499,"2021-05-01",2021
"21-May",경북,영양군,140,9687,114,9941,"2021-05-01",2021
"21-May",경북,영주시,365,55660,1520,57545,"2021-05-01",2021
"21-May",경북,영천시,323,59950,2591,62864,"2021-05-01",2021
"21-May",경북,예천군,271,30082,493,30846,"2021-05-01",2021
"21-May",경북,울릉군,155,5162,551,5868,"2021-05-01",2021
"21-May",경북,울진군,311,26235,354,26900,"2021-05-01",2021
"21-May",경북,의성군,311,30834,1117,32262,"2021-05-01",2021
"21-May",경북,청도군,218,24963,773,25954,"2021-05-01",2021
"21-May",경북,청송군,197,15630,206,16033,"2021-05-01",2021
"21-May",경북,칠곡군,300,68242,2360,70902,"2021-05-01",2021
"21-May",경북,포항시 남구,456,121122,8395,129973,"2021-05-01",2021
"21-May",경북,포항시 북구,333,140003,3799,144135,"2021-05-01",2021
"21-May",경북,계,7555,1430385,48589,1486529,"2021-05-01",2021
"21-May",경남,거제시,365,106195,2092,108652,"2021-05-01",2021
"21-May",경남,거창군,266,32384,786,33436,"2021-05-01",2021
"21-May",경남,고성군,228,26427,589,27244,"2021-05-01",2021
"21-May",경남,김해시,656,275369,7333,283358,"2021-05-01",2021
"21-May",경남,남해군,277,19831,457,20565,"2021-05-01",2021
"21-May",경남,밀양시,330,55976,3963,60269,"2021-05-01",2021
"21-May",경남,사천시,318,56343,1550,58211,"2021-05-01",2021
"21-May",경남,산청군,243,20202,779,21224,"2021-05-01",2021
"21-May",경남,양산시,412,166254,10128,176794,"2021-05-01",2021
"21-May",경남,의령군,201,14582,709,15492,"2021-05-01",2021
"21-May",경남,진주시,635,165385,6278,172298,"2021-05-01",2021
"21-May",경남,창녕군,233,35504,722,36459,"2021-05-01",2021
"21-May",경남,창원시 마산합포구,322,96327,2891,99540,"2021-05-01",2021
"21-May",경남,창원시 마산회원구,176,95439,4622,100237,"2021-05-01",2021
"21-May",경남,창원시 성산구,137,119237,3218,122592,"2021-05-01",2021
"21-May",경남,창원시 의창구,945,142559,49770,193274,"2021-05-01",2021
"21-May",경남,창원시 진해구,213,91725,1803,93741,"2021-05-01",2021
"21-May",경남,통영시,320,52317,1405,54042,"2021-05-01",2021
"21-May",경남,하동군,219,24041,398,24658,"2021-05-01",2021
"21-May",경남,함안군,193,40335,21149,61677,"2021-05-01",2021
"21-May",경남,함양군,212,19463,436,20111,"2021-05-01",2021
"21-May",경남,합천군,271,23330,616,24217,"2021-05-01",2021
"21-May",경남,계,7172,1679225,121694,1808091,"2021-05-01",2021
"21-May",제주,서귀포시,801,103773,1991,106565,"2021-05-01",2021
"21-May",제주,제주시,1627,281976,243234,526837,"2021-05-01",2021
"21-May",제주,계,2428,385749,245225,633402,"2021-05-01",2021
"21-Jun",서울,강남구,393,216866,18551,235810,"2021-06-01",2021
"21-Jun",서울,강동구,300,143619,8683,152602,"2021-06-01",2021
"21-Jun",서울,강북구,315,71066,4263,75644,"2021-06-01",2021
"21-Jun",서울,강서구,335,185878,18676,204889,"2021-06-01",2021
"21-Jun",서울,관악구,312,113022,5619,118953,"2021-06-01",2021
"21-Jun",서울,광진구,298,92880,5459,98637,"2021-06-01",2021
"21-Jun",서울,구로구,305,132148,12073,144526,"2021-06-01",2021
"21-Jun",서울,금천구,142,83035,6319,89496,"2021-06-01",2021
"21-Jun",서울,노원구,321,143365,9034,152720,"2021-06-01",2021
"21-Jun",서울,도봉구,274,88073,7285,95632,"2021-06-01",2021
"21-Jun",서울,동대문구,299,92976,4936,98211,"2021-06-01",2021
"21-Jun",서울,동작구,322,103052,2807,106181,"2021-06-01",2021
"21-Jun",서울,마포구,332,113208,7204,120744,"2021-06-01",2021
"21-Jun",서울,서대문구,465,83241,5783,89489,"2021-06-01",2021
"21-Jun",서울,서초구,513,167212,10536,178261,"2021-06-01",2021
"21-Jun",서울,성동구,343,93717,12944,107004,"2021-06-01",2021
"21-Jun",서울,성북구,293,115726,5214,121233,"2021-06-01",2021
"21-Jun",서울,송파구,390,231898,13225,245513,"2021-06-01",2021
"21-Jun",서울,양천구,314,142493,8579,151386,"2021-06-01",2021
"21-Jun",서울,영등포구,373,137244,9102,146719,"2021-06-01",2021
"21-Jun",서울,용산구,335,77302,2122,79759,"2021-06-01",2021
"21-Jun",서울,은평구,297,125233,6882,132412,"2021-06-01",2021
"21-Jun",서울,종로구,3767,44573,2070,50410,"2021-06-01",2021
"21-Jun",서울,중구,1221,45590,5620,52431,"2021-06-01",2021
"21-Jun",서울,중랑구,254,104681,9388,114323,"2021-06-01",2021
"21-Jun",서울,계,12513,2948098,202374,3162985,"2021-06-01",2021
"21-Jun",부산,강서구,312,80167,3857,84336,"2021-06-01",2021
"21-Jun",부산,금정구,273,80348,7434,88055,"2021-06-01",2021
"21-Jun",부산,기장군,261,80236,2628,83125,"2021-06-01",2021
"21-Jun",부산,남구,223,91060,8326,99609,"2021-06-01",2021
"21-Jun",부산,동구,183,49926,5066,55175,"2021-06-01",2021
"21-Jun",부산,동래구,172,92830,3913,96915,"2021-06-01",2021
"21-Jun",부산,부산진구,370,124111,20738,145219,"2021-06-01",2021
"21-Jun",부산,북구,229,101430,3522,105181,"2021-06-01",2021
"21-Jun",부산,사상구,285,83156,5864,89305,"2021-06-01",2021
"21-Jun",부산,사하구,264,106776,6502,113542,"2021-06-01",2021
"21-Jun",부산,서구,138,29199,1425,30762,"2021-06-01",2021
"21-Jun",부산,수영구,161,67224,35630,103015,"2021-06-01",2021
"21-Jun",부산,연제구,958,90501,11901,103360,"2021-06-01",2021
"21-Jun",부산,영도구,226,31114,1979,33319,"2021-06-01",2021
"21-Jun",부산,중구,307,29645,6985,36937,"2021-06-01",2021
"21-Jun",부산,해운대구,321,165998,13766,180085,"2021-06-01",2021
"21-Jun",부산,계,4683,1303721,139536,1447940,"2021-06-01",2021
"21-Jun",대구,남구,341,56129,1644,58114,"2021-06-01",2021
"21-Jun",대구,달서구,497,271318,14044,285859,"2021-06-01",2021
"21-Jun",대구,달성군,547,134749,5077,140373,"2021-06-01",2021
"21-Jun",대구,동구,352,153865,11237,165454,"2021-06-01",2021
"21-Jun",대구,북구,500,201745,7533,209778,"2021-06-01",2021
"21-Jun",대구,서구,252,68668,3968,72888,"2021-06-01",2021
"21-Jun",대구,수성구,605,215370,5194,221169,"2021-06-01",2021
"21-Jun",대구,중구,306,61190,2633,64129,"2021-06-01",2021
"21-Jun",대구,계,3400,1163034,51330,1217764,"2021-06-01",2021
"21-Jun",인천,강화군,355,35445,26523,62323,"2021-06-01",2021
"21-Jun",인천,계양구,296,120803,189750,310849,"2021-06-01",2021
"21-Jun",인천,남동구,859,256386,50093,307338,"2021-06-01",2021
"21-Jun",인천,동구,96,24491,2584,27171,"2021-06-01",2021
"21-Jun",인천,미추홀구,429,164635,9632,174696,"2021-06-01",2021
"21-Jun",인천,부평구,337,218614,25836,244787,"2021-06-01",2021
"21-Jun",인천,서구,442,240817,11297,252556,"2021-06-01",2021
"21-Jun",인천,연수구,419,197782,8471,206672,"2021-06-01",2021
"21-Jun",인천,옹진군,212,12145,215,12572,"2021-06-01",2021
"21-Jun",인천,중구,639,65501,12030,78170,"2021-06-01",2021
"21-Jun",인천,계,4084,1336619,336431,1677134,"2021-06-01",2021
"21-Jun",광주,광산구,516,195948,12553,209017,"2021-06-01",2021
"21-Jun",광주,남구,212,90607,2829,93648,"2021-06-01",2021
"21-Jun",광주,동구,241,43074,1255,44570,"2021-06-01",2021
"21-Jun",광주,북구,604,189398,9032,199034,"2021-06-01",2021
"21-Jun",광주,서구,650,140937,6483,148070,"2021-06-01",2021
"21-Jun",광주,계,2223,659964,32152,694339,"2021-06-01",2021
"21-Jun",대전,대덕구,234,85486,6757,92477,"2021-06-01",2021
"21-Jun",대전,동구,241,90852,4701,95794,"2021-06-01",2021
"21-Jun",대전,서구,800,205705,7847,214352,"2021-06-01",2021
"21-Jun",대전,유성구,368,177181,5029,182578,"2021-06-01",2021
"21-Jun",대전,중구,238,96076,5563,101877,"2021-06-01",2021
"21-Jun",대전,계,1881,655300,29897,687078,"2021-06-01",2021
"21-Jun",울산,남구,719,153844,7396,161959,"2021-06-01",2021
"21-Jun",울산,동구,189,61718,1069,62976,"2021-06-01",2021
"21-Jun",울산,북구,221,115152,3683,119056,"2021-06-01",2021
"21-Jun",울산,울주군,382,123841,6871,131094,"2021-06-01",2021
"21-Jun",울산,중구,336,100291,2544,103171,"2021-06-01",2021
"21-Jun",울산,계,1847,554846,21563,578256,"2021-06-01",2021
"21-Jun",세종,세종특별자치시,798,176036,3015,179849,"2021-06-01",2021
"21-Jun",세종,계,798,176036,3015,179849,"2021-06-01",2021
"21-Jun",경기,가평군,371,31193,595,32159,"2021-06-01",2021
"21-Jun",경기,고양시 덕양구,676,181946,3925,186547,"2021-06-01",2021
"21-Jun",경기,고양시 일산동구,276,125271,5612,131159,"2021-06-01",2021
"21-Jun",경기,고양시 일산서구,126,116347,4476,120949,"2021-06-01",2021
"21-Jun",경기,과천시,715,25615,605,26935,"2021-06-01",2021
"21-Jun",경기,광명시,309,100260,4426,104995,"2021-06-01",2021
"21-Jun",경기,광주시,378,193422,8378,202178,"2021-06-01",2021
"21-Jun",경기,구리시,260,70358,2724,73342,"2021-06-01",2021
"21-Jun",경기,군포시,303,98169,5128,103600,"2021-06-01",2021
"21-Jun",경기,김포시,531,226646,7940,235117,"2021-06-01",2021
"21-Jun",경기,남양주시,736,301693,8530,310959,"2021-06-01",2021
"21-Jun",경기,동두천시,209,38008,1437,39654,"2021-06-01",2021
"21-Jun",경기,부천시,705,293994,12462,307161,"2021-06-01",2021
"21-Jun",경기,성남시 분당구,370,184593,6968,191931,"2021-06-01",2021
"21-Jun",경기,성남시 수정구,356,76815,2501,79672,"2021-06-01",2021
"21-Jun",경기,성남시 중원구,345,71995,4162,76502,"2021-06-01",2021
"21-Jun",경기,수원시 권선구,492,189555,8928,198975,"2021-06-01",2021
"21-Jun",경기,수원시 영통구,226,147376,3162,150764,"2021-06-01",2021
"21-Jun",경기,수원시 장안구,476,100922,3791,105189,"2021-06-01",2021
"21-Jun",경기,수원시 팔달구,500,72923,2937,76360,"2021-06-01",2021
"21-Jun",경기,시흥시,463,250267,8058,258788,"2021-06-01",2021
"21-Jun",경기,안산시 단원구,555,155486,8172,164213,"2021-06-01",2021
"21-Jun",경기,안산시 상록구,175,144032,5012,149219,"2021-06-01",2021
"21-Jun",경기,안성시,390,105402,4890,110682,"2021-06-01",2021
"21-Jun",경기,안양시 동안구,399,117474,6517,124390,"2021-06-01",2021
"21-Jun",경기,안양시 만안구,155,83849,3886,87890,"2021-06-01",2021
"21-Jun",경기,양주시,378,110113,3268,113759,"2021-06-01",2021
"21-Jun",경기,양평군,571,60871,1827,63269,"2021-06-01",2021
"21-Jun",경기,여주시,459,63540,7290,71289,"2021-06-01",2021
"21-Jun",경기,연천군,305,23879,5224,29408,"2021-06-01",2021
"21-Jun",경기,오산시,208,107647,3530,111385,"2021-06-01",2021
"21-Jun",경기,용인시 기흥구,126,188388,6570,195084,"2021-06-01",2021
"21-Jun",경기,용인시 수지구,49,146059,2585,148693,"2021-06-01",2021
"21-Jun",경기,용인시 처인구,762,132877,7662,141301,"2021-06-01",2021
"21-Jun",경기,의왕시,296,64656,2905,67857,"2021-06-01",2021
"21-Jun",경기,의정부시,732,163898,5296,169926,"2021-06-01",2021
"21-Jun",경기,이천시,412,114168,5939,120519,"2021-06-01",2021
"21-Jun",경기,파주시,530,218161,10159,228850,"2021-06-01",2021
"21-Jun",경기,평택시,741,288953,12469,302163,"2021-06-01",2021
"21-Jun",경기,포천시,392,86602,8979,95973,"2021-06-01",2021
"21-Jun",경기,하남시,397,127170,3007,130574,"2021-06-01",2021
"21-Jun",경기,화성시,926,454652,12441,468019,"2021-06-01",2021
"21-Jun",경기,계,17781,5855245,234373,6107399,"2021-06-01",2021
"21-Jun",강원,강릉시,538,108699,4616,113853,"2021-06-01",2021
"21-Jun",강원,고성군,187,14608,226,15021,"2021-06-01",2021
"21-Jun",강원,동해시,306,45533,1457,47296,"2021-06-01",2021
"21-Jun",강원,삼척시,393,32229,761,33383,"2021-06-01",2021
"21-Jun",강원,속초시,299,38415,1390,40104,"2021-06-01",2021
"21-Jun",강원,양구군,197,12023,139,12359,"2021-06-01",2021
"21-Jun",강원,양양군,191,16039,291,16521,"2021-06-01",2021
"21-Jun",강원,영월군,328,21168,360,21856,"2021-06-01",2021
"21-Jun",강원,원주시,589,176104,5611,182304,"2021-06-01",2021
"21-Jun",강원,인제군,218,18657,278,19153,"2021-06-01",2021
"21-Jun",강원,정선군,335,20669,475,21479,"2021-06-01",2021
"21-Jun",강원,철원군,241,24161,318,24720,"2021-06-01",2021
"21-Jun",강원,춘천시,824,133595,6169,140588,"2021-06-01",2021
"21-Jun",강원,태백시,224,19926,754,20904,"2021-06-01",2021
"21-Jun",강원,평창군,290,25663,487,26440,"2021-06-01",2021
"21-Jun",강원,홍천군,425,39085,1024,40534,"2021-06-01",2021
"21-Jun",강원,화천군,230,13058,185,13473,"2021-06-01",2021
"21-Jun",강원,횡성군,258,26909,728,27895,"2021-06-01",2021
"21-Jun",강원,계,6073,786541,25269,817883,"2021-06-01",2021
"21-Jun",충북,괴산군,209,22847,412,23468,"2021-06-01",2021
"21-Jun",충북,단양군,223,15612,782,16617,"2021-06-01",2021
"21-Jun",충북,보은군,231,18109,1026,19366,"2021-06-01",2021
"21-Jun",충북,영동군,246,24901,401,25548,"2021-06-01",2021
"21-Jun",충북,옥천군,207,27258,1149,28614,"2021-06-01",2021
"21-Jun",충북,음성군,235,58396,1937,60568,"2021-06-01",2021
"21-Jun",충북,제천시,342,67181,3433,70956,"2021-06-01",2021
"21-Jun",충북,증평군,90,19268,742,20100,"2021-06-01",2021
"21-Jun",충북,진천군,214,50402,1307,51923,"2021-06-01",2021
"21-Jun",충북,청원군,1,19,0,20,"2021-06-01",2021
"21-Jun",충북,청주시 상당구,518,92511,2643,95672,"2021-06-01",2021
"21-Jun",충북,청주시 서원구,238,97645,4330,102213,"2021-06-01",2021
"21-Jun",충북,청주시 청원구,343,102824,4050,107217,"2021-06-01",2021
"21-Jun",충북,청주시 흥덕구,357,130349,7764,138470,"2021-06-01",2021
"21-Jun",충북,충주시,598,110018,7142,117758,"2021-06-01",2021
"21-Jun",충북,계,4052,837340,37118,878510,"2021-06-01",2021
"21-Jun",충남,계룡시,153,22400,532,23085,"2021-06-01",2021
"21-Jun",충남,공주시,576,53960,2525,57061,"2021-06-01",2021
"21-Jun",충남,금산군,194,28459,2114,30767,"2021-06-01",2021
"21-Jun",충남,논산시,405,60741,2416,63562,"2021-06-01",2021
"21-Jun",충남,당진시,394,95878,4000,100272,"2021-06-01",2021
"21-Jun",충남,보령시,404,52330,1344,54078,"2021-06-01",2021
"21-Jun",충남,부여군,297,34181,1220,35698,"2021-06-01",2021
"21-Jun",충남,서산시,411,95624,3477,99512,"2021-06-01",2021
"21-Jun",충남,서천군,235,27047,859,28141,"2021-06-01",2021
"21-Jun",충남,아산시,527,170610,6698,177835,"2021-06-01",2021
"21-Jun",충남,예산군,409,43139,1382,44930,"2021-06-01",2021
"21-Jun",충남,천안시 동남구,280,131204,5013,136497,"2021-06-01",2021
"21-Jun",충남,천안시 서북구,527,197055,5514,203096,"2021-06-01",2021
"21-Jun",충남,청양군,254,16808,831,17893,"2021-06-01",2021
"21-Jun",충남,태안군,313,34203,574,35090,"2021-06-01",2021
"21-Jun",충남,홍성군,419,53052,1426,54897,"2021-06-01",2021
"21-Jun",충남,계,5798,1116691,39925,1162414,"2021-06-01",2021
"21-Jun",전북,고창군,301,30382,582,31265,"2021-06-01",2021
"21-Jun",전북,군산시,544,130900,6381,137825,"2021-06-01",2021
"21-Jun",전북,김제시,282,45323,1936,47541,"2021-06-01",2021
"21-Jun",전북,남원시,407,41012,4175,45594,"2021-06-01",2021
"21-Jun",전북,무주군,192,12831,395,13418,"2021-06-01",2021
"21-Jun",전북,부안군,262,27397,617,28276,"2021-06-01",2021
"21-Jun",전북,순창군,230,14604,147,14981,"2021-06-01",2021
"21-Jun",전북,완주군,411,51516,3173,55100,"2021-06-01",2021
"21-Jun",전북,익산시,511,136217,5945,142673,"2021-06-01",2021
"21-Jun",전북,임실군,215,14231,426,14872,"2021-06-01",2021
"21-Jun",전북,장수군,235,12162,179,12576,"2021-06-01",2021
"21-Jun",전북,전주시 덕진구,379,172244,6958,179581,"2021-06-01",2021
"21-Jun",전북,전주시 완산구,728,151871,4166,156765,"2021-06-01",2021
"21-Jun",전북,정읍시,354,54623,3659,58636,"2021-06-01",2021
"21-Jun",전북,진안군,259,14107,228,14594,"2021-06-01",2021
"21-Jun",전북,계,5310,909420,38967,953697,"2021-06-01",2021
"21-Jun",전남,강진군,223,18597,1094,19914,"2021-06-01",2021
"21-Jun",전남,고흥군,303,32229,620,33152,"2021-06-01",2021
"21-Jun",전남,곡성군,160,14839,705,15704,"2021-06-01",2021
"21-Jun",전남,광양시,247,83349,5942,89538,"2021-06-01",2021
"21-Jun",전남,구례군,139,13184,726,14049,"2021-06-01",2021
"21-Jun",전남,나주시,462,65229,3181,68872,"2021-06-01",2021
"21-Jun",전남,담양군,224,27255,1578,29057,"2021-06-01",2021
"21-Jun",전남,목포시,421,94820,5491,100732,"2021-06-01",2021
"21-Jun",전남,무안군,564,47996,1073,49633,"2021-06-01",2021
"21-Jun",전남,보성군,217,21668,16530,38415,"2021-06-01",2021
"21-Jun",전남,순천시,491,140796,5208,146495,"2021-06-01",2021
"21-Jun",전남,신안군,318,21420,66511,88249,"2021-06-01",2021
"21-Jun",전남,여수시,527,131841,7222,139590,"2021-06-01",2021
"21-Jun",전남,영광군,210,27783,756,28749,"2021-06-01",2021
"21-Jun",전남,영암군,262,33415,3679,37356,"2021-06-01",2021
"21-Jun",전남,완도군,280,25453,540,26273,"2021-06-01",2021
"21-Jun",전남,장성군,197,26597,1222,28016,"2021-06-01",2021
"21-Jun",전남,장흥군,256,20026,443,20725,"2021-06-01",2021
"21-Jun",전남,진도군,166,17078,292,17536,"2021-06-01",2021
"21-Jun",전남,함평군,202,18130,32701,51033,"2021-06-01",2021
"21-Jun",전남,해남군,329,39443,21074,60846,"2021-06-01",2021
"21-Jun",전남,화순군,227,32589,2127,34943,"2021-06-01",2021
"21-Jun",전남,계,6425,953737,178715,1138877,"2021-06-01",2021
"21-Jun",경북,경산시,328,138339,4481,143148,"2021-06-01",2021
"21-Jun",경북,경주시,585,141473,4594,146652,"2021-06-01",2021
"21-Jun",경북,고령군,167,20436,675,21278,"2021-06-01",2021
"21-Jun",경북,구미시,559,213592,7196,221347,"2021-06-01",2021
"21-Jun",경북,군위군,124,14863,300,15287,"2021-06-01",2021
"21-Jun",경북,김천시,389,74511,1947,76847,"2021-06-01",2021
"21-Jun",경북,문경시,278,36897,847,38022,"2021-06-01",2021
"21-Jun",경북,봉화군,200,18014,200,18414,"2021-06-01",2021
"21-Jun",경북,상주시,389,52991,1841,55221,"2021-06-01",2021
"21-Jun",경북,성주군,196,30671,1302,32169,"2021-06-01",2021
"21-Jun",경북,안동시,738,82533,2710,85981,"2021-06-01",2021
"21-Jun",경북,영덕군,253,18966,309,19528,"2021-06-01",2021
"21-Jun",경북,영양군,139,9740,114,9993,"2021-06-01",2021
"21-Jun",경북,영주시,368,55733,1519,57620,"2021-06-01",2021
"21-Jun",경북,영천시,332,59840,2586,62758,"2021-06-01",2021
"21-Jun",경북,예천군,270,30102,491,30863,"2021-06-01",2021
"21-Jun",경북,울릉군,159,5178,553,5890,"2021-06-01",2021
"21-Jun",경북,울진군,310,26297,354,26961,"2021-06-01",2021
"21-Jun",경북,의성군,313,30863,1114,32290,"2021-06-01",2021
"21-Jun",경북,청도군,221,24914,777,25912,"2021-06-01",2021
"21-Jun",경북,청송군,199,15680,202,16081,"2021-06-01",2021
"21-Jun",경북,칠곡군,301,68253,2368,70922,"2021-06-01",2021
"21-Jun",경북,포항시 남구,459,121352,8383,130194,"2021-06-01",2021
"21-Jun",경북,포항시 북구,332,140227,3768,144327,"2021-06-01",2021
"21-Jun",경북,계,7609,1431465,48631,1487705,"2021-06-01",2021
"21-Jun",경남,거제시,361,106224,2105,108690,"2021-06-01",2021
"21-Jun",경남,거창군,271,32410,788,33469,"2021-06-01",2021
"21-Jun",경남,고성군,228,26459,586,27273,"2021-06-01",2021
"21-Jun",경남,김해시,657,275792,7347,283796,"2021-06-01",2021
"21-Jun",경남,남해군,278,19907,458,20643,"2021-06-01",2021
"21-Jun",경남,밀양시,330,56059,3960,60349,"2021-06-01",2021
"21-Jun",경남,사천시,318,56469,1534,58321,"2021-06-01",2021
"21-Jun",경남,산청군,242,20226,782,21250,"2021-06-01",2021
"21-Jun",경남,양산시,415,166676,10185,177276,"2021-06-01",2021
"21-Jun",경남,의령군,203,14572,705,15480,"2021-06-01",2021
"21-Jun",경남,진주시,642,165833,6286,172761,"2021-06-01",2021
"21-Jun",경남,창녕군,239,35550,724,36513,"2021-06-01",2021
"21-Jun",경남,창원시 마산합포구,329,96469,2887,99685,"2021-06-01",2021
"21-Jun",경남,창원시 마산회원구,178,95727,4742,100647,"2021-06-01",2021
"21-Jun",경남,창원시 성산구,136,119844,3281,123261,"2021-06-01",2021
"21-Jun",경남,창원시 의창구,939,142948,49810,193697,"2021-06-01",2021
"21-Jun",경남,창원시 진해구,214,92161,1815,94190,"2021-06-01",2021
"21-Jun",경남,통영시,318,52371,1400,54089,"2021-06-01",2021
"21-Jun",경남,하동군,220,24034,389,24643,"2021-06-01",2021
"21-Jun",경남,함안군,198,40363,21260,61821,"2021-06-01",2021
"21-Jun",경남,함양군,213,19503,440,20156,"2021-06-01",2021
"21-Jun",경남,합천군,275,23375,615,24265,"2021-06-01",2021
"21-Jun",경남,계,7204,1682972,122099,1812275,"2021-06-01",2021
"21-Jun",제주,서귀포시,796,103873,1987,106656,"2021-06-01",2021
"21-Jun",제주,제주시,1624,283531,246335,531490,"2021-06-01",2021
"21-Jun",제주,계,2420,387404,248322,638146,"2021-06-01",2021
"21-Jul",서울,강남구,394,216661,18730,235785,"2021-07-01",2021
"21-Jul",서울,강동구,299,143757,8688,152744,"2021-07-01",2021
"21-Jul",서울,강북구,319,71010,4252,75581,"2021-07-01",2021
"21-Jul",서울,강서구,336,186074,18622,205032,"2021-07-01",2021
"21-Jul",서울,관악구,311,113112,5574,118997,"2021-07-01",2021
"21-Jul",서울,광진구,300,92835,5452,98587,"2021-07-01",2021
"21-Jul",서울,구로구,305,132133,11923,144361,"2021-07-01",2021
"21-Jul",서울,금천구,142,83380,6289,89811,"2021-07-01",2021
"21-Jul",서울,노원구,320,143428,8978,152726,"2021-07-01",2021
"21-Jul",서울,도봉구,278,88155,7243,95676,"2021-07-01",2021
"21-Jul",서울,동대문구,300,93125,4934,98359,"2021-07-01",2021
"21-Jul",서울,동작구,322,103140,2815,106277,"2021-07-01",2021
"21-Jul",서울,마포구,335,113317,7248,120900,"2021-07-01",2021
"21-Jul",서울,서대문구,467,83280,5791,89538,"2021-07-01",2021
"21-Jul",서울,서초구,517,167266,10569,178352,"2021-07-01",2021
"21-Jul",서울,성동구,345,93833,12966,107144,"2021-07-01",2021
"21-Jul",서울,성북구,299,115806,5190,121295,"2021-07-01",2021
"21-Jul",서울,송파구,391,231955,13280,245626,"2021-07-01",2021
"21-Jul",서울,양천구,315,142650,8562,151527,"2021-07-01",2021
"21-Jul",서울,영등포구,374,136988,9038,146400,"2021-07-01",2021
"21-Jul",서울,용산구,336,77310,2163,79809,"2021-07-01",2021
"21-Jul",서울,은평구,297,125438,6876,132611,"2021-07-01",2021
"21-Jul",서울,종로구,3774,44616,1988,50378,"2021-07-01",2021
"21-Jul",서울,중구,1223,53160,5551,59934,"2021-07-01",2021
"21-Jul",서울,중랑구,252,104660,9405,114317,"2021-07-01",2021
"21-Jul",서울,계,12551,2957089,202127,3171767,"2021-07-01",2021
"21-Jul",부산,강서구,316,80575,3833,84724,"2021-07-01",2021
"21-Jul",부산,금정구,273,80471,7585,88329,"2021-07-01",2021
"21-Jul",부산,기장군,261,80329,2620,83210,"2021-07-01",2021
"21-Jul",부산,남구,224,91169,8348,99741,"2021-07-01",2021
"21-Jul",부산,동구,182,50272,5065,55519,"2021-07-01",2021
"21-Jul",부산,동래구,172,92716,3706,96594,"2021-07-01",2021
"21-Jul",부산,부산진구,368,124116,20868,145352,"2021-07-01",2021
"21-Jul",부산,북구,233,101669,3535,105437,"2021-07-01",2021
"21-Jul",부산,사상구,285,83293,5869,89447,"2021-07-01",2021
"21-Jul",부산,사하구,267,106686,6453,113406,"2021-07-01",2021
"21-Jul",부산,서구,138,29226,1416,30780,"2021-07-01",2021
"21-Jul",부산,수영구,163,67070,36405,103638,"2021-07-01",2021
"21-Jul",부산,연제구,955,90838,12146,103939,"2021-07-01",2021
"21-Jul",부산,영도구,226,31163,1985,33374,"2021-07-01",2021
"21-Jul",부산,중구,312,29827,6981,37120,"2021-07-01",2021
"21-Jul",부산,해운대구,325,166170,14175,180670,"2021-07-01",2021
"21-Jul",부산,계,4700,1305590,140990,1451280,"2021-07-01",2021
"21-Jul",대구,남구,341,56136,1631,58108,"2021-07-01",2021
"21-Jul",대구,달서구,495,271978,14098,286571,"2021-07-01",2021
"21-Jul",대구,달성군,548,135236,5086,140870,"2021-07-01",2021
"21-Jul",대구,동구,355,154317,11318,165990,"2021-07-01",2021
"21-Jul",대구,북구,501,202105,7569,210175,"2021-07-01",2021
"21-Jul",대구,서구,253,68653,4101,73007,"2021-07-01",2021
"21-Jul",대구,수성구,600,208104,4992,213696,"2021-07-01",2021
"21-Jul",대구,중구,307,58968,2622,61897,"2021-07-01",2021
"21-Jul",대구,계,3400,1155497,51417,1210314,"2021-07-01",2021
"21-Jul",인천,강화군,355,35564,25535,61454,"2021-07-01",2021
"21-Jul",인천,계양구,292,120944,189748,310984,"2021-07-01",2021
"21-Jul",인천,남동구,886,252030,49531,302447,"2021-07-01",2021
"21-Jul",인천,동구,104,24870,2634,27608,"2021-07-01",2021
"21-Jul",인천,미추홀구,425,165490,9415,175330,"2021-07-01",2021
"21-Jul",인천,부평구,334,219433,26744,246511,"2021-07-01",2021
"21-Jul",인천,서구,442,241994,11260,253696,"2021-07-01",2021
"21-Jul",인천,연수구,420,198472,8489,207381,"2021-07-01",2021
"21-Jul",인천,옹진군,213,12201,230,12644,"2021-07-01",2021
"21-Jul",인천,중구,675,65881,12046,78602,"2021-07-01",2021
"21-Jul",인천,계,4146,1336879,335632,1676657,"2021-07-01",2021
"21-Jul",광주,광산구,511,196178,12570,209259,"2021-07-01",2021
"21-Jul",광주,남구,206,90923,2893,94022,"2021-07-01",2021
"21-Jul",광주,동구,237,43173,1268,44678,"2021-07-01",2021
"21-Jul",광주,북구,617,189852,9033,199502,"2021-07-01",2021
"21-Jul",광주,서구,672,140749,6381,147802,"2021-07-01",2021
"21-Jul",광주,계,2243,660875,32145,695263,"2021-07-01",2021
"21-Jul",대전,대덕구,233,85736,6802,92771,"2021-07-01",2021
"21-Jul",대전,동구,244,91152,4715,96111,"2021-07-01",2021
"21-Jul",대전,서구,797,205948,7880,214625,"2021-07-01",2021
"21-Jul",대전,유성구,366,177834,5084,183284,"2021-07-01",2021
"21-Jul",대전,중구,233,96149,5565,101947,"2021-07-01",2021
"21-Jul",대전,계,1873,656819,30046,688738,"2021-07-01",2021
"21-Jul",울산,남구,721,153814,7409,161944,"2021-07-01",2021
"21-Jul",울산,동구,189,61768,1074,63031,"2021-07-01",2021
"21-Jul",울산,북구,220,115368,3369,118957,"2021-07-01",2021
"21-Jul",울산,울주군,407,124155,7225,131787,"2021-07-01",2021
"21-Jul",울산,중구,311,100402,2501,103214,"2021-07-01",2021
"21-Jul",울산,계,1848,555507,21578,578933,"2021-07-01",2021
"21-Jul",세종,세종특별자치시,803,176843,3046,180692,"2021-07-01",2021
"21-Jul",세종,계,803,176843,3046,180692,"2021-07-01",2021
"21-Jul",경기,가평군,370,31230,596,32196,"2021-07-01",2021
"21-Jul",경기,고양시 덕양구,678,182536,3927,187141,"2021-07-01",2021
"21-Jul",경기,고양시 일산동구,276,125491,5507,131274,"2021-07-01",2021
"21-Jul",경기,고양시 일산서구,127,116582,4547,121256,"2021-07-01",2021
"21-Jul",경기,과천시,717,25749,604,27070,"2021-07-01",2021
"21-Jul",경기,광명시,309,100521,4445,105275,"2021-07-01",2021
"21-Jul",경기,광주시,381,193864,8461,202706,"2021-07-01",2021
"21-Jul",경기,구리시,258,70325,2736,73319,"2021-07-01",2021
"21-Jul",경기,군포시,300,98244,5146,103690,"2021-07-01",2021
"21-Jul",경기,김포시,529,227486,8008,236023,"2021-07-01",2021
"21-Jul",경기,남양주시,738,302795,8549,312082,"2021-07-01",2021
"21-Jul",경기,동두천시,209,38144,1445,39798,"2021-07-01",2021
"21-Jul",경기,부천시,701,294979,12484,308164,"2021-07-01",2021
"21-Jul",경기,성남시 분당구,371,185503,7006,192880,"2021-07-01",2021
"21-Jul",경기,성남시 수정구,354,76783,2536,79673,"2021-07-01",2021
"21-Jul",경기,성남시 중원구,344,71904,4108,76356,"2021-07-01",2021
"21-Jul",경기,수원시 권선구,485,190804,8968,200257,"2021-07-01",2021
"21-Jul",경기,수원시 영통구,225,147517,3177,150919,"2021-07-01",2021
"21-Jul",경기,수원시 장안구,475,101022,3810,105307,"2021-07-01",2021
"21-Jul",경기,수원시 팔달구,514,73052,2941,76507,"2021-07-01",2021
"21-Jul",경기,시흥시,460,251371,8125,259956,"2021-07-01",2021
"21-Jul",경기,안산시 단원구,558,155768,8193,164519,"2021-07-01",2021
"21-Jul",경기,안산시 상록구,176,144366,5030,149572,"2021-07-01",2021
"21-Jul",경기,안성시,395,105566,4626,110587,"2021-07-01",2021
"21-Jul",경기,안양시 동안구,400,117185,6542,124127,"2021-07-01",2021
"21-Jul",경기,안양시 만안구,155,84141,3891,88187,"2021-07-01",2021
"21-Jul",경기,양주시,395,110316,3288,113999,"2021-07-01",2021
"21-Jul",경기,양평군,572,61098,1815,63485,"2021-07-01",2021
"21-Jul",경기,여주시,459,63652,7258,71369,"2021-07-01",2021
"21-Jul",경기,연천군,308,23924,5219,29451,"2021-07-01",2021
"21-Jul",경기,오산시,211,108094,3792,112097,"2021-07-01",2021
"21-Jul",경기,용인시 기흥구,127,189074,6471,195672,"2021-07-01",2021
"21-Jul",경기,용인시 수지구,49,146136,2603,148788,"2021-07-01",2021
"21-Jul",경기,용인시 처인구,764,133142,7695,141601,"2021-07-01",2021
"21-Jul",경기,의왕시,298,65171,2895,68364,"2021-07-01",2021
"21-Jul",경기,의정부시,746,164747,5322,170815,"2021-07-01",2021
"21-Jul",경기,이천시,410,114613,6235,121258,"2021-07-01",2021
"21-Jul",경기,파주시,529,219101,10105,229735,"2021-07-01",2021
"21-Jul",경기,평택시,753,290220,12467,303440,"2021-07-01",2021
"21-Jul",경기,포천시,390,86949,8806,96145,"2021-07-01",2021
"21-Jul",경기,하남시,397,128309,3066,131772,"2021-07-01",2021
"21-Jul",경기,화성시,921,456706,12580,470207,"2021-07-01",2021
"21-Jul",경기,계,17834,5874180,235025,6127039,"2021-07-01",2021
"21-Jul",강원,강릉시,537,109061,4655,114253,"2021-07-01",2021
"21-Jul",강원,고성군,191,14699,225,15115,"2021-07-01",2021
"21-Jul",강원,동해시,309,45676,1458,47443,"2021-07-01",2021
"21-Jul",강원,삼척시,394,32262,762,33418,"2021-07-01",2021
"21-Jul",강원,속초시,302,38566,1393,40261,"2021-07-01",2021
"21-Jul",강원,양구군,199,12068,140,12407,"2021-07-01",2021
"21-Jul",강원,양양군,190,16102,293,16585,"2021-07-01",2021
"21-Jul",강원,영월군,329,21204,361,21894,"2021-07-01",2021
"21-Jul",강원,원주시,584,176550,5577,182711,"2021-07-01",2021
"21-Jul",강원,인제군,218,18772,280,19270,"2021-07-01",2021
"21-Jul",강원,정선군,335,20689,475,21499,"2021-07-01",2021
"21-Jul",강원,철원군,242,24190,319,24751,"2021-07-01",2021
"21-Jul",강원,춘천시,831,133903,6197,140931,"2021-07-01",2021
"21-Jul",강원,태백시,222,19936,755,20913,"2021-07-01",2021
"21-Jul",강원,평창군,292,25625,492,26409,"2021-07-01",2021
"21-Jul",강원,홍천군,425,39158,1026,40609,"2021-07-01",2021
"21-Jul",강원,화천군,228,13073,187,13488,"2021-07-01",2021
"21-Jul",강원,횡성군,259,27021,723,28003,"2021-07-01",2021
"21-Jul",강원,계,6087,788555,25318,819960,"2021-07-01",2021
"21-Jul",충북,괴산군,211,22862,411,23484,"2021-07-01",2021
"21-Jul",충북,단양군,224,15675,780,16679,"2021-07-01",2021
"21-Jul",충북,보은군,233,18134,1024,19391,"2021-07-01",2021
"21-Jul",충북,영동군,250,24963,400,25613,"2021-07-01",2021
"21-Jul",충북,옥천군,214,27382,1149,28745,"2021-07-01",2021
"21-Jul",충북,음성군,238,58573,1934,60745,"2021-07-01",2021
"21-Jul",충북,제천시,341,67339,3425,71105,"2021-07-01",2021
"21-Jul",충북,증평군,90,19271,740,20101,"2021-07-01",2021
"21-Jul",충북,진천군,214,50519,1294,52027,"2021-07-01",2021
"21-Jul",충북,청원군,1,19,0,20,"2021-07-01",2021
"21-Jul",충북,청주시 상당구,519,92773,2646,95938,"2021-07-01",2021
"21-Jul",충북,청주시 서원구,237,101865,4327,106429,"2021-07-01",2021
"21-Jul",충북,청주시 청원구,345,103313,4400,108058,"2021-07-01",2021
"21-Jul",충북,청주시 흥덕구,355,131079,7461,138895,"2021-07-01",2021
"21-Jul",충북,충주시,601,110232,7128,117961,"2021-07-01",2021
"21-Jul",충북,계,4073,843999,37119,885191,"2021-07-01",2021
"21-Jul",충남,계룡시,153,22448,534,23135,"2021-07-01",2021
"21-Jul",충남,공주시,580,54048,2555,57183,"2021-07-01",2021
"21-Jul",충남,금산군,194,28541,2129,30864,"2021-07-01",2021
"21-Jul",충남,논산시,416,60826,2425,63667,"2021-07-01",2021
"21-Jul",충남,당진시,394,96229,3998,100621,"2021-07-01",2021
"21-Jul",충남,보령시,405,52381,1348,54134,"2021-07-01",2021
"21-Jul",충남,부여군,298,34329,1212,35839,"2021-07-01",2021
"21-Jul",충남,서산시,412,95863,3545,99820,"2021-07-01",2021
"21-Jul",충남,서천군,236,27047,863,28146,"2021-07-01",2021
"21-Jul",충남,아산시,524,171587,6730,178841,"2021-07-01",2021
"21-Jul",충남,예산군,412,43228,1382,45022,"2021-07-01",2021
"21-Jul",충남,천안시 동남구,285,131501,5030,136816,"2021-07-01",2021
"21-Jul",충남,천안시 서북구,525,197677,5542,203744,"2021-07-01",2021
"21-Jul",충남,청양군,256,16865,829,17950,"2021-07-01",2021
"21-Jul",충남,태안군,312,34274,570,35156,"2021-07-01",2021
"21-Jul",충남,홍성군,420,53103,1426,54949,"2021-07-01",2021
"21-Jul",충남,계,5822,1119947,40118,1165887,"2021-07-01",2021
"21-Jul",전북,고창군,301,30483,577,31361,"2021-07-01",2021
"21-Jul",전북,군산시,541,131152,6400,138093,"2021-07-01",2021
"21-Jul",전북,김제시,284,45410,1931,47625,"2021-07-01",2021
"21-Jul",전북,남원시,410,41066,4052,45528,"2021-07-01",2021
"21-Jul",전북,무주군,193,12858,397,13448,"2021-07-01",2021
"21-Jul",전북,부안군,260,27474,617,28351,"2021-07-01",2021
"21-Jul",전북,순창군,230,14613,148,14991,"2021-07-01",2021
"21-Jul",전북,완주군,410,51769,3213,55392,"2021-07-01",2021
"21-Jul",전북,익산시,511,136442,5932,142885,"2021-07-01",2021
"21-Jul",전북,임실군,218,14254,427,14899,"2021-07-01",2021
"21-Jul",전북,장수군,236,12185,179,12600,"2021-07-01",2021
"21-Jul",전북,전주시 덕진구,346,172636,6954,179936,"2021-07-01",2021
"21-Jul",전북,전주시 완산구,758,152203,4142,157103,"2021-07-01",2021
"21-Jul",전북,정읍시,353,54767,3607,58727,"2021-07-01",2021
"21-Jul",전북,진안군,260,14090,233,14583,"2021-07-01",2021
"21-Jul",전북,계,5311,911402,38809,955522,"2021-07-01",2021
"21-Jul",전남,강진군,223,18653,1100,19976,"2021-07-01",2021
"21-Jul",전남,고흥군,305,32218,626,33149,"2021-07-01",2021
"21-Jul",전남,곡성군,160,14897,703,15760,"2021-07-01",2021
"21-Jul",전남,광양시,246,83614,5966,89826,"2021-07-01",2021
"21-Jul",전남,구례군,139,13166,735,14040,"2021-07-01",2021
"21-Jul",전남,나주시,470,65437,3149,69056,"2021-07-01",2021
"21-Jul",전남,담양군,229,27231,1594,29054,"2021-07-01",2021
"21-Jul",전남,목포시,416,94784,5462,100662,"2021-07-01",2021
"21-Jul",전남,무안군,566,48457,1074,50097,"2021-07-01",2021
"21-Jul",전남,보성군,218,21678,15680,37576,"2021-07-01",2021
"21-Jul",전남,순천시,494,141341,5215,147050,"2021-07-01",2021
"21-Jul",전남,신안군,318,21461,68055,89834,"2021-07-01",2021
"21-Jul",전남,여수시,528,131851,7200,139579,"2021-07-01",2021
"21-Jul",전남,영광군,208,27863,759,28830,"2021-07-01",2021
"21-Jul",전남,영암군,262,33553,3140,36955,"2021-07-01",2021
"21-Jul",전남,완도군,283,25479,547,26309,"2021-07-01",2021
"21-Jul",전남,장성군,198,26613,1245,28056,"2021-07-01",2021
"21-Jul",전남,장흥군,257,20042,440,20739,"2021-07-01",2021
"21-Jul",전남,진도군,166,17015,294,17475,"2021-07-01",2021
"21-Jul",전남,함평군,203,18103,32593,50899,"2021-07-01",2021
"21-Jul",전남,해남군,331,39532,24007,63870,"2021-07-01",2021
"21-Jul",전남,화순군,228,32709,2155,35092,"2021-07-01",2021
"21-Jul",전남,계,6448,955697,181739,1143884,"2021-07-01",2021
"21-Jul",경북,경산시,326,139008,4520,143854,"2021-07-01",2021
"21-Jul",경북,경주시,591,141733,4584,146908,"2021-07-01",2021
"21-Jul",경북,고령군,167,20440,676,21283,"2021-07-01",2021
"21-Jul",경북,구미시,554,213873,7287,221714,"2021-07-01",2021
"21-Jul",경북,군위군,128,14833,299,15260,"2021-07-01",2021
"21-Jul",경북,김천시,390,74568,1942,76900,"2021-07-01",2021
"21-Jul",경북,문경시,277,36927,845,38049,"2021-07-01",2021
"21-Jul",경북,봉화군,200,18026,201,18427,"2021-07-01",2021
"21-Jul",경북,상주시,391,53116,1846,55353,"2021-07-01",2021
"21-Jul",경북,성주군,201,30726,1296,32223,"2021-07-01",2021
"21-Jul",경북,안동시,739,82670,2701,86110,"2021-07-01",2021
"21-Jul",경북,영덕군,251,18976,313,19540,"2021-07-01",2021
"21-Jul",경북,영양군,140,9749,114,10003,"2021-07-01",2021
"21-Jul",경북,영주시,372,55566,1522,57460,"2021-07-01",2021
"21-Jul",경북,영천시,332,59961,2594,62887,"2021-07-01",2021
"21-Jul",경북,예천군,268,30248,491,31007,"2021-07-01",2021
"21-Jul",경북,울릉군,159,5206,589,5954,"2021-07-01",2021
"21-Jul",경북,울진군,315,26357,362,27034,"2021-07-01",2021
"21-Jul",경북,의성군,313,30909,1108,32330,"2021-07-01",2021
"21-Jul",경북,청도군,223,24927,774,25924,"2021-07-01",2021
"21-Jul",경북,청송군,198,15711,201,16110,"2021-07-01",2021
"21-Jul",경북,칠곡군,307,68466,2376,71149,"2021-07-01",2021
"21-Jul",경북,포항시 남구,460,121776,8353,130589,"2021-07-01",2021
"21-Jul",경북,포항시 북구,331,140491,3747,144569,"2021-07-01",2021
"21-Jul",경북,계,7633,1434263,48741,1490637,"2021-07-01",2021
"21-Jul",경남,거제시,366,106309,2114,108789,"2021-07-01",2021
"21-Jul",경남,거창군,274,32532,789,33595,"2021-07-01",2021
"21-Jul",경남,고성군,224,26505,578,27307,"2021-07-01",2021
"21-Jul",경남,김해시,660,276123,7335,284118,"2021-07-01",2021
"21-Jul",경남,남해군,277,19929,450,20656,"2021-07-01",2021
"21-Jul",경남,밀양시,331,56208,3901,60440,"2021-07-01",2021
"21-Jul",경남,사천시,318,56550,1531,58399,"2021-07-01",2021
"21-Jul",경남,산청군,242,20246,781,21269,"2021-07-01",2021
"21-Jul",경남,양산시,416,167091,10233,177740,"2021-07-01",2021
"21-Jul",경남,의령군,203,14619,767,15589,"2021-07-01",2021
"21-Jul",경남,진주시,643,165970,6301,172914,"2021-07-01",2021
"21-Jul",경남,창녕군,240,35595,723,36558,"2021-07-01",2021
"21-Jul",경남,창원시 마산합포구,331,96262,2885,99478,"2021-07-01",2021
"21-Jul",경남,창원시 마산회원구,178,95954,4837,100969,"2021-07-01",2021
"21-Jul",경남,창원시 성산구,647,147125,50012,197784,"2021-07-01",2021
"21-Jul",경남,창원시 의창구,425,116492,3524,120441,"2021-07-01",2021
"21-Jul",경남,창원시 진해구,214,92418,1813,94445,"2021-07-01",2021
"21-Jul",경남,통영시,318,52462,1403,54183,"2021-07-01",2021
"21-Jul",경남,하동군,220,24026,391,24637,"2021-07-01",2021
"21-Jul",경남,함안군,199,43205,21346,64750,"2021-07-01",2021
"21-Jul",경남,함양군,215,19562,440,20217,"2021-07-01",2021
"21-Jul",경남,합천군,275,23409,620,24304,"2021-07-01",2021
"21-Jul",경남,계,7216,1688592,122774,1818582,"2021-07-01",2021
"21-Jul",제주,서귀포시,797,104171,1982,106950,"2021-07-01",2021
"21-Jul",제주,제주시,1623,285309,249294,536226,"2021-07-01",2021
"21-Jul",제주,계,2420,389480,251276,643176,"2021-07-01",2021
"21-Aug",서울,강남구,397,217408,18901,236706,"2021-08-01",2021
"21-Aug",서울,강동구,299,143632,8644,152575,"2021-08-01",2021
"21-Aug",서울,강북구,317,71013,4242,75572,"2021-08-01",2021
"21-Aug",서울,강서구,340,186074,18521,204935,"2021-08-01",2021
"21-Aug",서울,관악구,306,112954,5587,118847,"2021-08-01",2021
"21-Aug",서울,광진구,296,92859,5403,98558,"2021-08-01",2021
"21-Aug",서울,구로구,310,131949,11903,144162,"2021-08-01",2021
"21-Aug",서울,금천구,142,83431,6255,89828,"2021-08-01",2021
"21-Aug",서울,노원구,320,143201,8896,152417,"2021-08-01",2021
"21-Aug",서울,도봉구,281,88145,7244,95670,"2021-08-01",2021
"21-Aug",서울,동대문구,303,93154,4933,98390,"2021-08-01",2021
"21-Aug",서울,동작구,321,103112,2809,106242,"2021-08-01",2021
"21-Aug",서울,마포구,339,113463,7335,121137,"2021-08-01",2021
"21-Aug",서울,서대문구,474,83208,5789,89471,"2021-08-01",2021
"21-Aug",서울,서초구,519,167163,10784,178466,"2021-08-01",2021
"21-Aug",서울,성동구,345,93690,12979,107014,"2021-08-01",2021
"21-Aug",서울,성북구,301,115806,5182,121289,"2021-08-01",2021
"21-Aug",서울,송파구,390,232345,13339,246074,"2021-08-01",2021
"21-Aug",서울,양천구,317,142638,8556,151511,"2021-08-01",2021
"21-Aug",서울,영등포구,373,136991,8981,146345,"2021-08-01",2021
"21-Aug",서울,용산구,337,77088,2168,79593,"2021-08-01",2021
"21-Aug",서울,은평구,298,125440,6877,132615,"2021-08-01",2021
"21-Aug",서울,종로구,3758,44540,1979,50277,"2021-08-01",2021
"21-Aug",서울,중구,1232,53029,5498,59759,"2021-08-01",2021
"21-Aug",서울,중랑구,252,104633,9411,114296,"2021-08-01",2021
"21-Aug",서울,계,12567,2956966,202216,3171749,"2021-08-01",2021
"21-Aug",부산,강서구,315,80884,3816,85015,"2021-08-01",2021
"21-Aug",부산,금정구,274,80609,7554,88437,"2021-08-01",2021
"21-Aug",부산,기장군,257,80393,2617,83267,"2021-08-01",2021
"21-Aug",부산,남구,222,91188,9486,100896,"2021-08-01",2021
"21-Aug",부산,동구,184,50746,5061,55991,"2021-08-01",2021
"21-Aug",부산,동래구,171,92659,3702,96532,"2021-08-01",2021
"21-Aug",부산,부산진구,366,124188,20880,145434,"2021-08-01",2021
"21-Aug",부산,북구,235,102000,3614,105849,"2021-08-01",2021
"21-Aug",부산,사상구,285,83168,5787,89240,"2021-08-01",2021
"21-Aug",부산,사하구,269,106933,6388,113590,"2021-08-01",2021
"21-Aug",부산,서구,138,29200,1411,30749,"2021-08-01",2021
"21-Aug",부산,수영구,161,67049,37011,104221,"2021-08-01",2021
"21-Aug",부산,연제구,958,91071,11172,103201,"2021-08-01",2021
"21-Aug",부산,영도구,224,31211,1975,33410,"2021-08-01",2021
"21-Aug",부산,중구,304,29894,7020,37218,"2021-08-01",2021
"21-Aug",부산,해운대구,326,166282,14554,181162,"2021-08-01",2021
"21-Aug",부산,계,4689,1307475,142048,1454212,"2021-08-01",2021
"21-Aug",대구,남구,340,56071,1625,58036,"2021-08-01",2021
"21-Aug",대구,달서구,494,272083,14252,286829,"2021-08-01",2021
"21-Aug",대구,달성군,548,135751,5107,141406,"2021-08-01",2021
"21-Aug",대구,동구,353,154382,11280,166015,"2021-08-01",2021
"21-Aug",대구,북구,498,202292,7573,210363,"2021-08-01",2021
"21-Aug",대구,서구,252,68541,4111,72904,"2021-08-01",2021
"21-Aug",대구,수성구,596,208485,4963,214044,"2021-08-01",2021
"21-Aug",대구,중구,302,58688,2561,61551,"2021-08-01",2021
"21-Aug",대구,계,3383,1156293,51472,1211148,"2021-08-01",2021
"21-Aug",인천,강화군,357,35675,24779,60811,"2021-08-01",2021
"21-Aug",인천,계양구,289,120733,187413,308435,"2021-08-01",2021
"21-Aug",인천,남동구,879,259455,49170,309504,"2021-08-01",2021
"21-Aug",인천,동구,106,24853,2637,27596,"2021-08-01",2021
"21-Aug",인천,미추홀구,424,158737,9159,168320,"2021-08-01",2021
"21-Aug",인천,부평구,330,219959,27443,247732,"2021-08-01",2021
"21-Aug",인천,서구,448,242871,11293,254612,"2021-08-01",2021
"21-Aug",인천,연수구,420,198681,8534,207635,"2021-08-01",2021
"21-Aug",인천,옹진군,211,12210,231,12652,"2021-08-01",2021
"21-Aug",인천,중구,639,66277,12088,79004,"2021-08-01",2021
"21-Aug",인천,계,4103,1339451,332747,1676301,"2021-08-01",2021
"21-Aug",광주,광산구,514,196593,12581,209688,"2021-08-01",2021
"21-Aug",광주,남구,207,91076,2895,94178,"2021-08-01",2021
"21-Aug",광주,동구,233,43347,1304,44884,"2021-08-01",2021
"21-Aug",광주,북구,612,190116,8978,199706,"2021-08-01",2021
"21-Aug",광주,서구,669,140749,6352,147770,"2021-08-01",2021
"21-Aug",광주,계,2235,661881,32110,696226,"2021-08-01",2021
"21-Aug",대전,대덕구,234,85901,6815,92950,"2021-08-01",2021
"21-Aug",대전,동구,242,91369,4727,96338,"2021-08-01",2021
"21-Aug",대전,서구,800,206134,8091,215025,"2021-08-01",2021
"21-Aug",대전,유성구,366,178004,5047,183417,"2021-08-01",2021
"21-Aug",대전,중구,232,96214,5545,101991,"2021-08-01",2021
"21-Aug",대전,계,1874,657622,30225,689721,"2021-08-01",2021
"21-Aug",울산,남구,724,153683,7403,161810,"2021-08-01",2021
"21-Aug",울산,동구,190,61797,1078,63065,"2021-08-01",2021
"21-Aug",울산,북구,219,115392,3397,119008,"2021-08-01",2021
"21-Aug",울산,울주군,406,124413,7190,132009,"2021-08-01",2021
"21-Aug",울산,중구,312,100319,2500,103131,"2021-08-01",2021
"21-Aug",울산,계,1851,555604,21568,579023,"2021-08-01",2021
"21-Aug",세종,세종특별자치시,804,177277,3086,181167,"2021-08-01",2021
"21-Aug",세종,계,804,177277,3086,181167,"2021-08-01",2021
"21-Aug",경기,가평군,371,31299,594,32264,"2021-08-01",2021
"21-Aug",경기,고양시 덕양구,674,182878,3936,187488,"2021-08-01",2021
"21-Aug",경기,고양시 일산동구,275,125747,5529,131551,"2021-08-01",2021
"21-Aug",경기,고양시 일산서구,128,116534,4582,121244,"2021-08-01",2021
"21-Aug",경기,과천시,729,25827,615,27171,"2021-08-01",2021
"21-Aug",경기,광명시,308,100504,4423,105235,"2021-08-01",2021
"21-Aug",경기,광주시,382,194331,8452,203165,"2021-08-01",2021
"21-Aug",경기,구리시,258,70316,2758,73332,"2021-08-01",2021
"21-Aug",경기,군포시,297,98213,5148,103658,"2021-08-01",2021
"21-Aug",경기,김포시,529,227922,8026,236477,"2021-08-01",2021
"21-Aug",경기,남양주시,743,303948,8593,313284,"2021-08-01",2021
"21-Aug",경기,동두천시,208,38266,1451,39925,"2021-08-01",2021
"21-Aug",경기,부천시,706,295137,12472,308315,"2021-08-01",2021
"21-Aug",경기,성남시 분당구,370,186238,7000,193608,"2021-08-01",2021
"21-Aug",경기,성남시 수정구,353,76750,2563,79666,"2021-08-01",2021
"21-Aug",경기,성남시 중원구,349,71773,4101,76223,"2021-08-01",2021
"21-Aug",경기,수원시 권선구,486,191231,8973,200690,"2021-08-01",2021
"21-Aug",경기,수원시 영통구,226,147672,3120,151018,"2021-08-01",2021
"21-Aug",경기,수원시 장안구,465,100995,3842,105302,"2021-08-01",2021
"21-Aug",경기,수원시 팔달구,506,73218,2995,76719,"2021-08-01",2021
"21-Aug",경기,시흥시,461,251646,8137,260244,"2021-08-01",2021
"21-Aug",경기,안산시 단원구,550,156479,8204,165233,"2021-08-01",2021
"21-Aug",경기,안산시 상록구,175,144428,5016,149619,"2021-08-01",2021
"21-Aug",경기,안성시,397,105983,4633,111013,"2021-08-01",2021
"21-Aug",경기,안양시 동안구,400,117081,6523,124004,"2021-08-01",2021
"21-Aug",경기,안양시 만안구,154,84446,3880,88480,"2021-08-01",2021
"21-Aug",경기,양주시,397,110648,3295,114340,"2021-08-01",2021
"21-Aug",경기,양평군,569,61291,1815,63675,"2021-08-01",2021
"21-Aug",경기,여주시,459,63756,7266,71481,"2021-08-01",2021
"21-Aug",경기,연천군,311,23936,5222,29469,"2021-08-01",2021
"21-Aug",경기,오산시,213,108321,3793,112327,"2021-08-01",2021
"21-Aug",경기,용인시 기흥구,127,189826,6510,196463,"2021-08-01",2021
"21-Aug",경기,용인시 수지구,49,146188,2601,148838,"2021-08-01",2021
"21-Aug",경기,용인시 처인구,769,133386,7769,141924,"2021-08-01",2021
"21-Aug",경기,의왕시,299,65529,2920,68748,"2021-08-01",2021
"21-Aug",경기,의정부시,734,165260,5424,171418,"2021-08-01",2021
"21-Aug",경기,이천시,408,115113,6255,121776,"2021-08-01",2021
"21-Aug",경기,파주시,528,220454,10691,231673,"2021-08-01",2021
"21-Aug",경기,평택시,746,292117,12522,305385,"2021-08-01",2021
"21-Aug",경기,포천시,390,87279,10448,98117,"2021-08-01",2021
"21-Aug",경기,하남시,398,129002,3088,132488,"2021-08-01",2021
"21-Aug",경기,화성시,930,458624,12643,472197,"2021-08-01",2021
"21-Aug",경기,계,17827,5889592,237828,6145247,"2021-08-01",2021
"21-Aug",강원,강릉시,535,109129,4669,114333,"2021-08-01",2021
"21-Aug",강원,고성군,192,14746,225,15163,"2021-08-01",2021
"21-Aug",강원,동해시,307,45752,1456,47515,"2021-08-01",2021
"21-Aug",강원,삼척시,396,32264,763,33423,"2021-08-01",2021
"21-Aug",강원,속초시,302,38623,1389,40314,"2021-08-01",2021
"21-Aug",강원,양구군,199,12100,135,12434,"2021-08-01",2021
"21-Aug",강원,양양군,191,16122,292,16605,"2021-08-01",2021
"21-Aug",강원,영월군,329,21248,361,21938,"2021-08-01",2021
"21-Aug",강원,원주시,584,177029,5585,183198,"2021-08-01",2021
"21-Aug",강원,인제군,216,18824,300,19340,"2021-08-01",2021
"21-Aug",강원,정선군,334,20674,472,21480,"2021-08-01",2021
"21-Aug",강원,철원군,242,24195,320,24757,"2021-08-01",2021
"21-Aug",강원,춘천시,833,134100,6243,141176,"2021-08-01",2021
"21-Aug",강원,태백시,221,19908,759,20888,"2021-08-01",2021
"21-Aug",강원,평창군,292,25636,489,26417,"2021-08-01",2021
"21-Aug",강원,홍천군,426,39118,1019,40563,"2021-08-01",2021
"21-Aug",강원,화천군,226,13099,186,13511,"2021-08-01",2021
"21-Aug",강원,횡성군,254,26998,730,27982,"2021-08-01",2021
"21-Aug",강원,계,6079,789565,25393,821037,"2021-08-01",2021
"21-Aug",충북,괴산군,210,22878,404,23492,"2021-08-01",2021
"21-Aug",충북,단양군,224,15664,784,16672,"2021-08-01",2021
"21-Aug",충북,보은군,235,18155,1022,19412,"2021-08-01",2021
"21-Aug",충북,영동군,251,24922,404,25577,"2021-08-01",2021
"21-Aug",충북,옥천군,216,27445,1150,28811,"2021-08-01",2021
"21-Aug",충북,음성군,242,58631,1944,60817,"2021-08-01",2021
"21-Aug",충북,제천시,339,67435,3431,71205,"2021-08-01",2021
"21-Aug",충북,증평군,89,19272,747,20108,"2021-08-01",2021
"21-Aug",충북,진천군,214,50593,1289,52096,"2021-08-01",2021
"21-Aug",충북,청원군,1,19,0,20,"2021-08-01",2021
"21-Aug",충북,청주시 상당구,516,93076,2658,96250,"2021-08-01",2021
"21-Aug",충북,청주시 서원구,240,101942,4335,106517,"2021-08-01",2021
"21-Aug",충북,청주시 청원구,343,103513,4477,108333,"2021-08-01",2021
"21-Aug",충북,청주시 흥덕구,355,131397,7456,139208,"2021-08-01",2021
"21-Aug",충북,충주시,599,110444,7278,118321,"2021-08-01",2021
"21-Aug",충북,계,4074,845386,37379,886839,"2021-08-01",2021
"21-Aug",충남,계룡시,157,22516,546,23219,"2021-08-01",2021
"21-Aug",충남,공주시,577,54070,2527,57174,"2021-08-01",2021
"21-Aug",충남,금산군,195,28558,2147,30900,"2021-08-01",2021
"21-Aug",충남,논산시,415,60857,2370,63642,"2021-08-01",2021
"21-Aug",충남,당진시,394,96384,4011,100789,"2021-08-01",2021
"21-Aug",충남,보령시,407,52426,1350,54183,"2021-08-01",2021
"21-Aug",충남,부여군,297,34349,1207,35853,"2021-08-01",2021
"21-Aug",충남,서산시,413,96107,3564,100084,"2021-08-01",2021
"21-Aug",충남,서천군,236,27009,842,28087,"2021-08-01",2021
"21-Aug",충남,아산시,525,172203,6738,179466,"2021-08-01",2021
"21-Aug",충남,예산군,413,43276,1417,45106,"2021-08-01",2021
"21-Aug",충남,천안시 동남구,285,131446,5086,136817,"2021-08-01",2021
"21-Aug",충남,천안시 서북구,525,197686,5560,203771,"2021-08-01",2021
"21-Aug",충남,청양군,256,16876,831,17963,"2021-08-01",2021
"21-Aug",충남,태안군,311,34251,570,35132,"2021-08-01",2021
"21-Aug",충남,홍성군,419,53296,1436,55151,"2021-08-01",2021
"21-Aug",충남,계,5825,1121310,40202,1167337,"2021-08-01",2021
"21-Aug",전북,고창군,299,30547,583,31429,"2021-08-01",2021
"21-Aug",전북,군산시,541,131456,6416,138413,"2021-08-01",2021
"21-Aug",전북,김제시,285,45433,1928,47646,"2021-08-01",2021
"21-Aug",전북,남원시,407,41077,3943,45427,"2021-08-01",2021
"21-Aug",전북,무주군,194,12859,398,13451,"2021-08-01",2021
"21-Aug",전북,부안군,259,27440,620,28319,"2021-08-01",2021
"21-Aug",전북,순창군,229,14621,149,14999,"2021-08-01",2021
"21-Aug",전북,완주군,412,51856,3193,55461,"2021-08-01",2021
"21-Aug",전북,익산시,509,136499,5930,142938,"2021-08-01",2021
"21-Aug",전북,임실군,221,14242,429,14892,"2021-08-01",2021
"21-Aug",전북,장수군,237,12194,177,12608,"2021-08-01",2021
"21-Aug",전북,전주시 덕진구,344,172864,6963,180171,"2021-08-01",2021
"21-Aug",전북,전주시 완산구,758,152344,4143,157245,"2021-08-01",2021
"21-Aug",전북,정읍시,357,54919,3575,58851,"2021-08-01",2021
"21-Aug",전북,진안군,261,14082,234,14577,"2021-08-01",2021
"21-Aug",전북,계,5313,912433,38681,956427,"2021-08-01",2021
"21-Aug",전남,강진군,225,18658,1074,19957,"2021-08-01",2021
"21-Aug",전남,고흥군,304,32259,600,33163,"2021-08-01",2021
"21-Aug",전남,곡성군,162,14898,707,15767,"2021-08-01",2021
"21-Aug",전남,광양시,249,83852,5998,90099,"2021-08-01",2021
"21-Aug",전남,구례군,139,13134,728,14001,"2021-08-01",2021
"21-Aug",전남,나주시,469,65549,3138,69156,"2021-08-01",2021
"21-Aug",전남,담양군,229,27259,1600,29088,"2021-08-01",2021
"21-Aug",전남,목포시,405,94708,5468,100581,"2021-08-01",2021
"21-Aug",전남,무안군,567,48745,1067,50379,"2021-08-01",2021
"21-Aug",전남,보성군,217,21700,15015,36932,"2021-08-01",2021
"21-Aug",전남,순천시,497,141498,5254,147249,"2021-08-01",2021
"21-Aug",전남,신안군,322,21536,70087,91945,"2021-08-01",2021
"21-Aug",전남,여수시,531,131948,7225,139704,"2021-08-01",2021
"21-Aug",전남,영광군,206,27852,761,28819,"2021-08-01",2021
"21-Aug",전남,영암군,265,33512,2826,36603,"2021-08-01",2021
"21-Aug",전남,완도군,285,25452,545,26282,"2021-08-01",2021
"21-Aug",전남,장성군,198,26613,1256,28067,"2021-08-01",2021
"21-Aug",전남,장흥군,257,20070,440,20767,"2021-08-01",2021
"21-Aug",전남,진도군,165,17047,291,17503,"2021-08-01",2021
"21-Aug",전남,함평군,204,18148,32108,50460,"2021-08-01",2021
"21-Aug",전남,해남군,331,39632,25097,65060,"2021-08-01",2021
"21-Aug",전남,화순군,228,32912,2170,35310,"2021-08-01",2021
"21-Aug",전남,계,6455,956982,183455,1146892,"2021-08-01",2021
"21-Aug",경북,경산시,323,139147,4528,143998,"2021-08-01",2021
"21-Aug",경북,경주시,590,141894,4602,147086,"2021-08-01",2021
"21-Aug",경북,고령군,168,20450,681,21299,"2021-08-01",2021
"21-Aug",경북,구미시,551,213714,7277,221542,"2021-08-01",2021
"21-Aug",경북,군위군,128,14830,302,15260,"2021-08-01",2021
"21-Aug",경북,김천시,393,74715,1972,77080,"2021-08-01",2021
"21-Aug",경북,문경시,278,36960,840,38078,"2021-08-01",2021
"21-Aug",경북,봉화군,202,18031,201,18434,"2021-08-01",2021
"21-Aug",경북,상주시,392,53166,1854,55412,"2021-08-01",2021
"21-Aug",경북,성주군,201,30755,1292,32248,"2021-08-01",2021
"21-Aug",경북,안동시,742,82699,2720,86161,"2021-08-01",2021
"21-Aug",경북,영덕군,252,18975,311,19538,"2021-08-01",2021
"21-Aug",경북,영양군,140,9794,116,10050,"2021-08-01",2021
"21-Aug",경북,영주시,376,55474,1520,57370,"2021-08-01",2021
"21-Aug",경북,영천시,332,60104,2585,63021,"2021-08-01",2021
"21-Aug",경북,예천군,268,30334,490,31092,"2021-08-01",2021
"21-Aug",경북,울릉군,158,5200,588,5946,"2021-08-01",2021
"21-Aug",경북,울진군,313,26413,355,27081,"2021-08-01",2021
"21-Aug",경북,의성군,311,30895,1095,32301,"2021-08-01",2021
"21-Aug",경북,청도군,222,24932,773,25927,"2021-08-01",2021
"21-Aug",경북,청송군,200,15766,204,16170,"2021-08-01",2021
"21-Aug",경북,칠곡군,304,68600,2378,71282,"2021-08-01",2021
"21-Aug",경북,포항시 남구,460,121886,8345,130691,"2021-08-01",2021
"21-Aug",경북,포항시 북구,327,140734,3745,144806,"2021-08-01",2021
"21-Aug",경북,계,7631,1435468,48774,1491873,"2021-08-01",2021
"21-Aug",경남,거제시,366,106294,2119,108779,"2021-08-01",2021
"21-Aug",경남,거창군,270,32509,788,33567,"2021-08-01",2021
"21-Aug",경남,고성군,225,26482,573,27280,"2021-08-01",2021
"21-Aug",경남,김해시,661,276282,7338,284281,"2021-08-01",2021
"21-Aug",경남,남해군,271,19962,451,20684,"2021-08-01",2021
"21-Aug",경남,밀양시,332,56140,3900,60372,"2021-08-01",2021
"21-Aug",경남,사천시,312,56565,1525,58402,"2021-08-01",2021
"21-Aug",경남,산청군,244,20306,779,21329,"2021-08-01",2021
"21-Aug",경남,양산시,414,167262,10265,177941,"2021-08-01",2021
"21-Aug",경남,의령군,203,14635,766,15604,"2021-08-01",2021
"21-Aug",경남,진주시,642,166280,6309,173231,"2021-08-01",2021
"21-Aug",경남,창녕군,239,35586,728,36553,"2021-08-01",2021
"21-Aug",경남,창원시 마산합포구,331,96009,2873,99213,"2021-08-01",2021
"21-Aug",경남,창원시 마산회원구,178,96053,4885,101116,"2021-08-01",2021
"21-Aug",경남,창원시 성산구,646,147654,50219,198519,"2021-08-01",2021
"21-Aug",경남,창원시 의창구,425,116453,3531,120409,"2021-08-01",2021
"21-Aug",경남,창원시 진해구,214,92655,1837,94706,"2021-08-01",2021
"21-Aug",경남,통영시,317,52416,1400,54133,"2021-08-01",2021
"21-Aug",경남,하동군,222,24068,390,24680,"2021-08-01",2021
"21-Aug",경남,함안군,191,43124,21317,64632,"2021-08-01",2021
"21-Aug",경남,함양군,215,19602,436,20253,"2021-08-01",2021
"21-Aug",경남,합천군,279,23383,621,24283,"2021-08-01",2021
"21-Aug",경남,계,7197,1689720,123050,1819967,"2021-08-01",2021
"21-Aug",제주,서귀포시,793,104417,1983,107193,"2021-08-01",2021
"21-Aug",제주,제주시,1624,286298,250852,538774,"2021-08-01",2021
"21-Aug",제주,계,2417,390715,252835,645967,"2021-08-01",2021
"21-Sep",서울,강남구,398,217857,19242,237497,"2021-09-01",2021
"21-Sep",서울,강동구,299,143624,8589,152512,"2021-09-01",2021
"21-Sep",서울,강북구,317,70979,4239,75535,"2021-09-01",2021
"21-Sep",서울,강서구,340,186052,18474,204866,"2021-09-01",2021
"21-Sep",서울,관악구,305,112820,5597,118722,"2021-09-01",2021
"21-Sep",서울,광진구,300,92873,5253,98426,"2021-09-01",2021
"21-Sep",서울,구로구,310,131901,12362,144573,"2021-09-01",2021
"21-Sep",서울,금천구,141,83483,6264,89888,"2021-09-01",2021
"21-Sep",서울,노원구,318,142999,8890,152207,"2021-09-01",2021
"21-Sep",서울,도봉구,280,88150,7253,95683,"2021-09-01",2021
"21-Sep",서울,동대문구,302,93124,4952,98378,"2021-09-01",2021
"21-Sep",서울,동작구,321,103069,2813,106203,"2021-09-01",2021
"21-Sep",서울,마포구,339,113577,7265,121181,"2021-09-01",2021
"21-Sep",서울,서대문구,452,83238,5804,89494,"2021-09-01",2021
"21-Sep",서울,서초구,521,166958,10855,178334,"2021-09-01",2021
"21-Sep",서울,성동구,345,93595,13089,107029,"2021-09-01",2021
"21-Sep",서울,성북구,297,115845,5179,121321,"2021-09-01",2021
"21-Sep",서울,송파구,390,232655,13397,246442,"2021-09-01",2021
"21-Sep",서울,양천구,318,142674,8571,151563,"2021-09-01",2021
"21-Sep",서울,영등포구,373,136939,8969,146281,"2021-09-01",2021
"21-Sep",서울,용산구,339,76953,2177,79469,"2021-09-01",2021
"21-Sep",서울,은평구,298,125473,6872,132643,"2021-09-01",2021
"21-Sep",서울,종로구,3752,44579,1973,50304,"2021-09-01",2021
"21-Sep",서울,중구,1250,55571,5448,62269,"2021-09-01",2021
"21-Sep",서울,중랑구,251,104642,9429,114322,"2021-09-01",2021
"21-Sep",서울,계,12556,2959630,202956,3175142,"2021-09-01",2021
"21-Sep",부산,강서구,311,81170,3826,85307,"2021-09-01",2021
"21-Sep",부산,금정구,270,80616,7433,88319,"2021-09-01",2021
"21-Sep",부산,기장군,258,80557,2616,83431,"2021-09-01",2021
"21-Sep",부산,남구,218,91056,9434,100708,"2021-09-01",2021
"21-Sep",부산,동구,180,51237,5096,56513,"2021-09-01",2021
"21-Sep",부산,동래구,169,92683,3693,96545,"2021-09-01",2021
"21-Sep",부산,부산진구,365,121615,21029,143009,"2021-09-01",2021
"21-Sep",부산,북구,229,102148,3630,106007,"2021-09-01",2021
"21-Sep",부산,사상구,283,83134,5793,89210,"2021-09-01",2021
"21-Sep",부산,사하구,265,107108,6349,113722,"2021-09-01",2021
"21-Sep",부산,서구,136,29180,1392,30708,"2021-09-01",2021
"21-Sep",부산,수영구,160,67013,37428,104601,"2021-09-01",2021
"21-Sep",부산,연제구,946,91577,11448,103971,"2021-09-01",2021
"21-Sep",부산,영도구,224,31251,1971,33446,"2021-09-01",2021
"21-Sep",부산,중구,303,30071,7016,37390,"2021-09-01",2021
"21-Sep",부산,해운대구,324,166450,14946,181720,"2021-09-01",2021
"21-Sep",부산,계,4641,1306866,143100,1454607,"2021-09-01",2021
"21-Sep",대구,남구,340,55933,1619,57892,"2021-09-01",2021
"21-Sep",대구,달서구,492,271825,14459,286776,"2021-09-01",2021
"21-Sep",대구,달성군,547,136049,5168,141764,"2021-09-01",2021
"21-Sep",대구,동구,351,154120,11210,165681,"2021-09-01",2021
"21-Sep",대구,북구,497,202287,7584,210368,"2021-09-01",2021
"21-Sep",대구,서구,250,68203,4061,72514,"2021-09-01",2021
"21-Sep",대구,수성구,586,208724,4927,214237,"2021-09-01",2021
"21-Sep",대구,중구,313,58395,2568,61276,"2021-09-01",2021
"21-Sep",대구,계,3376,1155536,51596,1210508,"2021-09-01",2021
"21-Sep",인천,강화군,357,35770,18159,54286,"2021-09-01",2021
"21-Sep",인천,계양구,289,120512,185320,306121,"2021-09-01",2021
"21-Sep",인천,남동구,858,258490,48715,308063,"2021-09-01",2021
"21-Sep",인천,동구,104,24825,2657,27586,"2021-09-01",2021
"21-Sep",인천,미추홀구,425,159283,9042,168750,"2021-09-01",2021
"21-Sep",인천,부평구,330,220258,28004,248592,"2021-09-01",2021
"21-Sep",인천,서구,450,244512,11359,256321,"2021-09-01",2021
"21-Sep",인천,연수구,421,199019,8550,207990,"2021-09-01",2021
"21-Sep",인천,옹진군,212,12238,231,12681,"2021-09-01",2021
"21-Sep",인천,중구,633,66671,12223,79527,"2021-09-01",2021
"21-Sep",인천,계,4079,1341578,324260,1669917,"2021-09-01",2021
"21-Sep",광주,광산구,519,196972,12648,210139,"2021-09-01",2021
"21-Sep",광주,남구,206,91381,2874,94461,"2021-09-01",2021
"21-Sep",광주,동구,230,43456,1306,44992,"2021-09-01",2021
"21-Sep",광주,북구,601,190405,8979,199985,"2021-09-01",2021
"21-Sep",광주,서구,679,140981,6416,148076,"2021-09-01",2021
"21-Sep",광주,계,2235,663195,32223,697653,"2021-09-01",2021
"21-Sep",대전,대덕구,235,85907,6834,92976,"2021-09-01",2021
"21-Sep",대전,동구,242,91492,4753,96487,"2021-09-01",2021
"21-Sep",대전,서구,804,206506,8146,215456,"2021-09-01",2021
"21-Sep",대전,유성구,365,178335,5061,183761,"2021-09-01",2021
"21-Sep",대전,중구,231,96231,5536,101998,"2021-09-01",2021
"21-Sep",대전,계,1877,658471,30330,690678,"2021-09-01",2021
"21-Sep",울산,남구,724,153767,7482,161973,"2021-09-01",2021
"21-Sep",울산,동구,189,61851,1075,63115,"2021-09-01",2021
"21-Sep",울산,북구,218,115423,3414,119055,"2021-09-01",2021
"21-Sep",울산,울주군,412,124585,7123,132120,"2021-09-01",2021
"21-Sep",울산,중구,310,100293,2506,103109,"2021-09-01",2021
"21-Sep",울산,계,1853,555919,21600,579372,"2021-09-01",2021
"21-Sep",세종,세종특별자치시,801,177892,3102,181795,"2021-09-01",2021
"21-Sep",세종,계,801,177892,3102,181795,"2021-09-01",2021
"21-Sep",경기,가평군,376,31368,595,32339,"2021-09-01",2021
"21-Sep",경기,고양시 덕양구,667,183214,3971,187852,"2021-09-01",2021
"21-Sep",경기,고양시 일산동구,275,125994,5473,131742,"2021-09-01",2021
"21-Sep",경기,고양시 일산서구,127,116514,4585,121226,"2021-09-01",2021
"21-Sep",경기,과천시,730,25844,617,27191,"2021-09-01",2021
"21-Sep",경기,광명시,302,100532,4441,105275,"2021-09-01",2021
"21-Sep",경기,광주시,382,194866,8481,203729,"2021-09-01",2021
"21-Sep",경기,구리시,258,70361,2766,73385,"2021-09-01",2021
"21-Sep",경기,군포시,298,98255,5175,103728,"2021-09-01",2021
"21-Sep",경기,김포시,526,228322,8030,236878,"2021-09-01",2021
"21-Sep",경기,남양주시,744,304960,8602,314306,"2021-09-01",2021
"21-Sep",경기,동두천시,208,38341,1451,40000,"2021-09-01",2021
"21-Sep",경기,부천시,702,295392,12455,308549,"2021-09-01",2021
"21-Sep",경기,성남시 분당구,370,186739,6980,194089,"2021-09-01",2021
"21-Sep",경기,성남시 수정구,354,76719,2632,79705,"2021-09-01",2021
"21-Sep",경기,성남시 중원구,348,71711,4040,76099,"2021-09-01",2021
"21-Sep",경기,수원시 권선구,479,191482,8965,200926,"2021-09-01",2021
"21-Sep",경기,수원시 영통구,224,147574,3113,150911,"2021-09-01",2021
"21-Sep",경기,수원시 장안구,464,102213,3859,106536,"2021-09-01",2021
"21-Sep",경기,수원시 팔달구,510,73232,3004,76746,"2021-09-01",2021
"21-Sep",경기,시흥시,461,252101,8175,260737,"2021-09-01",2021
"21-Sep",경기,안산시 단원구,549,156902,8120,165571,"2021-09-01",2021
"21-Sep",경기,안산시 상록구,174,144353,5023,149550,"2021-09-01",2021
"21-Sep",경기,안성시,400,106851,4638,111889,"2021-09-01",2021
"21-Sep",경기,안양시 동안구,401,116857,6491,123749,"2021-09-01",2021
"21-Sep",경기,안양시 만안구,153,84581,3888,88622,"2021-09-01",2021
"21-Sep",경기,양주시,397,111015,3318,114730,"2021-09-01",2021
"21-Sep",경기,양평군,582,61406,1845,63833,"2021-09-01",2021
"21-Sep",경기,여주시,459,63872,7257,71588,"2021-09-01",2021
"21-Sep",경기,연천군,315,23891,5263,29469,"2021-09-01",2021
"21-Sep",경기,오산시,214,108215,3784,112213,"2021-09-01",2021
"21-Sep",경기,용인시 기흥구,127,190207,6450,196784,"2021-09-01",2021
"21-Sep",경기,용인시 수지구,49,146193,2570,148812,"2021-09-01",2021
"21-Sep",경기,용인시 처인구,772,133643,7801,142216,"2021-09-01",2021
"21-Sep",경기,의왕시,300,65722,2925,68947,"2021-09-01",2021
"21-Sep",경기,의정부시,731,165520,5483,171734,"2021-09-01",2021
"21-Sep",경기,이천시,409,115630,6267,122306,"2021-09-01",2021
"21-Sep",경기,파주시,525,221466,10737,232728,"2021-09-01",2021
"21-Sep",경기,평택시,740,294033,12597,307370,"2021-09-01",2021
"21-Sep",경기,포천시,390,87402,10346,98138,"2021-09-01",2021
"21-Sep",경기,하남시,398,129859,3098,133355,"2021-09-01",2021
"21-Sep",경기,화성시,935,460516,12667,474118,"2021-09-01",2021
"21-Sep",경기,계,17825,5903868,237978,6159671,"2021-09-01",2021
"21-Sep",강원,강릉시,533,109341,4656,114530,"2021-09-01",2021
"21-Sep",강원,고성군,193,14792,224,15209,"2021-09-01",2021
"21-Sep",강원,동해시,310,45847,1458,47615,"2021-09-01",2021
"21-Sep",강원,삼척시,396,32318,758,33472,"2021-09-01",2021
"21-Sep",강원,속초시,305,38682,1419,40406,"2021-09-01",2021
"21-Sep",강원,양구군,199,12092,136,12427,"2021-09-01",2021
"21-Sep",강원,양양군,191,16140,288,16619,"2021-09-01",2021
"21-Sep",강원,영월군,330,21322,363,22015,"2021-09-01",2021
"21-Sep",강원,원주시,586,177478,5562,183626,"2021-09-01",2021
"21-Sep",강원,인제군,216,18846,300,19362,"2021-09-01",2021
"21-Sep",강원,정선군,335,20671,474,21480,"2021-09-01",2021
"21-Sep",강원,철원군,243,24214,322,24779,"2021-09-01",2021
"21-Sep",강원,춘천시,832,134531,6296,141659,"2021-09-01",2021
"21-Sep",강원,태백시,222,19881,762,20865,"2021-09-01",2021
"21-Sep",강원,평창군,292,25667,491,26450,"2021-09-01",2021
"21-Sep",강원,홍천군,428,39162,1026,40616,"2021-09-01",2021
"21-Sep",강원,화천군,226,13138,185,13549,"2021-09-01",2021
"21-Sep",강원,횡성군,254,27041,727,28022,"2021-09-01",2021
"21-Sep",강원,계,6091,791163,25447,822701,"2021-09-01",2021
"21-Sep",충북,괴산군,210,22862,407,23479,"2021-09-01",2021
"21-Sep",충북,단양군,224,15662,784,16670,"2021-09-01",2021
"21-Sep",충북,보은군,237,18126,1027,19390,"2021-09-01",2021
"21-Sep",충북,영동군,251,24916,404,25571,"2021-09-01",2021
"21-Sep",충북,옥천군,213,27458,1151,28822,"2021-09-01",2021
"21-Sep",충북,음성군,256,58762,1943,60961,"2021-09-01",2021
"21-Sep",충북,제천시,338,67434,3443,71215,"2021-09-01",2021
"21-Sep",충북,증평군,89,19262,750,20101,"2021-09-01",2021
"21-Sep",충북,진천군,215,50778,1295,52288,"2021-09-01",2021
"21-Sep",충북,청원군,1,19,0,20,"2021-09-01",2021
"21-Sep",충북,청주시 상당구,518,93283,2660,96461,"2021-09-01",2021
"21-Sep",충북,청주시 서원구,240,101916,4324,106480,"2021-09-01",2021
"21-Sep",충북,청주시 청원구,344,103779,4492,108615,"2021-09-01",2021
"21-Sep",충북,청주시 흥덕구,356,131765,7445,139566,"2021-09-01",2021
"21-Sep",충북,충주시,597,110777,7302,118676,"2021-09-01",2021
"21-Sep",충북,계,4089,846799,37427,888315,"2021-09-01",2021
"21-Sep",충남,계룡시,157,22553,550,23260,"2021-09-01",2021
"21-Sep",충남,공주시,577,54155,2544,57276,"2021-09-01",2021
"21-Sep",충남,금산군,195,28547,2152,30894,"2021-09-01",2021
"21-Sep",충남,논산시,415,61033,2374,63822,"2021-09-01",2021
"21-Sep",충남,당진시,398,96643,4017,101058,"2021-09-01",2021
"21-Sep",충남,보령시,408,52506,1351,54265,"2021-09-01",2021
"21-Sep",충남,부여군,299,34311,1201,35811,"2021-09-01",2021
"21-Sep",충남,서산시,421,96322,3599,100342,"2021-09-01",2021
"21-Sep",충남,서천군,235,27014,834,28083,"2021-09-01",2021
"21-Sep",충남,아산시,527,172833,6724,180084,"2021-09-01",2021
"21-Sep",충남,예산군,414,43217,1423,45054,"2021-09-01",2021
"21-Sep",충남,천안시 동남구,287,131550,5077,136914,"2021-09-01",2021
"21-Sep",충남,천안시 서북구,527,198077,5568,204172,"2021-09-01",2021
"21-Sep",충남,청양군,259,16874,825,17958,"2021-09-01",2021
"21-Sep",충남,태안군,313,34259,580,35152,"2021-09-01",2021
"21-Sep",충남,홍성군,421,53367,1433,55221,"2021-09-01",2021
"21-Sep",충남,계,5853,1123261,40252,1169366,"2021-09-01",2021
"21-Sep",전북,고창군,302,30560,586,31448,"2021-09-01",2021
"21-Sep",전북,군산시,541,131596,6401,138538,"2021-09-01",2021
"21-Sep",전북,김제시,286,45517,1934,47737,"2021-09-01",2021
"21-Sep",전북,남원시,409,41068,3854,45331,"2021-09-01",2021
"21-Sep",전북,무주군,193,12881,397,13471,"2021-09-01",2021
"21-Sep",전북,부안군,259,27401,610,28270,"2021-09-01",2021
"21-Sep",전북,순창군,228,14642,149,15019,"2021-09-01",2021
"21-Sep",전북,완주군,411,51936,3171,55518,"2021-09-01",2021
"21-Sep",전북,익산시,510,136581,5898,142989,"2021-09-01",2021
"21-Sep",전북,임실군,218,14216,430,14864,"2021-09-01",2021
"21-Sep",전북,장수군,237,12184,177,12598,"2021-09-01",2021
"21-Sep",전북,전주시 덕진구,344,173132,6952,180428,"2021-09-01",2021
"21-Sep",전북,전주시 완산구,755,152442,4155,157352,"2021-09-01",2021
"21-Sep",전북,정읍시,352,54871,3552,58775,"2021-09-01",2021
"21-Sep",전북,진안군,258,14076,238,14572,"2021-09-01",2021
"21-Sep",전북,계,5303,913103,38504,956910,"2021-09-01",2021
"21-Sep",전남,강진군,224,18654,1074,19952,"2021-09-01",2021
"21-Sep",전남,고흥군,304,32253,593,33150,"2021-09-01",2021
"21-Sep",전남,곡성군,163,14878,724,15765,"2021-09-01",2021
"21-Sep",전남,광양시,249,83820,6019,90088,"2021-09-01",2021
"21-Sep",전남,구례군,139,13155,711,14005,"2021-09-01",2021
"21-Sep",전남,나주시,473,65659,3132,69264,"2021-09-01",2021
"21-Sep",전남,담양군,230,27352,1596,29178,"2021-09-01",2021
"21-Sep",전남,목포시,406,94545,5476,100427,"2021-09-01",2021
"21-Sep",전남,무안군,558,49158,1074,50790,"2021-09-01",2021
"21-Sep",전남,보성군,218,21729,14169,36116,"2021-09-01",2021
"21-Sep",전남,순천시,498,141818,5256,147572,"2021-09-01",2021
"21-Sep",전남,신안군,322,21537,77032,98891,"2021-09-01",2021
"21-Sep",전남,여수시,534,132085,7216,139835,"2021-09-01",2021
"21-Sep",전남,영광군,205,27889,760,28854,"2021-09-01",2021
"21-Sep",전남,영암군,272,33446,2710,36428,"2021-09-01",2021
"21-Sep",전남,완도군,283,25469,544,26296,"2021-09-01",2021
"21-Sep",전남,장성군,199,26648,1240,28087,"2021-09-01",2021
"21-Sep",전남,장흥군,259,20071,441,20771,"2021-09-01",2021
"21-Sep",전남,진도군,165,17057,288,17510,"2021-09-01",2021
"21-Sep",전남,함평군,204,18181,31929,50314,"2021-09-01",2021
"21-Sep",전남,해남군,331,39606,28430,68367,"2021-09-01",2021
"21-Sep",전남,화순군,228,33066,2143,35437,"2021-09-01",2021
"21-Sep",전남,계,6464,958076,192557,1157097,"2021-09-01",2021
"21-Sep",경북,경산시,322,139442,4513,144277,"2021-09-01",2021
"21-Sep",경북,경주시,589,142185,4608,147382,"2021-09-01",2021
"21-Sep",경북,고령군,167,20425,682,21274,"2021-09-01",2021
"21-Sep",경북,구미시,550,213716,7304,221570,"2021-09-01",2021
"21-Sep",경북,군위군,126,14847,305,15278,"2021-09-01",2021
"21-Sep",경북,김천시,397,74928,1967,77292,"2021-09-01",2021
"21-Sep",경북,문경시,278,37045,837,38160,"2021-09-01",2021
"21-Sep",경북,봉화군,202,18036,202,18440,"2021-09-01",2021
"21-Sep",경북,상주시,393,53177,1860,55430,"2021-09-01",2021
"21-Sep",경북,성주군,200,30729,1289,32218,"2021-09-01",2021
"21-Sep",경북,안동시,739,82757,2712,86208,"2021-09-01",2021
"21-Sep",경북,영덕군,252,18983,308,19543,"2021-09-01",2021
"21-Sep",경북,영양군,142,9805,116,10063,"2021-09-01",2021
"21-Sep",경북,영주시,374,55603,1513,57490,"2021-09-01",2021
"21-Sep",경북,영천시,336,60036,2579,62951,"2021-09-01",2021
"21-Sep",경북,예천군,269,30397,492,31158,"2021-09-01",2021
"21-Sep",경북,울릉군,160,5208,586,5954,"2021-09-01",2021
"21-Sep",경북,울진군,311,26351,356,27018,"2021-09-01",2021
"21-Sep",경북,의성군,314,30920,1087,32321,"2021-09-01",2021
"21-Sep",경북,청도군,222,24966,788,25976,"2021-09-01",2021
"21-Sep",경북,청송군,197,15794,205,16196,"2021-09-01",2021
"21-Sep",경북,칠곡군,302,68713,2385,71400,"2021-09-01",2021
"21-Sep",경북,포항시 남구,460,121951,8348,130759,"2021-09-01",2021
"21-Sep",경북,포항시 북구,328,140895,3715,144938,"2021-09-01",2021
"21-Sep",경북,계,7630,1436909,48757,1493296,"2021-09-01",2021
"21-Sep",경남,거제시,367,106388,2119,108874,"2021-09-01",2021
"21-Sep",경남,거창군,270,32536,783,33589,"2021-09-01",2021
"21-Sep",경남,고성군,224,26487,567,27278,"2021-09-01",2021
"21-Sep",경남,김해시,665,276329,7333,284327,"2021-09-01",2021
"21-Sep",경남,남해군,272,19998,450,20720,"2021-09-01",2021
"21-Sep",경남,밀양시,333,56131,3926,60390,"2021-09-01",2021
"21-Sep",경남,사천시,315,56639,1528,58482,"2021-09-01",2021
"21-Sep",경남,산청군,246,20336,776,21358,"2021-09-01",2021
"21-Sep",경남,양산시,414,167727,10330,178471,"2021-09-01",2021
"21-Sep",경남,의령군,201,14644,771,15616,"2021-09-01",2021
"21-Sep",경남,진주시,642,166556,6284,173482,"2021-09-01",2021
"21-Sep",경남,창녕군,227,35630,727,36584,"2021-09-01",2021
"21-Sep",경남,창원시 마산합포구,331,95754,2878,98963,"2021-09-01",2021
"21-Sep",경남,창원시 마산회원구,177,96200,4920,101297,"2021-09-01",2021
"21-Sep",경남,창원시 성산구,644,148186,50568,199398,"2021-09-01",2021
"21-Sep",경남,창원시 의창구,425,116373,3515,120313,"2021-09-01",2021
"21-Sep",경남,창원시 진해구,215,92970,1851,95036,"2021-09-01",2021
"21-Sep",경남,통영시,315,52424,1411,54150,"2021-09-01",2021
"21-Sep",경남,하동군,221,24006,388,24615,"2021-09-01",2021
"21-Sep",경남,함안군,191,43076,21360,64627,"2021-09-01",2021
"21-Sep",경남,함양군,215,19625,425,20265,"2021-09-01",2021
"21-Sep",경남,합천군,277,23423,619,24319,"2021-09-01",2021
"21-Sep",경남,계,7187,1691438,123529,1822154,"2021-09-01",2021
"21-Sep",제주,서귀포시,793,104600,1981,107374,"2021-09-01",2021
"21-Sep",제주,제주시,1630,287224,252594,541448,"2021-09-01",2021
"21-Sep",제주,계,2423,391824,254575,648822,"2021-09-01",2021
"21-Oct",서울,강남구,395,218385,19464,238244,"2021-10-01",2021
"21-Oct",서울,강동구,301,143479,8592,152372,"2021-10-01",2021
"21-Oct",서울,강북구,313,70837,4239,75389,"2021-10-01",2021
"21-Oct",서울,강서구,341,185760,18184,204285,"2021-10-01",2021
"21-Oct",서울,관악구,305,112644,5580,118529,"2021-10-01",2021
"21-Oct",서울,광진구,306,92812,5246,98364,"2021-10-01",2021
"21-Oct",서울,구로구,312,131917,12975,145204,"2021-10-01",2021
"21-Oct",서울,금천구,142,83457,6292,89891,"2021-10-01",2021
"21-Oct",서울,노원구,316,142964,8865,152145,"2021-10-01",2021
"21-Oct",서울,도봉구,279,88177,7289,95745,"2021-10-01",2021
"21-Oct",서울,동대문구,305,93135,4987,98427,"2021-10-01",2021
"21-Oct",서울,동작구,324,103037,2795,106156,"2021-10-01",2021
"21-Oct",서울,마포구,340,113621,7263,121224,"2021-10-01",2021
"21-Oct",서울,서대문구,452,83218,5781,89451,"2021-10-01",2021
"21-Oct",서울,서초구,526,166640,10762,177928,"2021-10-01",2021
"21-Oct",서울,성동구,341,93446,12561,106348,"2021-10-01",2021
"21-Oct",서울,성북구,295,115788,5180,121263,"2021-10-01",2021
"21-Oct",서울,송파구,390,232807,13450,246647,"2021-10-01",2021
"21-Oct",서울,양천구,322,142453,8542,151317,"2021-10-01",2021
"21-Oct",서울,영등포구,374,136920,8894,146188,"2021-10-01",2021
"21-Oct",서울,용산구,339,77103,2177,79619,"2021-10-01",2021
"21-Oct",서울,은평구,302,125549,6861,132712,"2021-10-01",2021
"21-Oct",서울,종로구,3722,44586,1950,50258,"2021-10-01",2021
"21-Oct",서울,중구,1250,55296,5384,61930,"2021-10-01",2021
"21-Oct",서울,중랑구,254,104685,9386,114325,"2021-10-01",2021
"21-Oct",서울,계,12546,2958716,202699,3173961,"2021-10-01",2021
"21-Oct",부산,강서구,312,81469,3839,85620,"2021-10-01",2021
"21-Oct",부산,금정구,274,80663,7410,88347,"2021-10-01",2021
"21-Oct",부산,기장군,257,80739,2630,83626,"2021-10-01",2021
"21-Oct",부산,남구,220,91306,9321,100847,"2021-10-01",2021
"21-Oct",부산,동구,180,51724,5105,57009,"2021-10-01",2021
"21-Oct",부산,동래구,169,92636,3635,96440,"2021-10-01",2021
"21-Oct",부산,부산진구,365,121748,21069,143182,"2021-10-01",2021
"21-Oct",부산,북구,228,102191,3644,106063,"2021-10-01",2021
"21-Oct",부산,사상구,284,83072,5789,89145,"2021-10-01",2021
"21-Oct",부산,사하구,266,107241,6339,113846,"2021-10-01",2021
"21-Oct",부산,서구,136,29141,1404,30681,"2021-10-01",2021
"21-Oct",부산,수영구,161,66815,37989,104965,"2021-10-01",2021
"21-Oct",부산,연제구,948,91830,11710,104488,"2021-10-01",2021
"21-Oct",부산,영도구,225,31281,1964,33470,"2021-10-01",2021
"21-Oct",부산,중구,303,30117,7006,37426,"2021-10-01",2021
"21-Oct",부산,해운대구,321,166240,15268,181829,"2021-10-01",2021
"21-Oct",부산,계,4649,1308213,144122,1456984,"2021-10-01",2021
"21-Oct",대구,남구,340,55849,1605,57794,"2021-10-01",2021
"21-Oct",대구,달서구,488,271374,14413,286275,"2021-10-01",2021
"21-Oct",대구,달성군,547,136243,5165,141955,"2021-10-01",2021
"21-Oct",대구,동구,349,154462,11197,166008,"2021-10-01",2021
"21-Oct",대구,북구,495,202210,7601,210306,"2021-10-01",2021
"21-Oct",대구,서구,251,67909,4047,72207,"2021-10-01",2021
"21-Oct",대구,수성구,586,208588,4849,214023,"2021-10-01",2021
"21-Oct",대구,중구,311,58517,2540,61368,"2021-10-01",2021
"21-Oct",대구,계,3367,1155152,51417,1209936,"2021-10-01",2021
"21-Oct",인천,강화군,358,35888,17354,53600,"2021-10-01",2021
"21-Oct",인천,계양구,294,120657,183462,304413,"2021-10-01",2021
"21-Oct",인천,남동구,854,256909,48337,306100,"2021-10-01",2021
"21-Oct",인천,동구,102,24715,2669,27486,"2021-10-01",2021
"21-Oct",인천,미추홀구,432,159599,9059,169090,"2021-10-01",2021
"21-Oct",인천,부평구,331,220620,28567,249518,"2021-10-01",2021
"21-Oct",인천,서구,454,246372,11394,258220,"2021-10-01",2021
"21-Oct",인천,연수구,419,199356,8511,208286,"2021-10-01",2021
"21-Oct",인천,옹진군,215,12240,231,12686,"2021-10-01",2021
"21-Oct",인천,중구,627,67124,12294,80045,"2021-10-01",2021
"21-Oct",인천,계,4086,1343480,321878,1669444,"2021-10-01",2021
"21-Oct",광주,광산구,524,197277,12590,210391,"2021-10-01",2021
"21-Oct",광주,남구,206,91882,2896,94984,"2021-10-01",2021
"21-Oct",광주,동구,229,43480,1322,45031,"2021-10-01",2021
"21-Oct",광주,북구,593,190545,8965,200103,"2021-10-01",2021
"21-Oct",광주,서구,678,140847,6399,147924,"2021-10-01",2021
"21-Oct",광주,계,2230,664031,32172,698433,"2021-10-01",2021
"21-Oct",대전,대덕구,234,85934,6849,93017,"2021-10-01",2021
"21-Oct",대전,동구,242,91552,4730,96524,"2021-10-01",2021
"21-Oct",대전,서구,803,206650,8210,215663,"2021-10-01",2021
"21-Oct",대전,유성구,364,178369,5029,183762,"2021-10-01",2021
"21-Oct",대전,중구,230,96335,5550,102115,"2021-10-01",2021
"21-Oct",대전,계,1873,658840,30368,691081,"2021-10-01",2021
"21-Oct",울산,남구,725,153805,7444,161974,"2021-10-01",2021
"21-Oct",울산,동구,188,61904,1087,63179,"2021-10-01",2021
"21-Oct",울산,북구,218,115651,3427,119296,"2021-10-01",2021
"21-Oct",울산,울주군,416,124697,7131,132244,"2021-10-01",2021
"21-Oct",울산,중구,310,100305,2517,103132,"2021-10-01",2021
"21-Oct",울산,계,1857,556362,21606,579825,"2021-10-01",2021
"21-Oct",세종,세종특별자치시,824,178966,3129,182919,"2021-10-01",2021
"21-Oct",세종,계,824,178966,3129,182919,"2021-10-01",2021
"21-Oct",경기,가평군,380,31320,595,32295,"2021-10-01",2021
"21-Oct",경기,고양시 덕양구,664,183458,3999,188121,"2021-10-01",2021
"21-Oct",경기,고양시 일산동구,274,126184,5387,131845,"2021-10-01",2021
"21-Oct",경기,고양시 일산서구,127,116565,4546,121238,"2021-10-01",2021
"21-Oct",경기,과천시,735,25865,706,27306,"2021-10-01",2021
"21-Oct",경기,광명시,304,100549,4424,105277,"2021-10-01",2021
"21-Oct",경기,광주시,386,195158,8572,204116,"2021-10-01",2021
"21-Oct",경기,구리시,259,70405,2779,73443,"2021-10-01",2021
"21-Oct",경기,군포시,298,98288,5163,103749,"2021-10-01",2021
"21-Oct",경기,김포시,524,228595,8116,237235,"2021-10-01",2021
"21-Oct",경기,남양주시,745,305934,8601,315280,"2021-10-01",2021
"21-Oct",경기,동두천시,208,38481,1451,40140,"2021-10-01",2021
"21-Oct",경기,부천시,701,295572,12176,308449,"2021-10-01",2021
"21-Oct",경기,성남시 분당구,370,186862,6964,194196,"2021-10-01",2021
"21-Oct",경기,성남시 수정구,354,77017,2610,79981,"2021-10-01",2021
"21-Oct",경기,성남시 중원구,344,71653,3971,75968,"2021-10-01",2021
"21-Oct",경기,수원시 권선구,479,191270,8942,200691,"2021-10-01",2021
"21-Oct",경기,수원시 영통구,224,147537,3119,150880,"2021-10-01",2021
"21-Oct",경기,수원시 장안구,468,103038,3841,107347,"2021-10-01",2021
"21-Oct",경기,수원시 팔달구,511,73216,2999,76726,"2021-10-01",2021
"21-Oct",경기,시흥시,458,252757,8179,261394,"2021-10-01",2021
"21-Oct",경기,안산시 단원구,553,157038,8145,165736,"2021-10-01",2021
"21-Oct",경기,안산시 상록구,174,144372,5021,149567,"2021-10-01",2021
"21-Oct",경기,안성시,397,107056,4637,112090,"2021-10-01",2021
"21-Oct",경기,안양시 동안구,403,116853,6477,123733,"2021-10-01",2021
"21-Oct",경기,안양시 만안구,154,84584,3905,88643,"2021-10-01",2021
"21-Oct",경기,양주시,393,111282,3269,114944,"2021-10-01",2021
"21-Oct",경기,양평군,584,61639,1842,64065,"2021-10-01",2021
"21-Oct",경기,여주시,459,64087,7261,71807,"2021-10-01",2021
"21-Oct",경기,연천군,310,23898,5271,29479,"2021-10-01",2021
"21-Oct",경기,오산시,215,108260,3783,112258,"2021-10-01",2021
"21-Oct",경기,용인시 기흥구,123,190340,6484,196947,"2021-10-01",2021
"21-Oct",경기,용인시 수지구,50,146115,2628,148793,"2021-10-01",2021
"21-Oct",경기,용인시 처인구,781,134026,7812,142619,"2021-10-01",2021
"21-Oct",경기,의왕시,300,65870,2912,69082,"2021-10-01",2021
"21-Oct",경기,의정부시,739,165958,5452,172149,"2021-10-01",2021
"21-Oct",경기,이천시,411,116139,6240,122790,"2021-10-01",2021
"21-Oct",경기,파주시,523,222507,10724,233754,"2021-10-01",2021
"21-Oct",경기,평택시,743,295716,12672,309131,"2021-10-01",2021
"21-Oct",경기,포천시,397,87659,10206,98262,"2021-10-01",2021
"21-Oct",경기,하남시,403,131029,3140,134572,"2021-10-01",2021
"21-Oct",경기,화성시,933,462328,12663,475924,"2021-10-01",2021
"21-Oct",경기,계,17858,5916480,237684,6172022,"2021-10-01",2021
"21-Oct",강원,강릉시,534,109547,4596,114677,"2021-10-01",2021
"21-Oct",강원,고성군,188,14857,224,15269,"2021-10-01",2021
"21-Oct",강원,동해시,312,46007,1468,47787,"2021-10-01",2021
"21-Oct",강원,삼척시,395,32330,758,33483,"2021-10-01",2021
"21-Oct",강원,속초시,306,38828,1415,40549,"2021-10-01",2021
"21-Oct",강원,양구군,199,12107,136,12442,"2021-10-01",2021
"21-Oct",강원,양양군,190,16148,298,16636,"2021-10-01",2021
"21-Oct",강원,영월군,330,21343,366,22039,"2021-10-01",2021
"21-Oct",강원,원주시,589,177981,5571,184141,"2021-10-01",2021
"21-Oct",강원,인제군,215,18877,302,19394,"2021-10-01",2021
"21-Oct",강원,정선군,335,20673,469,21477,"2021-10-01",2021
"21-Oct",강원,철원군,243,24249,322,24814,"2021-10-01",2021
"21-Oct",강원,춘천시,832,135094,6300,142226,"2021-10-01",2021
"21-Oct",강원,태백시,222,19849,750,20821,"2021-10-01",2021
"21-Oct",강원,평창군,298,25705,490,26493,"2021-10-01",2021
"21-Oct",강원,홍천군,431,39259,1032,40722,"2021-10-01",2021
"21-Oct",강원,화천군,227,13140,183,13550,"2021-10-01",2021
"21-Oct",강원,횡성군,253,27104,724,28081,"2021-10-01",2021
"21-Oct",강원,계,6099,793098,25404,824601,"2021-10-01",2021
"21-Oct",충북,괴산군,211,22890,406,23507,"2021-10-01",2021
"21-Oct",충북,단양군,224,15617,788,16629,"2021-10-01",2021
"21-Oct",충북,보은군,237,18158,1014,19409,"2021-10-01",2021
"21-Oct",충북,영동군,250,24927,402,25579,"2021-10-01",2021
"21-Oct",충북,옥천군,212,27495,1157,28864,"2021-10-01",2021
"21-Oct",충북,음성군,255,58878,1967,61100,"2021-10-01",2021
"21-Oct",충북,제천시,339,67586,3435,71360,"2021-10-01",2021
"21-Oct",충북,증평군,90,19309,757,20156,"2021-10-01",2021
"21-Oct",충북,진천군,216,50826,1326,52368,"2021-10-01",2021
"21-Oct",충북,청원군,1,19,0,20,"2021-10-01",2021
"21-Oct",충북,청주시 상당구,520,93410,2673,96603,"2021-10-01",2021
"21-Oct",충북,청주시 서원구,240,101825,4354,106419,"2021-10-01",2021
"21-Oct",충북,청주시 청원구,343,103993,4488,108824,"2021-10-01",2021
"21-Oct",충북,청주시 흥덕구,355,131976,7433,139764,"2021-10-01",2021
"21-Oct",충북,충주시,596,110905,7434,118935,"2021-10-01",2021
"21-Oct",충북,계,4089,847814,37634,889537,"2021-10-01",2021
"21-Oct",충남,계룡시,157,22550,546,23253,"2021-10-01",2021
"21-Oct",충남,공주시,577,54014,2578,57169,"2021-10-01",2021
"21-Oct",충남,금산군,195,28565,2174,30934,"2021-10-01",2021
"21-Oct",충남,논산시,416,61091,2377,63884,"2021-10-01",2021
"21-Oct",충남,당진시,399,96629,4021,101049,"2021-10-01",2021
"21-Oct",충남,보령시,408,52613,1359,54380,"2021-10-01",2021
"21-Oct",충남,부여군,302,34305,1184,35791,"2021-10-01",2021
"21-Oct",충남,서산시,420,96508,3615,100543,"2021-10-01",2021
"21-Oct",충남,서천군,233,27092,827,28152,"2021-10-01",2021
"21-Oct",충남,아산시,529,173592,6688,180809,"2021-10-01",2021
"21-Oct",충남,예산군,412,43285,1422,45119,"2021-10-01",2021
"21-Oct",충남,천안시 동남구,288,131900,5087,137275,"2021-10-01",2021
"21-Oct",충남,천안시 서북구,524,198767,5526,204817,"2021-10-01",2021
"21-Oct",충남,청양군,252,16929,827,18008,"2021-10-01",2021
"21-Oct",충남,태안군,313,34273,578,35164,"2021-10-01",2021
"21-Oct",충남,홍성군,422,53372,1452,55246,"2021-10-01",2021
"21-Oct",충남,계,5847,1125485,40261,1171593,"2021-10-01",2021
"21-Oct",전북,고창군,304,30600,587,31491,"2021-10-01",2021
"21-Oct",전북,군산시,550,131804,6389,138743,"2021-10-01",2021
"21-Oct",전북,김제시,288,45605,1967,47860,"2021-10-01",2021
"21-Oct",전북,남원시,410,41114,3775,45299,"2021-10-01",2021
"21-Oct",전북,무주군,194,12938,395,13527,"2021-10-01",2021
"21-Oct",전북,부안군,259,27395,613,28267,"2021-10-01",2021
"21-Oct",전북,순창군,227,14653,147,15027,"2021-10-01",2021
"21-Oct",전북,완주군,411,52044,3160,55615,"2021-10-01",2021
"21-Oct",전북,익산시,512,136761,5865,143138,"2021-10-01",2021
"21-Oct",전북,임실군,218,14226,429,14873,"2021-10-01",2021
"21-Oct",전북,장수군,238,12217,178,12633,"2021-10-01",2021
"21-Oct",전북,전주시 덕진구,340,173333,6925,180598,"2021-10-01",2021
"21-Oct",전북,전주시 완산구,759,152422,4173,157354,"2021-10-01",2021
"21-Oct",전북,정읍시,353,54909,3567,58829,"2021-10-01",2021
"21-Oct",전북,진안군,258,14102,236,14596,"2021-10-01",2021
"21-Oct",전북,계,5321,914123,38406,957850,"2021-10-01",2021
"21-Oct",전남,강진군,225,18690,1065,19980,"2021-10-01",2021
"21-Oct",전남,고흥군,304,32312,593,33209,"2021-10-01",2021
"21-Oct",전남,곡성군,162,14936,722,15820,"2021-10-01",2021
"21-Oct",전남,광양시,248,84049,6012,90309,"2021-10-01",2021
"21-Oct",전남,구례군,137,13182,714,14033,"2021-10-01",2021
"21-Oct",전남,나주시,474,65818,3287,69579,"2021-10-01",2021
"21-Oct",전남,담양군,230,27432,1637,29299,"2021-10-01",2021
"21-Oct",전남,목포시,407,94513,5463,100383,"2021-10-01",2021
"21-Oct",전남,무안군,552,49418,1085,51055,"2021-10-01",2021
"21-Oct",전남,보성군,218,21728,13319,35265,"2021-10-01",2021
"21-Oct",전남,순천시,501,141786,5268,147555,"2021-10-01",2021
"21-Oct",전남,신안군,322,21568,78799,100689,"2021-10-01",2021
"21-Oct",전남,여수시,536,132032,7211,139779,"2021-10-01",2021
"21-Oct",전남,영광군,205,27954,760,28919,"2021-10-01",2021
"21-Oct",전남,영암군,273,33565,2563,36401,"2021-10-01",2021
"21-Oct",전남,완도군,282,25468,547,26297,"2021-10-01",2021
"21-Oct",전남,장성군,202,26735,1202,28139,"2021-10-01",2021
"21-Oct",전남,장흥군,258,20081,443,20782,"2021-10-01",2021
"21-Oct",전남,진도군,165,17070,288,17523,"2021-10-01",2021
"21-Oct",전남,함평군,204,18244,31305,49753,"2021-10-01",2021
"21-Oct",전남,해남군,332,39679,30484,70495,"2021-10-01",2021
"21-Oct",전남,화순군,229,33164,2152,35545,"2021-10-01",2021
"21-Oct",전남,계,6466,959424,194919,1160809,"2021-10-01",2021
"21-Oct",경북,경산시,321,139618,4527,144466,"2021-10-01",2021
"21-Oct",경북,경주시,589,142236,4595,147420,"2021-10-01",2021
"21-Oct",경북,고령군,167,20433,684,21284,"2021-10-01",2021
"21-Oct",경북,구미시,550,214041,7285,221876,"2021-10-01",2021
"21-Oct",경북,군위군,125,14906,305,15336,"2021-10-01",2021
"21-Oct",경북,김천시,399,75085,1973,77457,"2021-10-01",2021
"21-Oct",경북,문경시,278,37164,829,38271,"2021-10-01",2021
"21-Oct",경북,봉화군,204,18090,200,18494,"2021-10-01",2021
"21-Oct",경북,상주시,389,53056,1864,55309,"2021-10-01",2021
"21-Oct",경북,성주군,200,30766,1299,32265,"2021-10-01",2021
"21-Oct",경북,안동시,737,82856,2708,86301,"2021-10-01",2021
"21-Oct",경북,영덕군,253,18993,305,19551,"2021-10-01",2021
"21-Oct",경북,영양군,141,9840,114,10095,"2021-10-01",2021
"21-Oct",경북,영주시,373,55565,1525,57463,"2021-10-01",2021
"21-Oct",경북,영천시,336,60084,2585,63005,"2021-10-01",2021
"21-Oct",경북,예천군,270,30486,498,31254,"2021-10-01",2021
"21-Oct",경북,울릉군,157,5202,587,5946,"2021-10-01",2021
"21-Oct",경북,울진군,310,26330,356,26996,"2021-10-01",2021
"21-Oct",경북,의성군,315,30934,1086,32335,"2021-10-01",2021
"21-Oct",경북,청도군,223,25051,794,26068,"2021-10-01",2021
"21-Oct",경북,청송군,196,15809,207,16212,"2021-10-01",2021
"21-Oct",경북,칠곡군,300,68820,2389,71509,"2021-10-01",2021
"21-Oct",경북,포항시 남구,450,122139,8372,130961,"2021-10-01",2021
"21-Oct",경북,포항시 북구,337,141093,3661,145091,"2021-10-01",2021
"21-Oct",경북,계,7620,1438597,48748,1494965,"2021-10-01",2021
"21-Oct",경남,거제시,368,106447,2124,108939,"2021-10-01",2021
"21-Oct",경남,거창군,272,32548,778,33598,"2021-10-01",2021
"21-Oct",경남,고성군,224,26520,565,27309,"2021-10-01",2021
"21-Oct",경남,김해시,653,276618,7346,284617,"2021-10-01",2021
"21-Oct",경남,남해군,272,20052,449,20773,"2021-10-01",2021
"21-Oct",경남,밀양시,335,56196,3922,60453,"2021-10-01",2021
"21-Oct",경남,사천시,315,56693,1509,58517,"2021-10-01",2021
"21-Oct",경남,산청군,247,20367,782,21396,"2021-10-01",2021
"21-Oct",경남,양산시,413,168066,10334,178813,"2021-10-01",2021
"21-Oct",경남,의령군,202,14688,772,15662,"2021-10-01",2021
"21-Oct",경남,진주시,642,166880,6488,174010,"2021-10-01",2021
"21-Oct",경남,창녕군,226,35634,726,36586,"2021-10-01",2021
"21-Oct",경남,창원시 마산합포구,329,95654,2865,98848,"2021-10-01",2021
"21-Oct",경남,창원시 마산회원구,177,96424,4986,101587,"2021-10-01",2021
"21-Oct",경남,창원시 성산구,644,148825,50737,200206,"2021-10-01",2021
"21-Oct",경남,창원시 의창구,431,116366,3526,120323,"2021-10-01",2021
"21-Oct",경남,창원시 진해구,215,93212,1889,95316,"2021-10-01",2021
"21-Oct",경남,통영시,314,52463,1405,54182,"2021-10-01",2021
"21-Oct",경남,하동군,223,23980,384,24587,"2021-10-01",2021
"21-Oct",경남,함안군,191,43306,21259,64756,"2021-10-01",2021
"21-Oct",경남,함양군,216,19601,427,20244,"2021-10-01",2021
"21-Oct",경남,합천군,280,23443,619,24342,"2021-10-01",2021
"21-Oct",경남,계,7189,1693983,123892,1825064,"2021-10-01",2021
"21-Oct",제주,서귀포시,789,104821,1988,107598,"2021-10-01",2021
"21-Oct",제주,제주시,1627,288305,254083,544015,"2021-10-01",2021
"21-Oct",제주,계,2416,393126,256071,651613,"2021-10-01",2021
"21-Nov",서울,강남구,396,218806,20935,240137,"2021-11-01",2021
"21-Nov",서울,강동구,306,143548,8570,152424,"2021-11-01",2021
"21-Nov",서울,강북구,312,70863,4245,75420,"2021-11-01",2021
"21-Nov",서울,강서구,341,185974,18054,204369,"2021-11-01",2021
"21-Nov",서울,관악구,305,112488,5620,118413,"2021-11-01",2021
"21-Nov",서울,광진구,302,92837,5290,98429,"2021-11-01",2021
"21-Nov",서울,구로구,311,132088,13399,145798,"2021-11-01",2021
"21-Nov",서울,금천구,140,83691,6303,90134,"2021-11-01",2021
"21-Nov",서울,노원구,315,142992,8862,152169,"2021-11-01",2021
"21-Nov",서울,도봉구,285,88162,7289,95736,"2021-11-01",2021
"21-Nov",서울,동대문구,319,93253,4901,98473,"2021-11-01",2021
"21-Nov",서울,동작구,326,103191,2788,106305,"2021-11-01",2021
"21-Nov",서울,마포구,340,113681,7346,121367,"2021-11-01",2021
"21-Nov",서울,서대문구,456,83209,5780,89445,"2021-11-01",2021
"21-Nov",서울,서초구,526,166315,10724,177565,"2021-11-01",2021
"21-Nov",서울,성동구,344,93520,12578,106442,"2021-11-01",2021
"21-Nov",서울,성북구,295,115782,5194,121271,"2021-11-01",2021
"21-Nov",서울,송파구,390,233161,13499,247050,"2021-11-01",2021
"21-Nov",서울,양천구,321,142393,8540,151254,"2021-11-01",2021
"21-Nov",서울,영등포구,374,136806,8760,145940,"2021-11-01",2021
"21-Nov",서울,용산구,336,77255,2178,79769,"2021-11-01",2021
"21-Nov",서울,은평구,306,125911,6860,133077,"2021-11-01",2021
"21-Nov",서울,종로구,3785,44664,1937,50386,"2021-11-01",2021
"21-Nov",서울,중구,1244,54955,5330,61529,"2021-11-01",2021
"21-Nov",서울,중랑구,253,104681,9400,114334,"2021-11-01",2021
"21-Nov",서울,계,12628,2960226,204382,3177236,"2021-11-01",2021
"21-Nov",부산,강서구,315,81848,3837,86000,"2021-11-01",2021
"21-Nov",부산,금정구,273,80655,7397,88325,"2021-11-01",2021
"21-Nov",부산,기장군,261,80967,2644,83872,"2021-11-01",2021
"21-Nov",부산,남구,221,91497,9289,101007,"2021-11-01",2021
"21-Nov",부산,동구,184,51917,5121,57222,"2021-11-01",2021
"21-Nov",부산,동래구,174,92649,3622,96445,"2021-11-01",2021
"21-Nov",부산,부산진구,369,121799,21287,143455,"2021-11-01",2021
"21-Nov",부산,북구,232,102314,3655,106201,"2021-11-01",2021
"21-Nov",부산,사상구,283,83144,5760,89187,"2021-11-01",2021
"21-Nov",부산,사하구,268,107324,6321,113913,"2021-11-01",2021
"21-Nov",부산,서구,140,29128,1403,30671,"2021-11-01",2021
"21-Nov",부산,수영구,162,66792,38946,105900,"2021-11-01",2021
"21-Nov",부산,연제구,947,92149,11870,104966,"2021-11-01",2021
"21-Nov",부산,영도구,229,31309,1964,33502,"2021-11-01",2021
"21-Nov",부산,중구,311,30133,7024,37468,"2021-11-01",2021
"21-Nov",부산,해운대구,320,166395,15654,182369,"2021-11-01",2021
"21-Nov",부산,계,4689,1310020,145794,1460503,"2021-11-01",2021
"21-Nov",대구,남구,341,55765,1589,57695,"2021-11-01",2021
"21-Nov",대구,달서구,477,271375,14284,286136,"2021-11-01",2021
"21-Nov",대구,달성군,548,136562,5113,142223,"2021-11-01",2021
"21-Nov",대구,동구,362,154908,11065,166335,"2021-11-01",2021
"21-Nov",대구,북구,500,202629,7613,210742,"2021-11-01",2021
"21-Nov",대구,서구,251,67786,4048,72085,"2021-11-01",2021
"21-Nov",대구,수성구,586,208419,4771,213776,"2021-11-01",2021
"21-Nov",대구,중구,315,58440,2551,61306,"2021-11-01",2021
"21-Nov",대구,계,3380,1155884,51034,1210298,"2021-11-01",2021
"21-Nov",인천,강화군,363,36048,16517,52928,"2021-11-01",2021
"21-Nov",인천,계양구,295,121153,183564,305012,"2021-11-01",2021
"21-Nov",인천,남동구,854,248096,48028,296978,"2021-11-01",2021
"21-Nov",인천,동구,99,24606,2651,27356,"2021-11-01",2021
"21-Nov",인천,미추홀구,432,160006,8919,169357,"2021-11-01",2021
"21-Nov",인천,부평구,340,220903,29361,250604,"2021-11-01",2021
"21-Nov",인천,서구,470,256122,11477,268069,"2021-11-01",2021
"21-Nov",인천,연수구,424,199678,8588,208690,"2021-11-01",2021
"21-Nov",인천,옹진군,215,12281,235,12731,"2021-11-01",2021
"21-Nov",인천,중구,641,67401,12453,80495,"2021-11-01",2021
"21-Nov",인천,계,4133,1346294,321793,1672220,"2021-11-01",2021
"21-Nov",광주,광산구,528,197374,12617,210519,"2021-11-01",2021
"21-Nov",광주,남구,210,92256,2912,95378,"2021-11-01",2021
"21-Nov",광주,동구,234,43567,1333,45134,"2021-11-01",2021
"21-Nov",광주,북구,588,190861,8956,200405,"2021-11-01",2021
"21-Nov",광주,서구,682,141114,6395,148191,"2021-11-01",2021
"21-Nov",광주,계,2242,665172,32213,699627,"2021-11-01",2021
"21-Nov",대전,대덕구,235,85956,6838,93029,"2021-11-01",2021
"21-Nov",대전,동구,245,91573,4742,96560,"2021-11-01",2021
"21-Nov",대전,서구,812,206912,8176,215900,"2021-11-01",2021
"21-Nov",대전,유성구,364,179047,5079,184490,"2021-11-01",2021
"21-Nov",대전,중구,231,96284,5551,102066,"2021-11-01",2021
"21-Nov",대전,계,1887,659772,30386,692045,"2021-11-01",2021
"21-Nov",울산,남구,731,153866,7446,162043,"2021-11-01",2021
"21-Nov",울산,동구,189,61919,1084,63192,"2021-11-01",2021
"21-Nov",울산,북구,222,116252,3432,119906,"2021-11-01",2021
"21-Nov",울산,울주군,417,124926,7078,132421,"2021-11-01",2021
"21-Nov",울산,중구,314,100421,2525,103260,"2021-11-01",2021
"21-Nov",울산,계,1873,557384,21565,580822,"2021-11-01",2021
"21-Nov",세종,세종특별자치시,836,179677,3160,183673,"2021-11-01",2021
"21-Nov",세종,계,836,179677,3160,183673,"2021-11-01",2021
"21-Nov",경기,가평군,382,31394,597,32373,"2021-11-01",2021
"21-Nov",경기,고양시 덕양구,669,183949,3988,188606,"2021-11-01",2021
"21-Nov",경기,고양시 일산동구,276,126284,5343,131903,"2021-11-01",2021
"21-Nov",경기,고양시 일산서구,127,116519,4568,121214,"2021-11-01",2021
"21-Nov",경기,과천시,733,26329,705,27767,"2021-11-01",2021
"21-Nov",경기,광명시,312,100603,4458,105373,"2021-11-01",2021
"21-Nov",경기,광주시,389,195579,8612,204580,"2021-11-01",2021
"21-Nov",경기,구리시,257,70304,2792,73353,"2021-11-01",2021
"21-Nov",경기,군포시,296,98486,5175,103957,"2021-11-01",2021
"21-Nov",경기,김포시,525,228949,8103,237577,"2021-11-01",2021
"21-Nov",경기,남양주시,747,307177,8640,316564,"2021-11-01",2021
"21-Nov",경기,동두천시,211,38610,1455,40276,"2021-11-01",2021
"21-Nov",경기,부천시,709,295656,12233,308598,"2021-11-01",2021
"21-Nov",경기,성남시 분당구,374,187232,6940,194546,"2021-11-01",2021
"21-Nov",경기,성남시 수정구,359,77300,2619,80278,"2021-11-01",2021
"21-Nov",경기,성남시 중원구,347,71633,3997,75977,"2021-11-01",2021
"21-Nov",경기,수원시 권선구,482,190946,8963,200391,"2021-11-01",2021
"21-Nov",경기,수원시 영통구,227,147543,3117,150887,"2021-11-01",2021
"21-Nov",경기,수원시 장안구,472,103381,3794,107647,"2021-11-01",2021
"21-Nov",경기,수원시 팔달구,502,73187,2998,76687,"2021-11-01",2021
"21-Nov",경기,시흥시,465,253421,8219,262105,"2021-11-01",2021
"21-Nov",경기,안산시 단원구,559,157196,8106,165861,"2021-11-01",2021
"21-Nov",경기,안산시 상록구,175,144588,5040,149803,"2021-11-01",2021
"21-Nov",경기,안성시,397,107376,4644,112417,"2021-11-01",2021
"21-Nov",경기,안양시 동안구,405,116935,6488,123828,"2021-11-01",2021
"21-Nov",경기,안양시 만안구,156,84708,3920,88784,"2021-11-01",2021
"21-Nov",경기,양주시,393,111548,3310,115251,"2021-11-01",2021
"21-Nov",경기,양평군,584,61874,1847,64305,"2021-11-01",2021
"21-Nov",경기,여주시,461,64218,7280,71959,"2021-11-01",2021
"21-Nov",경기,연천군,307,23918,5265,29490,"2021-11-01",2021
"21-Nov",경기,오산시,218,108594,3852,112664,"2021-11-01",2021
"21-Nov",경기,용인시 기흥구,122,190640,6696,197458,"2021-11-01",2021
"21-Nov",경기,용인시 수지구,50,146267,2475,148792,"2021-11-01",2021
"21-Nov",경기,용인시 처인구,781,134302,7836,142919,"2021-11-01",2021
"21-Nov",경기,의왕시,305,65904,2913,69122,"2021-11-01",2021
"21-Nov",경기,의정부시,744,166324,5408,172476,"2021-11-01",2021
"21-Nov",경기,이천시,412,116512,6262,123186,"2021-11-01",2021
"21-Nov",경기,파주시,523,223902,10732,235157,"2021-11-01",2021
"21-Nov",경기,평택시,742,297707,12764,311213,"2021-11-01",2021
"21-Nov",경기,포천시,396,87877,10074,98347,"2021-11-01",2021
"21-Nov",경기,하남시,403,132357,3216,135976,"2021-11-01",2021
"21-Nov",경기,화성시,928,464615,12715,478258,"2021-11-01",2021
"21-Nov",경기,계,17922,5931844,238159,6187925,"2021-11-01",2021
"21-Nov",강원,강릉시,538,109731,4592,114861,"2021-11-01",2021
"21-Nov",강원,고성군,189,14956,224,15369,"2021-11-01",2021
"21-Nov",강원,동해시,317,46091,1480,47888,"2021-11-01",2021
"21-Nov",강원,삼척시,396,32347,758,33501,"2021-11-01",2021
"21-Nov",강원,속초시,311,38895,1403,40609,"2021-11-01",2021
"21-Nov",강원,양구군,201,12095,135,12431,"2021-11-01",2021
"21-Nov",강원,양양군,191,16159,290,16640,"2021-11-01",2021
"21-Nov",강원,영월군,332,21337,361,22030,"2021-11-01",2021
"21-Nov",강원,원주시,604,178812,5596,185012,"2021-11-01",2021
"21-Nov",강원,인제군,216,18901,303,19420,"2021-11-01",2021
"21-Nov",강원,정선군,335,20699,465,21499,"2021-11-01",2021
"21-Nov",강원,철원군,246,24283,326,24855,"2021-11-01",2021
"21-Nov",강원,춘천시,845,135411,6303,142559,"2021-11-01",2021
"21-Nov",강원,태백시,224,19879,748,20851,"2021-11-01",2021
"21-Nov",강원,평창군,301,25749,482,26532,"2021-11-01",2021
"21-Nov",강원,홍천군,430,39313,1034,40777,"2021-11-01",2021
"21-Nov",강원,화천군,234,13137,181,13552,"2021-11-01",2021
"21-Nov",강원,횡성군,260,27168,738,28166,"2021-11-01",2021
"21-Nov",강원,계,6170,794963,25419,826552,"2021-11-01",2021
"21-Nov",충북,괴산군,213,22864,405,23482,"2021-11-01",2021
"21-Nov",충북,단양군,224,15647,790,16661,"2021-11-01",2021
"21-Nov",충북,보은군,236,18135,1015,19386,"2021-11-01",2021
"21-Nov",충북,영동군,252,25036,410,25698,"2021-11-01",2021
"21-Nov",충북,옥천군,209,27586,1161,28956,"2021-11-01",2021
"21-Nov",충북,음성군,255,59181,1954,61390,"2021-11-01",2021
"21-Nov",충북,제천시,340,67682,3450,71472,"2021-11-01",2021
"21-Nov",충북,증평군,91,19302,754,20147,"2021-11-01",2021
"21-Nov",충북,진천군,217,50973,1334,52524,"2021-11-01",2021
"21-Nov",충북,청원군,1,19,0,20,"2021-11-01",2021
"21-Nov",충북,청주시 상당구,522,93681,2684,96887,"2021-11-01",2021
"21-Nov",충북,청주시 서원구,242,101701,4300,106243,"2021-11-01",2021
"21-Nov",충북,청주시 청원구,345,104224,4477,109046,"2021-11-01",2021
"21-Nov",충북,청주시 흥덕구,364,132119,7462,139945,"2021-11-01",2021
"21-Nov",충북,충주시,598,111059,7368,119025,"2021-11-01",2021
"21-Nov",충북,계,4109,849209,37564,890882,"2021-11-01",2021
"21-Nov",충남,계룡시,158,22552,551,23261,"2021-11-01",2021
"21-Nov",충남,공주시,583,54028,2649,57260,"2021-11-01",2021
"21-Nov",충남,금산군,199,28538,2193,30930,"2021-11-01",2021
"21-Nov",충남,논산시,418,61215,2387,64020,"2021-11-01",2021
"21-Nov",충남,당진시,403,96914,4030,101347,"2021-11-01",2021
"21-Nov",충남,보령시,410,52746,1357,54513,"2021-11-01",2021
"21-Nov",충남,부여군,301,34349,1183,35833,"2021-11-01",2021
"21-Nov",충남,서산시,423,96772,3583,100778,"2021-11-01",2021
"21-Nov",충남,서천군,237,27068,823,28128,"2021-11-01",2021
"21-Nov",충남,아산시,532,174438,6683,181653,"2021-11-01",2021
"21-Nov",충남,예산군,412,43313,1398,45123,"2021-11-01",2021
"21-Nov",충남,천안시 동남구,289,132197,5158,137644,"2021-11-01",2021
"21-Nov",충남,천안시 서북구,538,199282,5539,205359,"2021-11-01",2021
"21-Nov",충남,청양군,251,16904,824,17979,"2021-11-01",2021
"21-Nov",충남,태안군,315,34298,574,35187,"2021-11-01",2021
"21-Nov",충남,홍성군,423,53351,1445,55219,"2021-11-01",2021
"21-Nov",충남,계,5892,1127965,40377,1174234,"2021-11-01",2021
"21-Nov",전북,고창군,304,30661,584,31549,"2021-11-01",2021
"21-Nov",전북,군산시,552,132184,6384,139120,"2021-11-01",2021
"21-Nov",전북,김제시,291,45675,1970,47936,"2021-11-01",2021
"21-Nov",전북,남원시,419,41194,3684,45297,"2021-11-01",2021
"21-Nov",전북,무주군,196,12980,395,13571,"2021-11-01",2021
"21-Nov",전북,부안군,260,27438,614,28312,"2021-11-01",2021
"21-Nov",전북,순창군,229,14667,146,15042,"2021-11-01",2021
"21-Nov",전북,완주군,411,52155,3156,55722,"2021-11-01",2021
"21-Nov",전북,익산시,521,137020,5867,143408,"2021-11-01",2021
"21-Nov",전북,임실군,217,14255,430,14902,"2021-11-01",2021
"21-Nov",전북,장수군,237,12238,178,12653,"2021-11-01",2021
"21-Nov",전북,전주시 덕진구,338,173730,6944,181012,"2021-11-01",2021
"21-Nov",전북,전주시 완산구,774,152445,4146,157365,"2021-11-01",2021
"21-Nov",전북,정읍시,358,55052,3599,59009,"2021-11-01",2021
"21-Nov",전북,진안군,259,14163,239,14661,"2021-11-01",2021
"21-Nov",전북,계,5366,915857,38336,959559,"2021-11-01",2021
"21-Nov",전남,강진군,233,18637,1065,19935,"2021-11-01",2021
"21-Nov",전남,고흥군,314,32384,591,33289,"2021-11-01",2021
"21-Nov",전남,곡성군,163,14949,723,15835,"2021-11-01",2021
"21-Nov",전남,광양시,250,84506,6016,90772,"2021-11-01",2021
"21-Nov",전남,구례군,144,13230,727,14101,"2021-11-01",2021
"21-Nov",전남,나주시,481,66006,3289,69776,"2021-11-01",2021
"21-Nov",전남,담양군,222,27438,1634,29294,"2021-11-01",2021
"21-Nov",전남,목포시,412,94451,5466,100329,"2021-11-01",2021
"21-Nov",전남,무안군,564,49825,1086,51475,"2021-11-01",2021
"21-Nov",전남,보성군,226,21687,12416,34329,"2021-11-01",2021
"21-Nov",전남,순천시,512,141837,5281,147630,"2021-11-01",2021
"21-Nov",전남,신안군,339,21657,80671,102667,"2021-11-01",2021
"21-Nov",전남,여수시,542,132137,7231,139910,"2021-11-01",2021
"21-Nov",전남,영광군,206,28008,758,28972,"2021-11-01",2021
"21-Nov",전남,영암군,274,33638,2474,36386,"2021-11-01",2021
"21-Nov",전남,완도군,285,25535,546,26366,"2021-11-01",2021
"21-Nov",전남,장성군,205,26762,1241,28208,"2021-11-01",2021
"21-Nov",전남,장흥군,259,20097,443,20799,"2021-11-01",2021
"21-Nov",전남,진도군,171,17079,288,17538,"2021-11-01",2021
"21-Nov",전남,함평군,209,18247,30935,49391,"2021-11-01",2021
"21-Nov",전남,해남군,343,39691,31677,71711,"2021-11-01",2021
"21-Nov",전남,화순군,231,33210,2141,35582,"2021-11-01",2021
"21-Nov",전남,계,6585,961011,196699,1164295,"2021-11-01",2021
"21-Nov",경북,경산시,323,139711,4546,144580,"2021-11-01",2021
"21-Nov",경북,경주시,594,142516,4597,147707,"2021-11-01",2021
"21-Nov",경북,고령군,171,20421,681,21273,"2021-11-01",2021
"21-Nov",경북,구미시,553,214271,7262,222086,"2021-11-01",2021
"21-Nov",경북,군위군,125,14952,308,15385,"2021-11-01",2021
"21-Nov",경북,김천시,403,75215,1974,77592,"2021-11-01",2021
"21-Nov",경북,문경시,279,37178,851,38308,"2021-11-01",2021
"21-Nov",경북,봉화군,205,18133,208,18546,"2021-11-01",2021
"21-Nov",경북,상주시,391,53146,1860,55397,"2021-11-01",2021
"21-Nov",경북,성주군,199,30830,1308,32337,"2021-11-01",2021
"21-Nov",경북,안동시,743,82866,2721,86330,"2021-11-01",2021
"21-Nov",경북,영덕군,253,19030,302,19585,"2021-11-01",2021
"21-Nov",경북,영양군,141,9855,111,10107,"2021-11-01",2021
"21-Nov",경북,영주시,378,55607,1516,57501,"2021-11-01",2021
"21-Nov",경북,영천시,325,60298,2584,63207,"2021-11-01",2021
"21-Nov",경북,예천군,275,30533,496,31304,"2021-11-01",2021
"21-Nov",경북,울릉군,157,5224,591,5972,"2021-11-01",2021
"21-Nov",경북,울진군,312,26361,361,27034,"2021-11-01",2021
"21-Nov",경북,의성군,315,31036,1082,32433,"2021-11-01",2021
"21-Nov",경북,청도군,224,25135,797,26156,"2021-11-01",2021
"21-Nov",경북,청송군,194,15861,207,16262,"2021-11-01",2021
"21-Nov",경북,칠곡군,302,68982,2405,71689,"2021-11-01",2021
"21-Nov",경북,포항시 남구,451,122571,8316,131338,"2021-11-01",2021
"21-Nov",경북,포항시 북구,341,141331,3678,145350,"2021-11-01",2021
"21-Nov",경북,계,7654,1441063,48762,1497479,"2021-11-01",2021
"21-Nov",경남,거제시,375,106542,2150,109067,"2021-11-01",2021
"21-Nov",경남,거창군,271,32621,770,33662,"2021-11-01",2021
"21-Nov",경남,고성군,226,26528,564,27318,"2021-11-01",2021
"21-Nov",경남,김해시,653,276959,7357,284969,"2021-11-01",2021
"21-Nov",경남,남해군,274,20116,453,20843,"2021-11-01",2021
"21-Nov",경남,밀양시,333,56280,3924,60537,"2021-11-01",2021
"21-Nov",경남,사천시,315,56822,1522,58659,"2021-11-01",2021
"21-Nov",경남,산청군,247,20388,781,21416,"2021-11-01",2021
"21-Nov",경남,양산시,418,168166,10382,178966,"2021-11-01",2021
"21-Nov",경남,의령군,203,14683,770,15656,"2021-11-01",2021
"21-Nov",경남,진주시,641,167226,6479,174346,"2021-11-01",2021
"21-Nov",경남,창녕군,227,35733,732,36692,"2021-11-01",2021
"21-Nov",경남,창원시 마산합포구,334,95482,2839,98655,"2021-11-01",2021
"21-Nov",경남,창원시 마산회원구,181,96619,5096,101896,"2021-11-01",2021
"21-Nov",경남,창원시 성산구,650,149556,51105,201311,"2021-11-01",2021
"21-Nov",경남,창원시 의창구,428,116423,3511,120362,"2021-11-01",2021
"21-Nov",경남,창원시 진해구,217,93551,1912,95680,"2021-11-01",2021
"21-Nov",경남,통영시,316,52506,1404,54226,"2021-11-01",2021
"21-Nov",경남,하동군,221,24002,382,24605,"2021-11-01",2021
"21-Nov",경남,함안군,192,43848,21135,65175,"2021-11-01",2021
"21-Nov",경남,함양군,218,19563,431,20212,"2021-11-01",2021
"21-Nov",경남,합천군,279,23510,616,24405,"2021-11-01",2021
"21-Nov",경남,계,7219,1697124,124315,1828658,"2021-11-01",2021
"21-Nov",제주,서귀포시,787,105184,1995,107966,"2021-11-01",2021
"21-Nov",제주,제주시,1639,289740,256124,547503,"2021-11-01",2021
"21-Nov",제주,계,2426,394924,258119,655469,"2021-11-01",2021
"21-Dec",서울,강남구,400,218708,20535,239643,"2021-12-01",2021
"21-Dec",서울,강동구,306,143288,8584,152178,"2021-12-01",2021
"21-Dec",서울,강북구,309,70789,4239,75337,"2021-12-01",2021
"21-Dec",서울,강서구,344,186599,18115,205058,"2021-12-01",2021
"21-Dec",서울,관악구,307,112156,5619,118082,"2021-12-01",2021
"21-Dec",서울,광진구,305,92742,5324,98371,"2021-12-01",2021
"21-Dec",서울,구로구,312,132057,13505,145874,"2021-12-01",2021
"21-Dec",서울,금천구,139,83610,6420,90169,"2021-12-01",2021
"21-Dec",서울,노원구,317,143011,8957,152285,"2021-12-01",2021
"21-Dec",서울,도봉구,287,88086,7258,95631,"2021-12-01",2021
"21-Dec",서울,동대문구,322,93282,4862,98466,"2021-12-01",2021
"21-Dec",서울,동작구,328,103115,2786,106229,"2021-12-01",2021
"21-Dec",서울,마포구,342,113699,7323,121364,"2021-12-01",2021
"21-Dec",서울,서대문구,455,83064,5680,89199,"2021-12-01",2021
"21-Dec",서울,서초구,524,165901,10708,177133,"2021-12-01",2021
"21-Dec",서울,성동구,341,93659,13564,107564,"2021-12-01",2021
"21-Dec",서울,성북구,297,115636,5140,121073,"2021-12-01",2021
"21-Dec",서울,송파구,393,232903,13562,246858,"2021-12-01",2021
"21-Dec",서울,양천구,321,142479,8538,151338,"2021-12-01",2021
"21-Dec",서울,영등포구,381,136974,8740,146095,"2021-12-01",2021
"21-Dec",서울,용산구,336,77221,2183,79740,"2021-12-01",2021
"21-Dec",서울,은평구,310,125984,6881,133175,"2021-12-01",2021
"21-Dec",서울,종로구,3872,44523,1953,50348,"2021-12-01",2021
"21-Dec",서울,중구,1242,54637,5279,61158,"2021-12-01",2021
"21-Dec",서울,중랑구,257,104676,9442,114375,"2021-12-01",2021
"21-Dec",서울,계,12747,2958799,205197,3176743,"2021-12-01",2021
"21-Dec",부산,강서구,322,82010,3818,86150,"2021-12-01",2021
"21-Dec",부산,금정구,275,80491,7380,88146,"2021-12-01",2021
"21-Dec",부산,기장군,260,81030,2663,83953,"2021-12-01",2021
"21-Dec",부산,남구,224,91324,9285,100833,"2021-12-01",2021
"21-Dec",부산,동구,188,52892,5114,58194,"2021-12-01",2021
"21-Dec",부산,동래구,177,92907,3638,96722,"2021-12-01",2021
"21-Dec",부산,부산진구,376,121854,21231,143461,"2021-12-01",2021
"21-Dec",부산,북구,290,102305,3666,106261,"2021-12-01",2021
"21-Dec",부산,사상구,285,83169,5730,89184,"2021-12-01",2021
"21-Dec",부산,사하구,270,107315,6320,113905,"2021-12-01",2021
"21-Dec",부산,서구,142,29126,1400,30668,"2021-12-01",2021
"21-Dec",부산,수영구,163,66648,40125,106936,"2021-12-01",2021
"21-Dec",부산,연제구,977,93185,12100,106262,"2021-12-01",2021
"21-Dec",부산,영도구,228,31297,1972,33497,"2021-12-01",2021
"21-Dec",부산,중구,309,30272,7025,37606,"2021-12-01",2021
"21-Dec",부산,해운대구,324,166311,16195,182830,"2021-12-01",2021
"21-Dec",부산,계,4810,1312136,147662,1464608,"2021-12-01",2021
"21-Dec",대구,남구,342,55628,1596,57566,"2021-12-01",2021
"21-Dec",대구,달서구,485,271706,14385,286576,"2021-12-01",2021
"21-Dec",대구,달성군,559,136415,5111,142085,"2021-12-01",2021
"21-Dec",대구,동구,365,155505,11044,166914,"2021-12-01",2021
"21-Dec",대구,북구,506,203348,7608,211462,"2021-12-01",2021
"21-Dec",대구,서구,253,67672,4044,71969,"2021-12-01",2021
"21-Dec",대구,수성구,596,208160,4757,213513,"2021-12-01",2021
"21-Dec",대구,중구,328,58163,2519,61010,"2021-12-01",2021
"21-Dec",대구,계,3434,1156597,51064,1211095,"2021-12-01",2021
"21-Dec",인천,강화군,352,36321,16118,52791,"2021-12-01",2021
"21-Dec",인천,계양구,298,121193,181217,302708,"2021-12-01",2021
"21-Dec",인천,남동구,857,250099,47798,298754,"2021-12-01",2021
"21-Dec",인천,동구,100,24485,2642,27227,"2021-12-01",2021
"21-Dec",인천,미추홀구,432,160481,8896,169809,"2021-12-01",2021
"21-Dec",인천,부평구,341,221554,30470,252365,"2021-12-01",2021
"21-Dec",인천,서구,470,257761,11561,269792,"2021-12-01",2021
"21-Dec",인천,연수구,428,199973,8215,208616,"2021-12-01",2021
"21-Dec",인천,옹진군,226,12205,235,12666,"2021-12-01",2021
"21-Dec",인천,중구,690,67643,12344,80677,"2021-12-01",2021
"21-Dec",인천,계,4194,1351715,319496,1675405,"2021-12-01",2021
"21-Dec",광주,광산구,526,197767,12637,210930,"2021-12-01",2021
"21-Dec",광주,남구,218,92452,2923,95593,"2021-12-01",2021
"21-Dec",광주,동구,234,43602,1326,45162,"2021-12-01",2021
"21-Dec",광주,북구,614,190861,8919,200394,"2021-12-01",2021
"21-Dec",광주,서구,717,141574,6413,148704,"2021-12-01",2021
"21-Dec",광주,계,2309,666256,32218,700783,"2021-12-01",2021
"21-Dec",대전,대덕구,240,86504,6867,93611,"2021-12-01",2021
"21-Dec",대전,동구,257,91350,4729,96336,"2021-12-01",2021
"21-Dec",대전,서구,810,206907,8193,215910,"2021-12-01",2021
"21-Dec",대전,유성구,370,179581,5124,185075,"2021-12-01",2021
"21-Dec",대전,중구,235,95987,5548,101770,"2021-12-01",2021
"21-Dec",대전,계,1912,660329,30461,692702,"2021-12-01",2021
"21-Dec",울산,남구,725,153743,7444,161912,"2021-12-01",2021
"21-Dec",울산,동구,190,61924,1096,63210,"2021-12-01",2021
"21-Dec",울산,북구,224,116873,3431,120528,"2021-12-01",2021
"21-Dec",울산,울주군,421,125094,7076,132591,"2021-12-01",2021
"21-Dec",울산,중구,319,100321,2548,103188,"2021-12-01",2021
"21-Dec",울산,계,1879,557955,21595,581429,"2021-12-01",2021
"21-Dec",세종,세종특별자치시,848,181013,3181,185042,"2021-12-01",2021
"21-Dec",세종,계,848,181013,3181,185042,"2021-12-01",2021
"21-Dec",경기,가평군,387,31440,596,32423,"2021-12-01",2021
"21-Dec",경기,고양시 덕양구,670,184286,4018,188974,"2021-12-01",2021
"21-Dec",경기,고양시 일산동구,278,126147,5361,131786,"2021-12-01",2021
"21-Dec",경기,고양시 일산서구,133,116571,4519,121223,"2021-12-01",2021
"21-Dec",경기,과천시,732,27090,706,28528,"2021-12-01",2021
"21-Dec",경기,광명시,312,100584,4453,105349,"2021-12-01",2021
"21-Dec",경기,광주시,394,196099,8586,205079,"2021-12-01",2021
"21-Dec",경기,구리시,259,70233,2785,73277,"2021-12-01",2021
"21-Dec",경기,군포시,297,98346,5177,103820,"2021-12-01",2021
"21-Dec",경기,김포시,532,229690,8108,238330,"2021-12-01",2021
"21-Dec",경기,남양주시,763,308438,8694,317895,"2021-12-01",2021
"21-Dec",경기,동두천시,214,38637,1458,40309,"2021-12-01",2021
"21-Dec",경기,부천시,713,296277,12221,309211,"2021-12-01",2021
"21-Dec",경기,성남시 분당구,374,187776,6987,195137,"2021-12-01",2021
"21-Dec",경기,성남시 수정구,352,77364,2637,80353,"2021-12-01",2021
"21-Dec",경기,성남시 중원구,347,71371,3978,75696,"2021-12-01",2021
"21-Dec",경기,수원시 권선구,480,193607,9071,203158,"2021-12-01",2021
"21-Dec",경기,수원시 영통구,227,147261,3082,150570,"2021-12-01",2021
"21-Dec",경기,수원시 장안구,475,103471,3755,107701,"2021-12-01",2021
"21-Dec",경기,수원시 팔달구,506,73186,2984,76676,"2021-12-01",2021
"21-Dec",경기,시흥시,474,253983,8254,262711,"2021-12-01",2021
"21-Dec",경기,안산시 단원구,561,157817,8118,166496,"2021-12-01",2021
"21-Dec",경기,안산시 상록구,180,144572,5061,149813,"2021-12-01",2021
"21-Dec",경기,안성시,402,108712,4637,113751,"2021-12-01",2021
"21-Dec",경기,안양시 동안구,403,117532,6454,124389,"2021-12-01",2021
"21-Dec",경기,안양시 만안구,161,84448,3919,88528,"2021-12-01",2021
"21-Dec",경기,양주시,395,111702,3392,115489,"2021-12-01",2021
"21-Dec",경기,양평군,580,61947,1838,64365,"2021-12-01",2021
"21-Dec",경기,여주시,457,64335,7319,72111,"2021-12-01",2021
"21-Dec",경기,연천군,310,23930,5252,29492,"2021-12-01",2021
"21-Dec",경기,오산시,220,108678,3877,112775,"2021-12-01",2021
"21-Dec",경기,용인시 기흥구,128,190927,6685,197740,"2021-12-01",2021
"21-Dec",경기,용인시 수지구,50,146276,2464,148790,"2021-12-01",2021
"21-Dec",경기,용인시 처인구,790,134585,7869,143244,"2021-12-01",2021
"21-Dec",경기,의왕시,307,65961,2933,69201,"2021-12-01",2021
"21-Dec",경기,의정부시,746,166442,5354,172542,"2021-12-01",2021
"21-Dec",경기,이천시,420,116621,6268,123309,"2021-12-01",2021
"21-Dec",경기,파주시,528,224750,10694,235972,"2021-12-01",2021
"21-Dec",경기,평택시,752,299449,12794,312995,"2021-12-01",2021
"21-Dec",경기,포천시,403,88023,9919,98345,"2021-12-01",2021
"21-Dec",경기,하남시,413,133041,3296,136750,"2021-12-01",2021
"21-Dec",경기,화성시,942,466479,12728,480149,"2021-12-01",2021
"21-Dec",경기,계,18067,5948084,238301,6204452,"2021-12-01",2021
"21-Dec",강원,강릉시,542,109904,4600,115046,"2021-12-01",2021
"21-Dec",강원,고성군,194,15033,228,15455,"2021-12-01",2021
"21-Dec",강원,동해시,320,46118,1493,47931,"2021-12-01",2021
"21-Dec",강원,삼척시,397,32430,757,33584,"2021-12-01",2021
"21-Dec",강원,속초시,317,39012,1400,40729,"2021-12-01",2021
"21-Dec",강원,양구군,200,12045,138,12383,"2021-12-01",2021
"21-Dec",강원,양양군,191,16139,285,16615,"2021-12-01",2021
"21-Dec",강원,영월군,334,21356,360,22050,"2021-12-01",2021
"21-Dec",강원,원주시,607,179321,5602,185530,"2021-12-01",2021
"21-Dec",강원,인제군,220,18941,307,19468,"2021-12-01",2021
"21-Dec",강원,정선군,339,20736,473,21548,"2021-12-01",2021
"21-Dec",강원,철원군,248,24285,331,24864,"2021-12-01",2021
"21-Dec",강원,춘천시,848,135855,6290,142993,"2021-12-01",2021
"21-Dec",강원,태백시,223,19866,742,20831,"2021-12-01",2021
"21-Dec",강원,평창군,302,25788,481,26571,"2021-12-01",2021
"21-Dec",강원,홍천군,427,39315,1035,40777,"2021-12-01",2021
"21-Dec",강원,화천군,236,13178,183,13597,"2021-12-01",2021
"21-Dec",강원,횡성군,263,27173,738,28174,"2021-12-01",2021
"21-Dec",강원,계,6208,796495,25443,828146,"2021-12-01",2021
"21-Dec",충북,괴산군,217,23557,410,24184,"2021-12-01",2021
"21-Dec",충북,단양군,233,15643,782,16658,"2021-12-01",2021
"21-Dec",충북,보은군,236,18198,994,19428,"2021-12-01",2021
"21-Dec",충북,영동군,256,25100,413,25769,"2021-12-01",2021
"21-Dec",충북,옥천군,218,27616,1154,28988,"2021-12-01",2021
"21-Dec",충북,음성군,256,59328,1968,61552,"2021-12-01",2021
"21-Dec",충북,제천시,341,67705,3459,71505,"2021-12-01",2021
"21-Dec",충북,증평군,90,19418,753,20261,"2021-12-01",2021
"21-Dec",충북,진천군,222,51088,1337,52647,"2021-12-01",2021
"21-Dec",충북,청원군,1,19,0,20,"2021-12-01",2021
"21-Dec",충북,청주시 상당구,505,93675,2684,96864,"2021-12-01",2021
"21-Dec",충북,청주시 서원구,238,101765,4311,106314,"2021-12-01",2021
"21-Dec",충북,청주시 청원구,373,104206,4491,109070,"2021-12-01",2021
"21-Dec",충북,청주시 흥덕구,365,132084,7416,139865,"2021-12-01",2021
"21-Dec",충북,충주시,630,111219,7327,119176,"2021-12-01",2021
"21-Dec",충북,계,4181,850621,37499,892301,"2021-12-01",2021
"21-Dec",충남,계룡시,157,22763,550,23470,"2021-12-01",2021
"21-Dec",충남,공주시,581,54093,2699,57373,"2021-12-01",2021
"21-Dec",충남,금산군,204,28582,2183,30969,"2021-12-01",2021
"21-Dec",충남,논산시,423,61209,2393,64025,"2021-12-01",2021
"21-Dec",충남,당진시,404,97034,4022,101460,"2021-12-01",2021
"21-Dec",충남,보령시,419,52764,1365,54548,"2021-12-01",2021
"21-Dec",충남,부여군,304,34361,1180,35845,"2021-12-01",2021
"21-Dec",충남,서산시,423,97031,3619,101073,"2021-12-01",2021
"21-Dec",충남,서천군,239,27100,817,28156,"2021-12-01",2021
"21-Dec",충남,아산시,538,174540,7101,182179,"2021-12-01",2021
"21-Dec",충남,예산군,426,43426,1392,45244,"2021-12-01",2021
"21-Dec",충남,천안시 동남구,290,132438,5165,137893,"2021-12-01",2021
"21-Dec",충남,천안시 서북구,535,199589,5528,205652,"2021-12-01",2021
"21-Dec",충남,청양군,253,16921,822,17996,"2021-12-01",2021
"21-Dec",충남,태안군,314,34364,572,35250,"2021-12-01",2021
"21-Dec",충남,홍성군,419,53388,1410,55217,"2021-12-01",2021
"21-Dec",충남,계,5929,1129603,40818,1176350,"2021-12-01",2021
"21-Dec",전북,고창군,312,30670,584,31566,"2021-12-01",2021
"21-Dec",전북,군산시,556,132231,6408,139195,"2021-12-01",2021
"21-Dec",전북,김제시,290,45705,1958,47953,"2021-12-01",2021
"21-Dec",전북,남원시,418,41245,3650,45313,"2021-12-01",2021
"21-Dec",전북,무주군,197,12990,396,13583,"2021-12-01",2021
"21-Dec",전북,부안군,266,27390,609,28265,"2021-12-01",2021
"21-Dec",전북,순창군,229,14661,146,15036,"2021-12-01",2021
"21-Dec",전북,완주군,423,52195,3147,55765,"2021-12-01",2021
"21-Dec",전북,익산시,527,136999,5877,143403,"2021-12-01",2021
"21-Dec",전북,임실군,225,14320,434,14979,"2021-12-01",2021
"21-Dec",전북,장수군,246,12251,180,12677,"2021-12-01",2021
"21-Dec",전북,전주시 덕진구,338,173841,6888,181067,"2021-12-01",2021
"21-Dec",전북,전주시 완산구,778,152291,4194,157263,"2021-12-01",2021
"21-Dec",전북,정읍시,359,55054,3698,59111,"2021-12-01",2021
"21-Dec",전북,진안군,266,14238,240,14744,"2021-12-01",2021
"21-Dec",전북,계,5430,916081,38409,959920,"2021-12-01",2021
"21-Dec",전남,강진군,235,18609,1061,19905,"2021-12-01",2021
"21-Dec",전남,고흥군,315,32437,588,33340,"2021-12-01",2021
"21-Dec",전남,곡성군,161,15011,715,15887,"2021-12-01",2021
"21-Dec",전남,광양시,253,84728,6027,91008,"2021-12-01",2021
"21-Dec",전남,구례군,145,13281,735,14161,"2021-12-01",2021
"21-Dec",전남,나주시,482,66056,3195,69733,"2021-12-01",2021
"21-Dec",전남,담양군,224,27461,1659,29344,"2021-12-01",2021
"21-Dec",전남,목포시,419,94524,5461,100404,"2021-12-01",2021
"21-Dec",전남,무안군,568,49855,1097,51520,"2021-12-01",2021
"21-Dec",전남,보성군,227,21679,11428,33334,"2021-12-01",2021
"21-Dec",전남,순천시,519,141763,5299,147581,"2021-12-01",2021
"21-Dec",전남,신안군,331,21705,83545,105581,"2021-12-01",2021
"21-Dec",전남,여수시,539,132386,7282,140207,"2021-12-01",2021
"21-Dec",전남,영광군,207,28042,770,29019,"2021-12-01",2021
"21-Dec",전남,영암군,283,33700,2392,36375,"2021-12-01",2021
"21-Dec",전남,완도군,288,25558,539,26385,"2021-12-01",2021
"21-Dec",전남,장성군,212,26715,1266,28193,"2021-12-01",2021
"21-Dec",전남,장흥군,259,20128,447,20834,"2021-12-01",2021
"21-Dec",전남,진도군,172,17090,289,17551,"2021-12-01",2021
"21-Dec",전남,함평군,214,18273,30763,49250,"2021-12-01",2021
"21-Dec",전남,해남군,346,39722,36983,77051,"2021-12-01",2021
"21-Dec",전남,화순군,234,33295,2090,35619,"2021-12-01",2021
"21-Dec",전남,계,6633,962018,203631,1172282,"2021-12-01",2021
"21-Dec",경북,경산시,324,139767,4409,144500,"2021-12-01",2021
"21-Dec",경북,경주시,596,142527,4598,147721,"2021-12-01",2021
"21-Dec",경북,고령군,174,20465,680,21319,"2021-12-01",2021
"21-Dec",경북,구미시,558,214267,7279,222104,"2021-12-01",2021
"21-Dec",경북,군위군,123,15021,308,15452,"2021-12-01",2021
"21-Dec",경북,김천시,404,75449,1984,77837,"2021-12-01",2021
"21-Dec",경북,문경시,284,37201,855,38340,"2021-12-01",2021
"21-Dec",경북,봉화군,208,18149,204,18561,"2021-12-01",2021
"21-Dec",경북,상주시,391,53175,1867,55433,"2021-12-01",2021
"21-Dec",경북,성주군,201,30968,1299,32468,"2021-12-01",2021
"21-Dec",경북,안동시,742,82880,2738,86360,"2021-12-01",2021
"21-Dec",경북,영덕군,259,18987,302,19548,"2021-12-01",2021
"21-Dec",경북,영양군,143,9884,112,10139,"2021-12-01",2021
"21-Dec",경북,영주시,381,55727,1528,57636,"2021-12-01",2021
"21-Dec",경북,영천시,328,60389,2587,63304,"2021-12-01",2021
"21-Dec",경북,예천군,276,30602,495,31373,"2021-12-01",2021
"21-Dec",경북,울릉군,160,5236,588,5984,"2021-12-01",2021
"21-Dec",경북,울진군,316,26387,360,27063,"2021-12-01",2021
"21-Dec",경북,의성군,315,31078,1081,32474,"2021-12-01",2021
"21-Dec",경북,청도군,220,25183,938,26341,"2021-12-01",2021
"21-Dec",경북,청송군,195,15920,208,16323,"2021-12-01",2021
"21-Dec",경북,칠곡군,303,68933,2407,71643,"2021-12-01",2021
"21-Dec",경북,포항시 남구,447,122836,8361,131644,"2021-12-01",2021
"21-Dec",경북,포항시 북구,340,141681,3612,145633,"2021-12-01",2021
"21-Dec",경북,계,7688,1442712,48800,1499200,"2021-12-01",2021
"21-Dec",경남,거제시,367,106585,2132,109084,"2021-12-01",2021
"21-Dec",경남,거창군,272,32723,768,33763,"2021-12-01",2021
"21-Dec",경남,고성군,230,26529,561,27320,"2021-12-01",2021
"21-Dec",경남,김해시,657,277153,7419,285229,"2021-12-01",2021
"21-Dec",경남,남해군,275,20114,454,20843,"2021-12-01",2021
"21-Dec",경남,밀양시,330,56348,3927,60605,"2021-12-01",2021
"21-Dec",경남,사천시,321,56838,1526,58685,"2021-12-01",2021
"21-Dec",경남,산청군,251,20409,779,21439,"2021-12-01",2021
"21-Dec",경남,양산시,421,168718,10401,179540,"2021-12-01",2021
"21-Dec",경남,의령군,214,14738,773,15725,"2021-12-01",2021
"21-Dec",경남,진주시,643,167396,6476,174515,"2021-12-01",2021
"21-Dec",경남,창녕군,227,35858,749,36834,"2021-12-01",2021
"21-Dec",경남,창원시 마산합포구,331,95301,2842,98474,"2021-12-01",2021
"21-Dec",경남,창원시 마산회원구,180,96860,5205,102245,"2021-12-01",2021
"21-Dec",경남,창원시 성산구,650,150351,51451,202452,"2021-12-01",2021
"21-Dec",경남,창원시 의창구,431,116784,3509,120724,"2021-12-01",2021
"21-Dec",경남,창원시 진해구,218,93814,1927,95959,"2021-12-01",2021
"21-Dec",경남,통영시,320,52515,1404,54239,"2021-12-01",2021
"21-Dec",경남,하동군,223,24056,383,24662,"2021-12-01",2021
"21-Dec",경남,함안군,191,43832,21082,65105,"2021-12-01",2021
"21-Dec",경남,함양군,220,19553,431,20204,"2021-12-01",2021
"21-Dec",경남,합천군,282,23511,610,24403,"2021-12-01",2021
"21-Dec",경남,계,7254,1699986,124809,1832049,"2021-12-01",2021
"21-Dec",제주,서귀포시,792,105380,1990,108162,"2021-12-01",2021
"21-Dec",제주,제주시,1634,290953,257845,550432,"2021-12-01",2021
"21-Dec",제주,계,2426,396333,259835,658594,"2021-12-01",2021
"22-Jan",서울,강남구,399,218900,20690,239989,"2022-01-01",2022
"22-Jan",서울,강동구,305,143231,8547,152083,"2022-01-01",2022
"22-Jan",서울,강북구,310,70937,4236,75483,"2022-01-01",2022
"22-Jan",서울,강서구,344,186673,18226,205243,"2022-01-01",2022
"22-Jan",서울,관악구,307,112357,5623,118287,"2022-01-01",2022
"22-Jan",서울,광진구,304,92831,5728,98863,"2022-01-01",2022
"22-Jan",서울,구로구,291,132148,13415,145854,"2022-01-01",2022
"22-Jan",서울,금천구,165,83746,6411,90322,"2022-01-01",2022
"22-Jan",서울,노원구,319,143247,8911,152477,"2022-01-01",2022
"22-Jan",서울,도봉구,286,88086,7249,95621,"2022-01-01",2022
"22-Jan",서울,동대문구,316,93371,4884,98571,"2022-01-01",2022
"22-Jan",서울,동작구,329,103297,2779,106405,"2022-01-01",2022
"22-Jan",서울,마포구,342,113653,7305,121300,"2022-01-01",2022
"22-Jan",서울,서대문구,455,83310,5666,89431,"2022-01-01",2022
"22-Jan",서울,서초구,524,165634,10690,176848,"2022-01-01",2022
"22-Jan",서울,성동구,347,93530,12649,106526,"2022-01-01",2022
"22-Jan",서울,성북구,298,115714,5139,121151,"2022-01-01",2022
"22-Jan",서울,송파구,396,233340,13632,247368,"2022-01-01",2022
"22-Jan",서울,양천구,321,142549,8511,151381,"2022-01-01",2022
"22-Jan",서울,영등포구,382,137139,8727,146248,"2022-01-01",2022
"22-Jan",서울,용산구,336,77115,2170,79621,"2022-01-01",2022
"22-Jan",서울,은평구,309,126066,6892,133267,"2022-01-01",2022
"22-Jan",서울,종로구,3879,44577,1884,50340,"2022-01-01",2022
"22-Jan",서울,중구,1224,54301,5231,60756,"2022-01-01",2022
"22-Jan",서울,중랑구,256,104981,9402,114639,"2022-01-01",2022
"22-Jan",서울,계,12744,2960733,204597,3178074,"2022-01-01",2022
"22-Jan",부산,강서구,325,82245,3831,86401,"2022-01-01",2022
"22-Jan",부산,금정구,275,80206,7366,87847,"2022-01-01",2022
"22-Jan",부산,기장군,260,81127,2622,84009,"2022-01-01",2022
"22-Jan",부산,남구,225,91201,9417,100843,"2022-01-01",2022
"22-Jan",부산,동구,188,53155,5101,58444,"2022-01-01",2022
"22-Jan",부산,동래구,177,94423,3646,98246,"2022-01-01",2022
"22-Jan",부산,부산진구,376,121748,21238,143362,"2022-01-01",2022
"22-Jan",부산,북구,234,102313,3687,106234,"2022-01-01",2022
"22-Jan",부산,사상구,284,83139,5709,89132,"2022-01-01",2022
"22-Jan",부산,사하구,270,107494,6317,114081,"2022-01-01",2022
"22-Jan",부산,서구,142,29107,1426,30675,"2022-01-01",2022
"22-Jan",부산,수영구,163,66538,41025,107726,"2022-01-01",2022
"22-Jan",부산,연제구,976,93628,12339,106943,"2022-01-01",2022
"22-Jan",부산,영도구,228,31305,2030,33563,"2022-01-01",2022
"22-Jan",부산,중구,309,30407,7042,37758,"2022-01-01",2022
"22-Jan",부산,해운대구,328,166314,16550,183192,"2022-01-01",2022
"22-Jan",부산,계,4760,1314350,149346,1468456,"2022-01-01",2022
"22-Jan",대구,남구,356,55584,1592,57532,"2022-01-01",2022
"22-Jan",대구,달서구,488,272144,14546,287178,"2022-01-01",2022
"22-Jan",대구,달성군,572,136558,5110,142240,"2022-01-01",2022
"22-Jan",대구,동구,366,155966,11104,167436,"2022-01-01",2022
"22-Jan",대구,북구,508,203745,7557,211810,"2022-01-01",2022
"22-Jan",대구,서구,252,67703,4058,72013,"2022-01-01",2022
"22-Jan",대구,수성구,597,208832,4654,214083,"2022-01-01",2022
"22-Jan",대구,중구,303,57915,2615,60833,"2022-01-01",2022
"22-Jan",대구,계,3442,1158447,51236,1213125,"2022-01-01",2022
"22-Jan",인천,강화군,349,36496,15164,52009,"2022-01-01",2022
"22-Jan",인천,계양구,297,121322,180596,302215,"2022-01-01",2022
"22-Jan",인천,남동구,863,250841,47451,299155,"2022-01-01",2022
"22-Jan",인천,동구,100,24425,2593,27118,"2022-01-01",2022
"22-Jan",인천,미추홀구,433,160709,8913,170055,"2022-01-01",2022
"22-Jan",인천,부평구,341,222002,32915,255258,"2022-01-01",2022
"22-Jan",인천,서구,471,259306,11602,271379,"2022-01-01",2022
"22-Jan",인천,연수구,427,200342,8287,209056,"2022-01-01",2022
"22-Jan",인천,옹진군,225,12262,230,12717,"2022-01-01",2022
"22-Jan",인천,중구,675,67982,12366,81023,"2022-01-01",2022
"22-Jan",인천,계,4181,1355687,320117,1679985,"2022-01-01",2022
"22-Jan",광주,광산구,529,198315,12760,211604,"2022-01-01",2022
"22-Jan",광주,남구,230,92676,2906,95812,"2022-01-01",2022
"22-Jan",광주,동구,233,43618,1082,44933,"2022-01-01",2022
"22-Jan",광주,북구,604,191318,9186,201108,"2022-01-01",2022
"22-Jan",광주,서구,713,142020,6342,149075,"2022-01-01",2022
"22-Jan",광주,계,2309,667947,32276,702532,"2022-01-01",2022
"22-Jan",대전,대덕구,237,87016,6881,94134,"2022-01-01",2022
"22-Jan",대전,동구,248,91278,4761,96287,"2022-01-01",2022
"22-Jan",대전,서구,806,207243,8244,216293,"2022-01-01",2022
"22-Jan",대전,유성구,644,180123,5149,185916,"2022-01-01",2022
"22-Jan",대전,중구,230,95545,5532,101307,"2022-01-01",2022
"22-Jan",대전,계,2165,661205,30567,693937,"2022-01-01",2022
"22-Jan",울산,남구,725,153825,7461,162011,"2022-01-01",2022
"22-Jan",울산,동구,188,62011,1108,63307,"2022-01-01",2022
"22-Jan",울산,북구,225,117409,3431,121065,"2022-01-01",2022
"22-Jan",울산,울주군,421,125381,7072,132874,"2022-01-01",2022
"22-Jan",울산,중구,322,100313,2552,103187,"2022-01-01",2022
"22-Jan",울산,계,1881,558939,21624,582444,"2022-01-01",2022
"22-Jan",세종,세종특별자치시,849,182579,3191,186619,"2022-01-01",2022
"22-Jan",세종,계,849,182579,3191,186619,"2022-01-01",2022
"22-Jan",경기,가평군,388,31502,588,32478,"2022-01-01",2022
"22-Jan",경기,고양시 덕양구,670,184760,4032,189462,"2022-01-01",2022
"22-Jan",경기,고양시 일산동구,278,126243,5295,131816,"2022-01-01",2022
"22-Jan",경기,고양시 일산서구,133,116616,4633,121382,"2022-01-01",2022
"22-Jan",경기,과천시,729,28129,711,29569,"2022-01-01",2022
"22-Jan",경기,광명시,309,100572,4499,105380,"2022-01-01",2022
"22-Jan",경기,광주시,390,196499,8440,205329,"2022-01-01",2022
"22-Jan",경기,구리시,262,70174,2775,73211,"2022-01-01",2022
"22-Jan",경기,군포시,299,98306,5192,103797,"2022-01-01",2022
"22-Jan",경기,김포시,535,230204,8126,238865,"2022-01-01",2022
"22-Jan",경기,남양주시,767,309330,8839,318936,"2022-01-01",2022
"22-Jan",경기,동두천시,216,38701,1459,40376,"2022-01-01",2022
"22-Jan",경기,부천시,714,296418,12303,309435,"2022-01-01",2022
"22-Jan",경기,성남시 분당구,377,188327,7084,195788,"2022-01-01",2022
"22-Jan",경기,성남시 수정구,352,77479,2663,80494,"2022-01-01",2022
"22-Jan",경기,성남시 중원구,347,71384,3988,75719,"2022-01-01",2022
"22-Jan",경기,수원시 권선구,479,195456,9168,205103,"2022-01-01",2022
"22-Jan",경기,수원시 영통구,227,146961,3269,150457,"2022-01-01",2022
"22-Jan",경기,수원시 장안구,482,103506,3805,107793,"2022-01-01",2022
"22-Jan",경기,수원시 팔달구,511,73244,2988,76743,"2022-01-01",2022
"22-Jan",경기,시흥시,471,254578,8298,263347,"2022-01-01",2022
"22-Jan",경기,안산시 단원구,559,158414,7470,166443,"2022-01-01",2022
"22-Jan",경기,안산시 상록구,177,144843,5764,150784,"2022-01-01",2022
"22-Jan",경기,안성시,401,108921,4658,113980,"2022-01-01",2022
"22-Jan",경기,안양시 동안구,402,118722,6517,125641,"2022-01-01",2022
"22-Jan",경기,안양시 만안구,161,84231,3918,88310,"2022-01-01",2022
"22-Jan",경기,양주시,396,111995,3395,115786,"2022-01-01",2022
"22-Jan",경기,양평군,578,62150,1846,64574,"2022-01-01",2022
"22-Jan",경기,여주시,457,64578,7273,72308,"2022-01-01",2022
"22-Jan",경기,연천군,311,24028,5261,29600,"2022-01-01",2022
"22-Jan",경기,오산시,216,109073,3881,113170,"2022-01-01",2022
"22-Jan",경기,용인시 기흥구,127,191391,6697,198215,"2022-01-01",2022
"22-Jan",경기,용인시 수지구,52,146329,2484,148865,"2022-01-01",2022
"22-Jan",경기,용인시 처인구,786,134961,7888,143635,"2022-01-01",2022
"22-Jan",경기,의왕시,302,65968,2941,69211,"2022-01-01",2022
"22-Jan",경기,의정부시,750,167048,5408,173206,"2022-01-01",2022
"22-Jan",경기,이천시,416,117062,6328,123806,"2022-01-01",2022
"22-Jan",경기,파주시,529,225964,10707,237200,"2022-01-01",2022
"22-Jan",경기,평택시,755,300950,12837,314542,"2022-01-01",2022
"22-Jan",경기,포천시,404,88296,9824,98524,"2022-01-01",2022
"22-Jan",경기,하남시,414,133593,3289,137296,"2022-01-01",2022
"22-Jan",경기,화성시,940,468027,12847,481814,"2022-01-01",2022
"22-Jan",경기,계,18069,5964933,239388,6222390,"2022-01-01",2022
"22-Jan",강원,강릉시,542,110160,4653,115355,"2022-01-01",2022
"22-Jan",강원,고성군,193,15106,229,15528,"2022-01-01",2022
"22-Jan",강원,동해시,319,46164,1483,47966,"2022-01-01",2022
"22-Jan",강원,삼척시,396,32593,756,33745,"2022-01-01",2022
"22-Jan",강원,속초시,316,39043,1402,40761,"2022-01-01",2022
"22-Jan",강원,양구군,200,12052,139,12391,"2022-01-01",2022
"22-Jan",강원,양양군,191,16187,298,16676,"2022-01-01",2022
"22-Jan",강원,영월군,334,21396,364,22094,"2022-01-01",2022
"22-Jan",강원,원주시,609,180058,5619,186286,"2022-01-01",2022
"22-Jan",강원,인제군,222,19047,297,19566,"2022-01-01",2022
"22-Jan",강원,정선군,338,20769,469,21576,"2022-01-01",2022
"22-Jan",강원,철원군,245,24297,329,24871,"2022-01-01",2022
"22-Jan",강원,춘천시,855,136404,6290,143549,"2022-01-01",2022
"22-Jan",강원,태백시,224,19873,740,20837,"2022-01-01",2022
"22-Jan",강원,평창군,304,25948,498,26750,"2022-01-01",2022
"22-Jan",강원,홍천군,424,39384,1038,40846,"2022-01-01",2022
"22-Jan",강원,화천군,235,13184,185,13604,"2022-01-01",2022
"22-Jan",강원,횡성군,262,27234,718,28214,"2022-01-01",2022
"22-Jan",강원,계,6209,798899,25507,830615,"2022-01-01",2022
"22-Jan",충북,괴산군,214,23320,405,23939,"2022-01-01",2022
"22-Jan",충북,단양군,229,15671,782,16682,"2022-01-01",2022
"22-Jan",충북,보은군,236,18226,985,19447,"2022-01-01",2022
"22-Jan",충북,영동군,250,25138,414,25802,"2022-01-01",2022
"22-Jan",충북,옥천군,211,27703,1152,29066,"2022-01-01",2022
"22-Jan",충북,음성군,257,59478,1979,61714,"2022-01-01",2022
"22-Jan",충북,제천시,340,67805,3453,71598,"2022-01-01",2022
"22-Jan",충북,증평군,91,19568,762,20421,"2022-01-01",2022
"22-Jan",충북,진천군,219,51414,1353,52986,"2022-01-01",2022
"22-Jan",충북,청원군,1,19,0,20,"2022-01-01",2022
"22-Jan",충북,청주시 상당구,501,94094,2678,97273,"2022-01-01",2022
"22-Jan",충북,청주시 서원구,239,101890,4219,106348,"2022-01-01",2022
"22-Jan",충북,청주시 청원구,368,104496,4571,109435,"2022-01-01",2022
"22-Jan",충북,청주시 흥덕구,358,132405,7447,140210,"2022-01-01",2022
"22-Jan",충북,충주시,630,111537,7273,119440,"2022-01-01",2022
"22-Jan",충북,계,4144,852764,37473,894381,"2022-01-01",2022
"22-Jan",충남,계룡시,158,22842,552,23552,"2022-01-01",2022
"22-Jan",충남,공주시,586,54460,2656,57702,"2022-01-01",2022
"22-Jan",충남,금산군,205,28589,2207,31001,"2022-01-01",2022
"22-Jan",충남,논산시,427,61379,2403,64209,"2022-01-01",2022
"22-Jan",충남,당진시,406,97372,4029,101807,"2022-01-01",2022
"22-Jan",충남,보령시,419,52695,1356,54470,"2022-01-01",2022
"22-Jan",충남,부여군,304,34427,1178,35909,"2022-01-01",2022
"22-Jan",충남,서산시,423,97282,3593,101298,"2022-01-01",2022
"22-Jan",충남,서천군,238,27121,812,28171,"2022-01-01",2022
"22-Jan",충남,아산시,542,175469,7100,183111,"2022-01-01",2022
"22-Jan",충남,예산군,426,43533,1389,45348,"2022-01-01",2022
"22-Jan",충남,천안시 동남구,290,132697,5230,138217,"2022-01-01",2022
"22-Jan",충남,천안시 서북구,537,199864,5577,205978,"2022-01-01",2022
"22-Jan",충남,청양군,252,16993,814,18059,"2022-01-01",2022
"22-Jan",충남,태안군,313,34501,567,35381,"2022-01-01",2022
"22-Jan",충남,홍성군,420,53520,1370,55310,"2022-01-01",2022
"22-Jan",충남,계,5946,1132744,40833,1179523,"2022-01-01",2022
"22-Jan",전북,고창군,312,30753,586,31651,"2022-01-01",2022
"22-Jan",전북,군산시,559,132504,6417,139480,"2022-01-01",2022
"22-Jan",전북,김제시,290,45855,1962,48107,"2022-01-01",2022
"22-Jan",전북,남원시,416,41312,3545,45273,"2022-01-01",2022
"22-Jan",전북,무주군,197,13014,395,13606,"2022-01-01",2022
"22-Jan",전북,부안군,266,27492,615,28373,"2022-01-01",2022
"22-Jan",전북,순창군,229,14686,142,15057,"2022-01-01",2022
"22-Jan",전북,완주군,426,52251,3139,55816,"2022-01-01",2022
"22-Jan",전북,익산시,528,137187,5900,143615,"2022-01-01",2022
"22-Jan",전북,임실군,222,14344,428,14994,"2022-01-01",2022
"22-Jan",전북,장수군,247,12289,181,12717,"2022-01-01",2022
"22-Jan",전북,전주시 덕진구,340,174250,6871,181461,"2022-01-01",2022
"22-Jan",전북,전주시 완산구,785,152581,4191,157557,"2022-01-01",2022
"22-Jan",전북,정읍시,359,55253,3677,59289,"2022-01-01",2022
"22-Jan",전북,진안군,266,14309,242,14817,"2022-01-01",2022
"22-Jan",전북,계,5442,918080,38291,961813,"2022-01-01",2022
"22-Jan",전남,강진군,237,18673,1050,19960,"2022-01-01",2022
"22-Jan",전남,고흥군,314,32488,587,33389,"2022-01-01",2022
"22-Jan",전남,곡성군,161,15051,716,15928,"2022-01-01",2022
"22-Jan",전남,광양시,254,85469,6035,91758,"2022-01-01",2022
"22-Jan",전남,구례군,147,13310,733,14190,"2022-01-01",2022
"22-Jan",전남,나주시,482,66276,3161,69919,"2022-01-01",2022
"22-Jan",전남,담양군,221,27547,1672,29440,"2022-01-01",2022
"22-Jan",전남,목포시,419,94820,5450,100689,"2022-01-01",2022
"22-Jan",전남,무안군,564,49861,1095,51520,"2022-01-01",2022
"22-Jan",전남,보성군,228,21711,10636,32575,"2022-01-01",2022
"22-Jan",전남,순천시,515,141669,5297,147481,"2022-01-01",2022
"22-Jan",전남,신안군,330,21734,84855,106919,"2022-01-01",2022
"22-Jan",전남,여수시,539,132781,7296,140616,"2022-01-01",2022
"22-Jan",전남,영광군,207,28159,775,29141,"2022-01-01",2022
"22-Jan",전남,영암군,282,33838,2333,36453,"2022-01-01",2022
"22-Jan",전남,완도군,286,25586,547,26419,"2022-01-01",2022
"22-Jan",전남,장성군,213,26813,1259,28285,"2022-01-01",2022
"22-Jan",전남,장흥군,259,20206,447,20912,"2022-01-01",2022
"22-Jan",전남,진도군,172,17130,290,17592,"2022-01-01",2022
"22-Jan",전남,함평군,210,18286,30349,48845,"2022-01-01",2022
"22-Jan",전남,해남군,348,39840,37208,77396,"2022-01-01",2022
"22-Jan",전남,화순군,233,33370,2081,35684,"2022-01-01",2022
"22-Jan",전남,계,6621,964618,203872,1175111,"2022-01-01",2022
"22-Jan",경북,경산시,324,140163,4383,144870,"2022-01-01",2022
"22-Jan",경북,경주시,595,142798,4594,147987,"2022-01-01",2022
"22-Jan",경북,고령군,175,20545,690,21410,"2022-01-01",2022
"22-Jan",경북,구미시,550,214692,7248,222490,"2022-01-01",2022
"22-Jan",경북,군위군,122,15136,312,15570,"2022-01-01",2022
"22-Jan",경북,김천시,400,75729,1989,78118,"2022-01-01",2022
"22-Jan",경북,문경시,281,37291,872,38444,"2022-01-01",2022
"22-Jan",경북,봉화군,206,18164,207,18577,"2022-01-01",2022
"22-Jan",경북,상주시,389,53359,1869,55617,"2022-01-01",2022
"22-Jan",경북,성주군,200,31099,1297,32596,"2022-01-01",2022
"22-Jan",경북,안동시,745,82978,2769,86492,"2022-01-01",2022
"22-Jan",경북,영덕군,255,19038,305,19598,"2022-01-01",2022
"22-Jan",경북,영양군,142,9892,148,10182,"2022-01-01",2022
"22-Jan",경북,영주시,372,55937,1531,57840,"2022-01-01",2022
"22-Jan",경북,영천시,321,60441,2585,63347,"2022-01-01",2022
"22-Jan",경북,예천군,278,30711,494,31483,"2022-01-01",2022
"22-Jan",경북,울릉군,160,5246,587,5993,"2022-01-01",2022
"22-Jan",경북,울진군,313,26422,357,27092,"2022-01-01",2022
"22-Jan",경북,의성군,314,31161,1081,32556,"2022-01-01",2022
"22-Jan",경북,청도군,222,25272,942,26436,"2022-01-01",2022
"22-Jan",경북,청송군,192,15953,208,16353,"2022-01-01",2022
"22-Jan",경북,칠곡군,304,69050,2406,71760,"2022-01-01",2022
"22-Jan",경북,포항시 남구,439,123100,8344,131883,"2022-01-01",2022
"22-Jan",경북,포항시 북구,339,142096,3602,146037,"2022-01-01",2022
"22-Jan",경북,계,7638,1446273,48820,1502731,"2022-01-01",2022
"22-Jan",경남,거제시,368,106685,2116,109169,"2022-01-01",2022
"22-Jan",경남,거창군,275,32795,766,33836,"2022-01-01",2022
"22-Jan",경남,고성군,232,26608,559,27399,"2022-01-01",2022
"22-Jan",경남,김해시,660,277760,7430,285850,"2022-01-01",2022
"22-Jan",경남,남해군,274,20160,451,20885,"2022-01-01",2022
"22-Jan",경남,밀양시,326,56456,3925,60707,"2022-01-01",2022
"22-Jan",경남,사천시,323,56865,1534,58722,"2022-01-01",2022
"22-Jan",경남,산청군,250,20426,778,21454,"2022-01-01",2022
"22-Jan",경남,양산시,423,169163,10482,180068,"2022-01-01",2022
"22-Jan",경남,의령군,209,14819,771,15799,"2022-01-01",2022
"22-Jan",경남,진주시,641,167753,6474,174868,"2022-01-01",2022
"22-Jan",경남,창녕군,229,35880,745,36854,"2022-01-01",2022
"22-Jan",경남,창원시 마산합포구,329,95086,2846,98261,"2022-01-01",2022
"22-Jan",경남,창원시 마산회원구,180,97168,5268,102616,"2022-01-01",2022
"22-Jan",경남,창원시 성산구,656,151146,51754,203556,"2022-01-01",2022
"22-Jan",경남,창원시 의창구,432,117053,3491,120976,"2022-01-01",2022
"22-Jan",경남,창원시 진해구,216,94179,1947,96342,"2022-01-01",2022
"22-Jan",경남,통영시,320,52557,1392,54269,"2022-01-01",2022
"22-Jan",경남,하동군,225,24092,384,24701,"2022-01-01",2022
"22-Jan",경남,함안군,193,43788,21937,65918,"2022-01-01",2022
"22-Jan",경남,함양군,221,19590,436,20247,"2022-01-01",2022
"22-Jan",경남,합천군,282,23557,613,24452,"2022-01-01",2022
"22-Jan",경남,계,7264,1703586,126099,1836949,"2022-01-01",2022
"22-Jan",제주,서귀포시,788,105557,1988,108333,"2022-01-01",2022
"22-Jan",제주,제주시,1638,291982,260024,553644,"2022-01-01",2022
"22-Jan",제주,계,2426,397539,262012,661977,"2022-01-01",2022
"22-Feb",서울,강남구,398,219032,21236,240666,"2022-02-01",2022
"22-Feb",서울,강동구,301,143117,8539,151957,"2022-02-01",2022
"22-Feb",서울,강북구,310,70757,4221,75288,"2022-02-01",2022
"22-Feb",서울,강서구,343,186668,18146,205157,"2022-02-01",2022
"22-Feb",서울,관악구,306,112289,5655,118250,"2022-02-01",2022
"22-Feb",서울,광진구,304,92910,5755,98969,"2022-02-01",2022
"22-Feb",서울,구로구,288,132080,13222,145590,"2022-02-01",2022
"22-Feb",서울,금천구,165,83821,6414,90400,"2022-02-01",2022
"22-Feb",서울,노원구,319,143254,8916,152489,"2022-02-01",2022
"22-Feb",서울,도봉구,284,88073,7284,95641,"2022-02-01",2022
"22-Feb",서울,동대문구,314,93382,4903,98599,"2022-02-01",2022
"22-Feb",서울,동작구,306,103145,2758,106209,"2022-02-01",2022
"22-Feb",서울,마포구,338,113557,7303,121198,"2022-02-01",2022
"22-Feb",서울,서대문구,454,83485,5560,89499,"2022-02-01",2022
"22-Feb",서울,서초구,522,165475,10698,176695,"2022-02-01",2022
"22-Feb",서울,성동구,371,93460,12540,106371,"2022-02-01",2022
"22-Feb",서울,성북구,298,116124,5106,121528,"2022-02-01",2022
"22-Feb",서울,송파구,393,234111,13747,248251,"2022-02-01",2022
"22-Feb",서울,양천구,321,142465,8487,151273,"2022-02-01",2022
"22-Feb",서울,영등포구,383,137152,8747,146282,"2022-02-01",2022
"22-Feb",서울,용산구,336,77069,2154,79559,"2022-02-01",2022
"22-Feb",서울,은평구,304,126069,6972,133345,"2022-02-01",2022
"22-Feb",서울,종로구,3877,44455,2551,50883,"2022-02-01",2022
"22-Feb",서울,중구,1249,53959,5172,60380,"2022-02-01",2022
"22-Feb",서울,중랑구,249,105213,9387,114849,"2022-02-01",2022
"22-Feb",서울,계,12733,2961122,205473,3179328,"2022-02-01",2022
"22-Feb",부산,강서구,325,82369,4100,86794,"2022-02-01",2022
"22-Feb",부산,금정구,275,79987,7349,87611,"2022-02-01",2022
"22-Feb",부산,기장군,257,81297,2665,84219,"2022-02-01",2022
"22-Feb",부산,남구,225,91137,9423,100785,"2022-02-01",2022
"22-Feb",부산,동구,187,53679,5337,59203,"2022-02-01",2022
"22-Feb",부산,동래구,172,95721,3674,99567,"2022-02-01",2022
"22-Feb",부산,부산진구,374,121809,21206,143389,"2022-02-01",2022
"22-Feb",부산,북구,233,102165,3696,106094,"2022-02-01",2022
"22-Feb",부산,사상구,283,83091,5698,89072,"2022-02-01",2022
"22-Feb",부산,사하구,269,107767,6336,114372,"2022-02-01",2022
"22-Feb",부산,서구,141,29063,1431,30635,"2022-02-01",2022
"22-Feb",부산,수영구,163,66496,41963,108622,"2022-02-01",2022
"22-Feb",부산,연제구,977,93754,12475,107206,"2022-02-01",2022
"22-Feb",부산,영도구,228,31266,2028,33522,"2022-02-01",2022
"22-Feb",부산,중구,310,30625,7006,37941,"2022-02-01",2022
"22-Feb",부산,해운대구,327,166341,16914,183582,"2022-02-01",2022
"22-Feb",부산,계,4746,1316567,151301,1472614,"2022-02-01",2022
"22-Feb",대구,남구,355,55558,1590,57503,"2022-02-01",2022
"22-Feb",대구,달서구,487,272471,14637,287595,"2022-02-01",2022
"22-Feb",대구,달성군,573,136598,5128,142299,"2022-02-01",2022
"22-Feb",대구,동구,363,156066,10747,167176,"2022-02-01",2022
"22-Feb",대구,북구,507,203932,7577,212016,"2022-02-01",2022
"22-Feb",대구,서구,252,67641,4439,72332,"2022-02-01",2022
"22-Feb",대구,수성구,595,209522,4646,214763,"2022-02-01",2022
"22-Feb",대구,중구,304,57702,2653,60659,"2022-02-01",2022
"22-Feb",대구,계,3436,1159490,51417,1214343,"2022-02-01",2022
"22-Feb",인천,강화군,350,36625,14217,51192,"2022-02-01",2022
"22-Feb",인천,계양구,297,121219,180851,302367,"2022-02-01",2022
"22-Feb",인천,남동구,861,246402,45597,292860,"2022-02-01",2022
"22-Feb",인천,동구,100,24288,2584,26972,"2022-02-01",2022
"22-Feb",인천,미추홀구,434,160685,8939,170058,"2022-02-01",2022
"22-Feb",인천,부평구,341,222458,33458,256257,"2022-02-01",2022
"22-Feb",인천,서구,468,266415,13239,280122,"2022-02-01",2022
"22-Feb",인천,연수구,427,200577,8383,209387,"2022-02-01",2022
"22-Feb",인천,옹진군,225,12353,222,12800,"2022-02-01",2022
"22-Feb",인천,중구,674,68424,12297,81395,"2022-02-01",2022
"22-Feb",인천,계,4177,1359446,319787,1683410,"2022-02-01",2022
"22-Feb",광주,광산구,528,198305,12726,211559,"2022-02-01",2022
"22-Feb",광주,남구,231,92722,2910,95863,"2022-02-01",2022
"22-Feb",광주,동구,236,43697,1069,45002,"2022-02-01",2022
"22-Feb",광주,북구,594,191658,9220,201472,"2022-02-01",2022
"22-Feb",광주,서구,721,142164,6392,149277,"2022-02-01",2022
"22-Feb",광주,계,2310,668546,32317,703173,"2022-02-01",2022
"22-Feb",대전,대덕구,236,87222,6878,94336,"2022-02-01",2022
"22-Feb",대전,동구,246,91250,4754,96250,"2022-02-01",2022
"22-Feb",대전,서구,808,207470,8266,216544,"2022-02-01",2022
"22-Feb",대전,유성구,654,180363,5250,186267,"2022-02-01",2022
"22-Feb",대전,중구,230,95541,5545,101316,"2022-02-01",2022
"22-Feb",대전,계,2174,661846,30693,694713,"2022-02-01",2022
"22-Feb",울산,남구,722,153946,7439,162107,"2022-02-01",2022
"22-Feb",울산,동구,188,61890,1109,63187,"2022-02-01",2022
"22-Feb",울산,북구,224,117686,3431,121341,"2022-02-01",2022
"22-Feb",울산,울주군,426,125797,7116,133339,"2022-02-01",2022
"22-Feb",울산,중구,319,100274,2556,103149,"2022-02-01",2022
"22-Feb",울산,계,1879,559593,21651,583123,"2022-02-01",2022
"22-Feb",세종,세종특별자치시,851,183640,3204,187695,"2022-02-01",2022
"22-Feb",세종,계,851,183640,3204,187695,"2022-02-01",2022
"22-Feb",경기,가평군,386,31538,586,32510,"2022-02-01",2022
"22-Feb",경기,고양시 덕양구,670,185126,4016,189812,"2022-02-01",2022
"22-Feb",경기,고양시 일산동구,277,126256,5315,131848,"2022-02-01",2022
"22-Feb",경기,고양시 일산서구,130,116606,4629,121365,"2022-02-01",2022
"22-Feb",경기,과천시,729,28575,707,30011,"2022-02-01",2022
"22-Feb",경기,광명시,309,100421,4489,105219,"2022-02-01",2022
"22-Feb",경기,광주시,393,196904,8458,205755,"2022-02-01",2022
"22-Feb",경기,구리시,266,70214,2777,73257,"2022-02-01",2022
"22-Feb",경기,군포시,298,98279,5149,103726,"2022-02-01",2022
"22-Feb",경기,김포시,538,230498,8128,239164,"2022-02-01",2022
"22-Feb",경기,남양주시,771,309831,8850,319452,"2022-02-01",2022
"22-Feb",경기,동두천시,214,38751,1470,40435,"2022-02-01",2022
"22-Feb",경기,부천시,716,296068,12349,309133,"2022-02-01",2022
"22-Feb",경기,성남시 분당구,376,188579,7044,195999,"2022-02-01",2022
"22-Feb",경기,성남시 수정구,351,77418,2615,80384,"2022-02-01",2022
"22-Feb",경기,성남시 중원구,346,71370,4043,75759,"2022-02-01",2022
"22-Feb",경기,수원시 권선구,478,196944,9195,206617,"2022-02-01",2022
"22-Feb",경기,수원시 영통구,227,146794,3269,150290,"2022-02-01",2022
"22-Feb",경기,수원시 장안구,480,103575,3829,107884,"2022-02-01",2022
"22-Feb",경기,수원시 팔달구,511,73193,2989,76693,"2022-02-01",2022
"22-Feb",경기,시흥시,468,254880,8328,263676,"2022-02-01",2022
"22-Feb",경기,안산시 단원구,560,158472,7450,166482,"2022-02-01",2022
"22-Feb",경기,안산시 상록구,177,144946,5750,150873,"2022-02-01",2022
"22-Feb",경기,안성시,402,108915,4657,113974,"2022-02-01",2022
"22-Feb",경기,안양시 동안구,402,119524,6563,126489,"2022-02-01",2022
"22-Feb",경기,안양시 만안구,158,84231,3921,88310,"2022-02-01",2022
"22-Feb",경기,양주시,396,112252,3410,116058,"2022-02-01",2022
"22-Feb",경기,양평군,578,62377,1852,64807,"2022-02-01",2022
"22-Feb",경기,여주시,457,64837,7295,72589,"2022-02-01",2022
"22-Feb",경기,연천군,310,24041,5266,29617,"2022-02-01",2022
"22-Feb",경기,오산시,216,109590,3897,113703,"2022-02-01",2022
"22-Feb",경기,용인시 기흥구,127,191649,6714,198490,"2022-02-01",2022
"22-Feb",경기,용인시 수지구,52,146350,2421,148823,"2022-02-01",2022
"22-Feb",경기,용인시 처인구,783,135208,7894,143885,"2022-02-01",2022
"22-Feb",경기,의왕시,301,66002,2945,69248,"2022-02-01",2022
"22-Feb",경기,의정부시,748,167237,5408,173393,"2022-02-01",2022
"22-Feb",경기,이천시,418,117217,6319,123954,"2022-02-01",2022
"22-Feb",경기,파주시,529,226811,10750,238090,"2022-02-01",2022
"22-Feb",경기,평택시,754,302131,12933,315818,"2022-02-01",2022
"22-Feb",경기,포천시,394,88347,9715,98456,"2022-02-01",2022
"22-Feb",경기,하남시,413,134196,3337,137946,"2022-02-01",2022
"22-Feb",경기,화성시,945,469148,12900,482993,"2022-02-01",2022
"22-Feb",경기,계,18054,5975301,239632,6232987,"2022-02-01",2022
"22-Feb",강원,강릉시,535,110292,4637,115464,"2022-02-01",2022
"22-Feb",강원,고성군,193,15185,229,15607,"2022-02-01",2022
"22-Feb",강원,동해시,318,46225,1474,48017,"2022-02-01",2022
"22-Feb",강원,삼척시,397,32737,756,33890,"2022-02-01",2022
"22-Feb",강원,속초시,312,39104,1401,40817,"2022-02-01",2022
"22-Feb",강원,양구군,200,12077,140,12417,"2022-02-01",2022
"22-Feb",강원,양양군,192,16218,304,16714,"2022-02-01",2022
"22-Feb",강원,영월군,331,21455,362,22148,"2022-02-01",2022
"22-Feb",강원,원주시,607,180680,5609,186896,"2022-02-01",2022
"22-Feb",강원,인제군,220,19090,294,19604,"2022-02-01",2022
"22-Feb",강원,정선군,337,20788,474,21599,"2022-02-01",2022
"22-Feb",강원,철원군,241,24305,328,24874,"2022-02-01",2022
"22-Feb",강원,춘천시,846,136753,6303,143902,"2022-02-01",2022
"22-Feb",강원,태백시,223,19819,737,20779,"2022-02-01",2022
"22-Feb",강원,평창군,301,26046,504,26851,"2022-02-01",2022
"22-Feb",강원,홍천군,425,39470,1035,40930,"2022-02-01",2022
"22-Feb",강원,화천군,235,13202,184,13621,"2022-02-01",2022
"22-Feb",강원,횡성군,258,27329,730,28317,"2022-02-01",2022
"22-Feb",강원,계,6171,800775,25501,832447,"2022-02-01",2022
"22-Feb",충북,괴산군,215,23376,412,24003,"2022-02-01",2022
"22-Feb",충북,단양군,231,15701,778,16710,"2022-02-01",2022
"22-Feb",충북,보은군,236,18267,986,19489,"2022-02-01",2022
"22-Feb",충북,영동군,254,25259,410,25923,"2022-02-01",2022
"22-Feb",충북,옥천군,211,27737,1153,29101,"2022-02-01",2022
"22-Feb",충북,음성군,260,59697,1990,61947,"2022-02-01",2022
"22-Feb",충북,제천시,338,67873,3459,71670,"2022-02-01",2022
"22-Feb",충북,증평군,92,19687,771,20550,"2022-02-01",2022
"22-Feb",충북,진천군,220,51689,1368,53277,"2022-02-01",2022
"22-Feb",충북,청원군,1,19,0,20,"2022-02-01",2022
"22-Feb",충북,청주시 상당구,502,94496,2685,97683,"2022-02-01",2022
"22-Feb",충북,청주시 서원구,237,101896,4208,106341,"2022-02-01",2022
"22-Feb",충북,청주시 청원구,371,104742,4587,109700,"2022-02-01",2022
"22-Feb",충북,청주시 흥덕구,359,132612,7502,140473,"2022-02-01",2022
"22-Feb",충북,충주시,633,111735,7374,119742,"2022-02-01",2022
"22-Feb",충북,계,4160,854786,37683,896629,"2022-02-01",2022
"22-Feb",충남,계룡시,157,22943,560,23660,"2022-02-01",2022
"22-Feb",충남,공주시,593,54639,2663,57895,"2022-02-01",2022
"22-Feb",충남,금산군,203,28647,2269,31119,"2022-02-01",2022
"22-Feb",충남,논산시,407,61474,2401,64282,"2022-02-01",2022
"22-Feb",충남,당진시,402,97523,4047,101972,"2022-02-01",2022
"22-Feb",충남,보령시,418,52690,1356,54464,"2022-02-01",2022
"22-Feb",충남,부여군,304,34467,1169,35940,"2022-02-01",2022
"22-Feb",충남,서산시,426,97468,3566,101460,"2022-02-01",2022
"22-Feb",충남,서천군,238,27160,811,28209,"2022-02-01",2022
"22-Feb",충남,아산시,538,176886,7127,184551,"2022-02-01",2022
"22-Feb",충남,예산군,428,43564,1385,45377,"2022-02-01",2022
"22-Feb",충남,천안시 동남구,289,132914,5255,138458,"2022-02-01",2022
"22-Feb",충남,천안시 서북구,536,199748,5596,205880,"2022-02-01",2022
"22-Feb",충남,청양군,252,17058,807,18117,"2022-02-01",2022
"22-Feb",충남,태안군,311,34546,560,35417,"2022-02-01",2022
"22-Feb",충남,홍성군,413,53641,1371,55425,"2022-02-01",2022
"22-Feb",충남,계,5915,1135368,40943,1182226,"2022-02-01",2022
"22-Feb",전북,고창군,312,30842,585,31739,"2022-02-01",2022
"22-Feb",전북,군산시,556,132643,6382,139581,"2022-02-01",2022
"22-Feb",전북,김제시,290,45994,1952,48236,"2022-02-01",2022
"22-Feb",전북,남원시,415,41394,3447,45256,"2022-02-01",2022
"22-Feb",전북,무주군,197,13073,396,13666,"2022-02-01",2022
"22-Feb",전북,부안군,269,27568,620,28457,"2022-02-01",2022
"22-Feb",전북,순창군,229,14746,149,15124,"2022-02-01",2022
"22-Feb",전북,완주군,424,52395,3137,55956,"2022-02-01",2022
"22-Feb",전북,익산시,531,137297,5911,143739,"2022-02-01",2022
"22-Feb",전북,임실군,223,14407,427,15057,"2022-02-01",2022
"22-Feb",전북,장수군,246,12326,178,12750,"2022-02-01",2022
"22-Feb",전북,전주시 덕진구,343,174386,6863,181592,"2022-02-01",2022
"22-Feb",전북,전주시 완산구,790,152718,4166,157674,"2022-02-01",2022
"22-Feb",전북,정읍시,359,55335,3639,59333,"2022-02-01",2022
"22-Feb",전북,진안군,266,14384,238,14888,"2022-02-01",2022
"22-Feb",전북,계,5450,919508,38090,963048,"2022-02-01",2022
"22-Feb",전남,강진군,236,18737,1053,20026,"2022-02-01",2022
"22-Feb",전남,고흥군,315,32589,588,33492,"2022-02-01",2022
"22-Feb",전남,곡성군,161,15099,714,15974,"2022-02-01",2022
"22-Feb",전남,광양시,257,85694,6053,92004,"2022-02-01",2022
"22-Feb",전남,구례군,147,13293,726,14166,"2022-02-01",2022
"22-Feb",전남,나주시,478,66505,3224,70207,"2022-02-01",2022
"22-Feb",전남,담양군,222,27625,1643,29490,"2022-02-01",2022
"22-Feb",전남,목포시,416,95044,5477,100937,"2022-02-01",2022
"22-Feb",전남,무안군,560,49877,1101,51538,"2022-02-01",2022
"22-Feb",전남,보성군,225,21786,8903,30914,"2022-02-01",2022
"22-Feb",전남,순천시,508,142160,5354,148022,"2022-02-01",2022
"22-Feb",전남,신안군,330,21848,86049,108227,"2022-02-01",2022
"22-Feb",전남,여수시,533,132980,7373,140886,"2022-02-01",2022
"22-Feb",전남,영광군,207,28259,778,29244,"2022-02-01",2022
"22-Feb",전남,영암군,281,33903,2369,36553,"2022-02-01",2022
"22-Feb",전남,완도군,285,25662,548,26495,"2022-02-01",2022
"22-Feb",전남,장성군,213,26937,1275,28425,"2022-02-01",2022
"22-Feb",전남,장흥군,261,20250,447,20958,"2022-02-01",2022
"22-Feb",전남,진도군,170,17164,289,17623,"2022-02-01",2022
"22-Feb",전남,함평군,211,18317,30141,48669,"2022-02-01",2022
"22-Feb",전남,해남군,346,39941,38807,79094,"2022-02-01",2022
"22-Feb",전남,화순군,232,33439,2071,35742,"2022-02-01",2022
"22-Feb",전남,계,6594,967109,204983,1178686,"2022-02-01",2022
"22-Feb",경북,경산시,325,140282,4389,144996,"2022-02-01",2022
"22-Feb",경북,경주시,594,143066,4582,148242,"2022-02-01",2022
"22-Feb",경북,고령군,172,20599,738,21509,"2022-02-01",2022
"22-Feb",경북,구미시,548,214896,7216,222660,"2022-02-01",2022
"22-Feb",경북,군위군,124,15179,313,15616,"2022-02-01",2022
"22-Feb",경북,김천시,397,75814,1991,78202,"2022-02-01",2022
"22-Feb",경북,문경시,278,37489,871,38638,"2022-02-01",2022
"22-Feb",경북,봉화군,204,18197,208,18609,"2022-02-01",2022
"22-Feb",경북,상주시,386,53572,1880,55838,"2022-02-01",2022
"22-Feb",경북,성주군,199,31195,1295,32689,"2022-02-01",2022
"22-Feb",경북,안동시,746,83198,2774,86718,"2022-02-01",2022
"22-Feb",경북,영덕군,252,19073,300,19625,"2022-02-01",2022
"22-Feb",경북,영양군,143,9894,147,10184,"2022-02-01",2022
"22-Feb",경북,영주시,370,56001,1528,57899,"2022-02-01",2022
"22-Feb",경북,영천시,322,60556,2585,63463,"2022-02-01",2022
"22-Feb",경북,예천군,278,30760,491,31529,"2022-02-01",2022
"22-Feb",경북,울릉군,160,5302,596,6058,"2022-02-01",2022
"22-Feb",경북,울진군,313,26419,361,27093,"2022-02-01",2022
"22-Feb",경북,의성군,313,31274,1083,32670,"2022-02-01",2022
"22-Feb",경북,청도군,218,25365,939,26522,"2022-02-01",2022
"22-Feb",경북,청송군,192,15993,207,16392,"2022-02-01",2022
"22-Feb",경북,칠곡군,305,69264,2415,71984,"2022-02-01",2022
"22-Feb",경북,포항시 남구,439,123191,8370,132000,"2022-02-01",2022
"22-Feb",경북,포항시 북구,337,142212,3582,146131,"2022-02-01",2022
"22-Feb",경북,계,7615,1448791,48861,1505267,"2022-02-01",2022
"22-Feb",경남,거제시,362,106742,2104,109208,"2022-02-01",2022
"22-Feb",경남,거창군,272,32857,762,33891,"2022-02-01",2022
"22-Feb",경남,고성군,228,26688,565,27481,"2022-02-01",2022
"22-Feb",경남,김해시,658,278401,7455,286514,"2022-02-01",2022
"22-Feb",경남,남해군,272,20233,445,20950,"2022-02-01",2022
"22-Feb",경남,밀양시,324,56626,3939,60889,"2022-02-01",2022
"22-Feb",경남,사천시,319,57010,1550,58879,"2022-02-01",2022
"22-Feb",경남,산청군,245,20435,773,21453,"2022-02-01",2022
"22-Feb",경남,양산시,421,169466,10521,180408,"2022-02-01",2022
"22-Feb",경남,의령군,205,14869,760,15834,"2022-02-01",2022
"22-Feb",경남,진주시,640,168015,6462,175117,"2022-02-01",2022
"22-Feb",경남,창녕군,228,35902,741,36871,"2022-02-01",2022
"22-Feb",경남,창원시 마산합포구,328,94949,2852,98129,"2022-02-01",2022
"22-Feb",경남,창원시 마산회원구,179,97409,5361,102949,"2022-02-01",2022
"22-Feb",경남,창원시 성산구,631,151763,51695,204089,"2022-02-01",2022
"22-Feb",경남,창원시 의창구,456,117366,3490,121312,"2022-02-01",2022
"22-Feb",경남,창원시 진해구,214,94288,1972,96474,"2022-02-01",2022
"22-Feb",경남,통영시,319,52537,1389,54245,"2022-02-01",2022
"22-Feb",경남,하동군,225,24167,383,24775,"2022-02-01",2022
"22-Feb",경남,함안군,191,43695,22401,66287,"2022-02-01",2022
"22-Feb",경남,함양군,220,19644,435,20299,"2022-02-01",2022
"22-Feb",경남,합천군,279,23590,614,24483,"2022-02-01",2022
"22-Feb",경남,계,7216,1706652,126669,1840537,"2022-02-01",2022
"22-Feb",제주,서귀포시,784,105881,1992,108657,"2022-02-01",2022
"22-Feb",제주,제주시,1633,293382,261393,556408,"2022-02-01",2022
"22-Feb",제주,계,2417,399263,263385,665065,"2022-02-01",2022
"22-Mar",서울,강남구,401,218868,21211,240480,"2022-03-01",2022
"22-Mar",서울,강동구,302,143044,8529,151875,"2022-03-01",2022
"22-Mar",서울,강북구,309,70621,4218,75148,"2022-03-01",2022
"22-Mar",서울,강서구,344,187870,18138,206352,"2022-03-01",2022
"22-Mar",서울,관악구,306,112169,5673,118148,"2022-03-01",2022
"22-Mar",서울,광진구,304,93059,5763,99126,"2022-03-01",2022
"22-Mar",서울,구로구,287,132170,13583,146040,"2022-03-01",2022
"22-Mar",서울,금천구,163,83947,6398,90508,"2022-03-01",2022
"22-Mar",서울,노원구,315,143176,8814,152305,"2022-03-01",2022
"22-Mar",서울,도봉구,284,87940,7349,95573,"2022-03-01",2022
"22-Mar",서울,동대문구,315,93320,4939,98574,"2022-03-01",2022
"22-Mar",서울,동작구,305,103182,2776,106263,"2022-03-01",2022
"22-Mar",서울,마포구,335,113633,7282,121250,"2022-03-01",2022
"22-Mar",서울,서대문구,451,83387,5597,89435,"2022-03-01",2022
"22-Mar",서울,서초구,521,165339,10779,176639,"2022-03-01",2022
"22-Mar",서울,성동구,373,93617,12045,106035,"2022-03-01",2022
"22-Mar",서울,성북구,301,116578,5137,122016,"2022-03-01",2022
"22-Mar",서울,송파구,394,234533,13823,248750,"2022-03-01",2022
"22-Mar",서울,양천구,320,142489,8442,151251,"2022-03-01",2022
"22-Mar",서울,영등포구,387,136811,8748,145946,"2022-03-01",2022
"22-Mar",서울,용산구,337,76924,2159,79420,"2022-03-01",2022
"22-Mar",서울,은평구,300,125971,7020,133291,"2022-03-01",2022
"22-Mar",서울,종로구,3879,44444,2509,50832,"2022-03-01",2022
"22-Mar",서울,중구,1249,53685,5147,60081,"2022-03-01",2022
"22-Mar",서울,중랑구,245,105334,9382,114961,"2022-03-01",2022
"22-Mar",서울,계,12727,2962111,205461,3180299,"2022-03-01",2022
"22-Mar",부산,강서구,316,82502,4355,87173,"2022-03-01",2022
"22-Mar",부산,금정구,275,79720,7356,87351,"2022-03-01",2022
"22-Mar",부산,기장군,256,81287,2675,84218,"2022-03-01",2022
"22-Mar",부산,남구,219,91174,9427,100820,"2022-03-01",2022
"22-Mar",부산,동구,184,54116,5712,60012,"2022-03-01",2022
"22-Mar",부산,동래구,168,96018,3667,99853,"2022-03-01",2022
"22-Mar",부산,부산진구,368,121908,21192,143468,"2022-03-01",2022
"22-Mar",부산,북구,230,102016,3721,105967,"2022-03-01",2022
"22-Mar",부산,사상구,282,82964,5669,88915,"2022-03-01",2022
"22-Mar",부산,사하구,264,107709,6344,114317,"2022-03-01",2022
"22-Mar",부산,서구,137,28952,1438,30527,"2022-03-01",2022
"22-Mar",부산,수영구,161,66184,43161,109506,"2022-03-01",2022
"22-Mar",부산,연제구,973,94020,12780,107773,"2022-03-01",2022
"22-Mar",부산,영도구,223,31192,2031,33446,"2022-03-01",2022
"22-Mar",부산,중구,307,30888,7039,38234,"2022-03-01",2022
"22-Mar",부산,해운대구,322,166278,17166,183766,"2022-03-01",2022
"22-Mar",부산,계,4685,1316928,153733,1475346,"2022-03-01",2022
"22-Mar",대구,남구,354,55454,1594,57402,"2022-03-01",2022
"22-Mar",대구,달서구,484,272370,14700,287554,"2022-03-01",2022
"22-Mar",대구,달성군,566,136834,5176,142576,"2022-03-01",2022
"22-Mar",대구,동구,358,156335,10762,167455,"2022-03-01",2022
"22-Mar",대구,북구,504,203922,7564,211990,"2022-03-01",2022
"22-Mar",대구,서구,252,67837,4493,72582,"2022-03-01",2022
"22-Mar",대구,수성구,585,210071,4701,215357,"2022-03-01",2022
"22-Mar",대구,중구,303,57887,2670,60860,"2022-03-01",2022
"22-Mar",대구,계,3406,1160710,51660,1215776,"2022-03-01",2022
"22-Mar",인천,강화군,349,36742,12841,49932,"2022-03-01",2022
"22-Mar",인천,계양구,297,121142,181459,302898,"2022-03-01",2022
"22-Mar",인천,남동구,862,247022,45528,293412,"2022-03-01",2022
"22-Mar",인천,동구,101,24140,2587,26828,"2022-03-01",2022
"22-Mar",인천,미추홀구,434,160793,8977,170204,"2022-03-01",2022
"22-Mar",인천,부평구,341,223319,34054,257714,"2022-03-01",2022
"22-Mar",인천,서구,467,268930,13044,282441,"2022-03-01",2022
"22-Mar",인천,연수구,427,201140,8530,210097,"2022-03-01",2022
"22-Mar",인천,옹진군,227,12455,229,12911,"2022-03-01",2022
"22-Mar",인천,중구,651,68885,12294,81830,"2022-03-01",2022
"22-Mar",인천,계,4156,1364568,319543,1688267,"2022-03-01",2022
"22-Mar",광주,광산구,523,198725,12847,212095,"2022-03-01",2022
"22-Mar",광주,남구,231,92787,2968,95986,"2022-03-01",2022
"22-Mar",광주,동구,233,43552,1078,44863,"2022-03-01",2022
"22-Mar",광주,북구,589,192086,9302,201977,"2022-03-01",2022
"22-Mar",광주,서구,720,142808,6374,149902,"2022-03-01",2022
"22-Mar",광주,계,2296,669958,32569,704823,"2022-03-01",2022
"22-Mar",대전,대덕구,238,87323,7398,94959,"2022-03-01",2022
"22-Mar",대전,동구,244,91060,4771,96075,"2022-03-01",2022
"22-Mar",대전,서구,803,207472,8246,216521,"2022-03-01",2022
"22-Mar",대전,유성구,659,180990,5280,186929,"2022-03-01",2022
"22-Mar",대전,중구,228,95761,5539,101528,"2022-03-01",2022
"22-Mar",대전,계,2172,662606,31234,696012,"2022-03-01",2022
"22-Mar",울산,남구,718,153853,7493,162064,"2022-03-01",2022
"22-Mar",울산,동구,188,61889,1131,63208,"2022-03-01",2022
"22-Mar",울산,북구,224,117983,3449,121656,"2022-03-01",2022
"22-Mar",울산,울주군,426,125847,7125,133398,"2022-03-01",2022
"22-Mar",울산,중구,322,100253,2554,103129,"2022-03-01",2022
"22-Mar",울산,계,1878,559825,21752,583455,"2022-03-01",2022
"22-Mar",세종,세종특별자치시,857,184385,3245,188487,"2022-03-01",2022
"22-Mar",세종,계,857,184385,3245,188487,"2022-03-01",2022
"22-Mar",경기,가평군,387,31560,581,32528,"2022-03-01",2022
"22-Mar",경기,고양시 덕양구,669,185502,4075,190246,"2022-03-01",2022
"22-Mar",경기,고양시 일산동구,277,126833,5438,132548,"2022-03-01",2022
"22-Mar",경기,고양시 일산서구,130,116580,4638,121348,"2022-03-01",2022
"22-Mar",경기,과천시,730,28854,706,30290,"2022-03-01",2022
"22-Mar",경기,광명시,309,100405,4470,105184,"2022-03-01",2022
"22-Mar",경기,광주시,393,197291,8506,206190,"2022-03-01",2022
"22-Mar",경기,구리시,266,70280,2762,73308,"2022-03-01",2022
"22-Mar",경기,군포시,296,98401,5155,103852,"2022-03-01",2022
"22-Mar",경기,김포시,538,230936,8178,239652,"2022-03-01",2022
"22-Mar",경기,남양주시,767,310337,8889,319993,"2022-03-01",2022
"22-Mar",경기,동두천시,218,38830,1494,40542,"2022-03-01",2022
"22-Mar",경기,부천시,713,296529,12556,309798,"2022-03-01",2022
"22-Mar",경기,성남시 분당구,374,188691,7119,196184,"2022-03-01",2022
"22-Mar",경기,성남시 수정구,353,77433,2624,80410,"2022-03-01",2022
"22-Mar",경기,성남시 중원구,346,71275,4051,75672,"2022-03-01",2022
"22-Mar",경기,수원시 권선구,481,200762,9228,210471,"2022-03-01",2022
"22-Mar",경기,수원시 영통구,256,146860,3272,150388,"2022-03-01",2022
"22-Mar",경기,수원시 장안구,476,103650,3858,107984,"2022-03-01",2022
"22-Mar",경기,수원시 팔달구,491,73191,2991,76673,"2022-03-01",2022
"22-Mar",경기,시흥시,468,255268,8376,264112,"2022-03-01",2022
"22-Mar",경기,안산시 단원구,550,159254,7479,167283,"2022-03-01",2022
"22-Mar",경기,안산시 상록구,175,144974,5792,150941,"2022-03-01",2022
"22-Mar",경기,안성시,399,108958,4695,114052,"2022-03-01",2022
"22-Mar",경기,안양시 동안구,402,119930,6582,126914,"2022-03-01",2022
"22-Mar",경기,안양시 만안구,159,84206,3963,88328,"2022-03-01",2022
"22-Mar",경기,양주시,398,112572,3426,116396,"2022-03-01",2022
"22-Mar",경기,양평군,579,62615,1901,65095,"2022-03-01",2022
"22-Mar",경기,여주시,458,64929,7235,72622,"2022-03-01",2022
"22-Mar",경기,연천군,308,24113,5288,29709,"2022-03-01",2022
"22-Mar",경기,오산시,215,109730,3920,113865,"2022-03-01",2022
"22-Mar",경기,용인시 기흥구,124,192248,6745,199117,"2022-03-01",2022
"22-Mar",경기,용인시 수지구,52,146637,2436,149125,"2022-03-01",2022
"22-Mar",경기,용인시 처인구,801,135469,7903,144173,"2022-03-01",2022
"22-Mar",경기,의왕시,300,66002,2954,69256,"2022-03-01",2022
"22-Mar",경기,의정부시,749,167705,5446,173900,"2022-03-01",2022
"22-Mar",경기,이천시,418,117493,6377,124288,"2022-03-01",2022
"22-Mar",경기,파주시,532,227525,10728,238785,"2022-03-01",2022
"22-Mar",경기,평택시,753,303393,13043,317189,"2022-03-01",2022
"22-Mar",경기,포천시,390,88407,9531,98328,"2022-03-01",2022
"22-Mar",경기,하남시,413,134541,3374,138328,"2022-03-01",2022
"22-Mar",경기,화성시,947,470597,13111,484655,"2022-03-01",2022
"22-Mar",경기,계,18060,5990766,240896,6249722,"2022-03-01",2022
"22-Mar",강원,강릉시,530,110496,4636,115662,"2022-03-01",2022
"22-Mar",강원,고성군,190,15235,230,15655,"2022-03-01",2022
"22-Mar",강원,동해시,314,46265,1468,48047,"2022-03-01",2022
"22-Mar",강원,삼척시,397,32836,771,34004,"2022-03-01",2022
"22-Mar",강원,속초시,305,39195,1403,40903,"2022-03-01",2022
"22-Mar",강원,양구군,201,12126,145,12472,"2022-03-01",2022
"22-Mar",강원,양양군,191,16273,314,16778,"2022-03-01",2022
"22-Mar",강원,영월군,329,21508,368,22205,"2022-03-01",2022
"22-Mar",강원,원주시,604,181377,5634,187615,"2022-03-01",2022
"22-Mar",강원,인제군,217,19171,317,19705,"2022-03-01",2022
"22-Mar",강원,정선군,335,20811,478,21624,"2022-03-01",2022
"22-Mar",강원,철원군,241,24348,330,24919,"2022-03-01",2022
"22-Mar",강원,춘천시,841,137107,6318,144266,"2022-03-01",2022
"22-Mar",강원,태백시,221,19849,747,20817,"2022-03-01",2022
"22-Mar",강원,평창군,300,26098,511,26909,"2022-03-01",2022
"22-Mar",강원,홍천군,423,39608,1046,41077,"2022-03-01",2022
"22-Mar",강원,화천군,232,13252,182,13666,"2022-03-01",2022
"22-Mar",강원,횡성군,258,27406,727,28391,"2022-03-01",2022
"22-Mar",강원,계,6129,802961,25625,834715,"2022-03-01",2022
"22-Mar",충북,괴산군,214,23383,416,24013,"2022-03-01",2022
"22-Mar",충북,단양군,230,15754,771,16755,"2022-03-01",2022
"22-Mar",충북,보은군,234,18289,981,19504,"2022-03-01",2022
"22-Mar",충북,영동군,252,25267,411,25930,"2022-03-01",2022
"22-Mar",충북,옥천군,209,27790,1154,29153,"2022-03-01",2022
"22-Mar",충북,음성군,257,59976,2014,62247,"2022-03-01",2022
"22-Mar",충북,제천시,339,68045,3469,71853,"2022-03-01",2022
"22-Mar",충북,증평군,91,19789,772,20652,"2022-03-01",2022
"22-Mar",충북,진천군,218,51795,1384,53397,"2022-03-01",2022
"22-Mar",충북,청원군,1,19,0,20,"2022-03-01",2022
"22-Mar",충북,청주시 상당구,502,94832,2702,98036,"2022-03-01",2022
"22-Mar",충북,청주시 서원구,237,101921,4203,106361,"2022-03-01",2022
"22-Mar",충북,청주시 청원구,366,105150,4592,110108,"2022-03-01",2022
"22-Mar",충북,청주시 흥덕구,358,132918,7670,140946,"2022-03-01",2022
"22-Mar",충북,충주시,625,111962,7515,120102,"2022-03-01",2022
"22-Mar",충북,계,4133,856890,38054,899077,"2022-03-01",2022
"22-Mar",충남,계룡시,157,23003,564,23724,"2022-03-01",2022
"22-Mar",충남,공주시,587,54793,2665,58045,"2022-03-01",2022
"22-Mar",충남,금산군,202,28706,2005,30913,"2022-03-01",2022
"22-Mar",충남,논산시,411,61620,2398,64429,"2022-03-01",2022
"22-Mar",충남,당진시,400,97918,4053,102371,"2022-03-01",2022
"22-Mar",충남,보령시,415,52851,1362,54628,"2022-03-01",2022
"22-Mar",충남,부여군,302,34524,1168,35994,"2022-03-01",2022
"22-Mar",충남,서산시,425,97680,3599,101704,"2022-03-01",2022
"22-Mar",충남,서천군,236,27204,813,28253,"2022-03-01",2022
"22-Mar",충남,아산시,537,177980,7140,185657,"2022-03-01",2022
"22-Mar",충남,예산군,430,43691,1392,45513,"2022-03-01",2022
"22-Mar",충남,천안시 동남구,291,133324,5280,138895,"2022-03-01",2022
"22-Mar",충남,천안시 서북구,529,200330,5618,206477,"2022-03-01",2022
"22-Mar",충남,청양군,251,17171,811,18233,"2022-03-01",2022
"22-Mar",충남,태안군,310,34682,563,35555,"2022-03-01",2022
"22-Mar",충남,홍성군,414,53681,1369,55464,"2022-03-01",2022
"22-Mar",충남,계,5897,1139158,40800,1185855,"2022-03-01",2022
"22-Mar",전북,고창군,313,30926,586,31825,"2022-03-01",2022
"22-Mar",전북,군산시,555,132954,6405,139914,"2022-03-01",2022
"22-Mar",전북,김제시,289,46088,1968,48345,"2022-03-01",2022
"22-Mar",전북,남원시,416,41531,3340,45287,"2022-03-01",2022
"22-Mar",전북,무주군,197,13130,395,13722,"2022-03-01",2022
"22-Mar",전북,부안군,266,27602,616,28484,"2022-03-01",2022
"22-Mar",전북,순창군,229,14803,145,15177,"2022-03-01",2022
"22-Mar",전북,완주군,420,52587,3129,56136,"2022-03-01",2022
"22-Mar",전북,익산시,531,137609,5925,144065,"2022-03-01",2022
"22-Mar",전북,임실군,219,14426,427,15072,"2022-03-01",2022
"22-Mar",전북,장수군,247,12378,180,12805,"2022-03-01",2022
"22-Mar",전북,전주시 덕진구,339,174679,6902,181920,"2022-03-01",2022
"22-Mar",전북,전주시 완산구,788,152932,4178,157898,"2022-03-01",2022
"22-Mar",전북,정읍시,358,55478,3719,59555,"2022-03-01",2022
"22-Mar",전북,진안군,267,14447,232,14946,"2022-03-01",2022
"22-Mar",전북,계,5434,921570,38147,965151,"2022-03-01",2022
"22-Mar",전남,강진군,234,18758,1055,20047,"2022-03-01",2022
"22-Mar",전남,고흥군,314,32711,582,33607,"2022-03-01",2022
"22-Mar",전남,곡성군,159,15105,713,15977,"2022-03-01",2022
"22-Mar",전남,광양시,257,86042,6040,92339,"2022-03-01",2022
"22-Mar",전남,구례군,144,13341,730,14215,"2022-03-01",2022
"22-Mar",전남,나주시,475,66399,3268,70142,"2022-03-01",2022
"22-Mar",전남,담양군,220,27743,1661,29624,"2022-03-01",2022
"22-Mar",전남,목포시,399,95136,5460,100995,"2022-03-01",2022
"22-Mar",전남,무안군,557,50040,1100,51697,"2022-03-01",2022
"22-Mar",전남,보성군,223,21784,4505,26512,"2022-03-01",2022
"22-Mar",전남,순천시,501,142722,5402,148625,"2022-03-01",2022
"22-Mar",전남,신안군,339,22021,86600,108960,"2022-03-01",2022
"22-Mar",전남,여수시,528,133100,7364,140992,"2022-03-01",2022
"22-Mar",전남,영광군,206,28390,782,29378,"2022-03-01",2022
"22-Mar",전남,영암군,280,34086,2210,36576,"2022-03-01",2022
"22-Mar",전남,완도군,283,25574,545,26402,"2022-03-01",2022
"22-Mar",전남,장성군,210,27037,1258,28505,"2022-03-01",2022
"22-Mar",전남,장흥군,257,20304,453,21014,"2022-03-01",2022
"22-Mar",전남,진도군,199,17235,292,17726,"2022-03-01",2022
"22-Mar",전남,함평군,209,18390,33092,51691,"2022-03-01",2022
"22-Mar",전남,해남군,320,40017,39905,80242,"2022-03-01",2022
"22-Mar",전남,화순군,227,33619,2070,35916,"2022-03-01",2022
"22-Mar",전남,계,6541,969554,205087,1181182,"2022-03-01",2022
"22-Mar",경북,경산시,327,140327,4409,145063,"2022-03-01",2022
"22-Mar",경북,경주시,590,143309,4589,148488,"2022-03-01",2022
"22-Mar",경북,고령군,172,20539,745,21456,"2022-03-01",2022
"22-Mar",경북,구미시,541,215209,7252,223002,"2022-03-01",2022
"22-Mar",경북,군위군,123,15312,313,15748,"2022-03-01",2022
"22-Mar",경북,김천시,395,75989,2015,78399,"2022-03-01",2022
"22-Mar",경북,문경시,279,38036,878,39193,"2022-03-01",2022
"22-Mar",경북,봉화군,204,18289,205,18698,"2022-03-01",2022
"22-Mar",경북,상주시,387,53775,1883,56045,"2022-03-01",2022
"22-Mar",경북,성주군,199,31299,1299,32797,"2022-03-01",2022
"22-Mar",경북,안동시,751,83259,2767,86777,"2022-03-01",2022
"22-Mar",경북,영덕군,251,19158,296,19705,"2022-03-01",2022
"22-Mar",경북,영양군,144,9897,145,10186,"2022-03-01",2022
"22-Mar",경북,영주시,372,56094,1526,57992,"2022-03-01",2022
"22-Mar",경북,영천시,331,60715,2592,63638,"2022-03-01",2022
"22-Mar",경북,예천군,279,30770,492,31541,"2022-03-01",2022
"22-Mar",경북,울릉군,158,5379,601,6138,"2022-03-01",2022
"22-Mar",경북,울진군,313,26447,359,27119,"2022-03-01",2022
"22-Mar",경북,의성군,314,31430,1087,32831,"2022-03-01",2022
"22-Mar",경북,청도군,215,25439,949,26603,"2022-03-01",2022
"22-Mar",경북,청송군,194,16027,209,16430,"2022-03-01",2022
"22-Mar",경북,칠곡군,302,69420,2437,72159,"2022-03-01",2022
"22-Mar",경북,포항시 남구,435,123447,8370,132252,"2022-03-01",2022
"22-Mar",경북,포항시 북구,336,142389,3560,146285,"2022-03-01",2022
"22-Mar",경북,계,7612,1451955,48978,1508545,"2022-03-01",2022
"22-Mar",경남,거제시,364,106785,2096,109245,"2022-03-01",2022
"22-Mar",경남,거창군,269,32961,761,33991,"2022-03-01",2022
"22-Mar",경남,고성군,225,26742,558,27525,"2022-03-01",2022
"22-Mar",경남,김해시,654,278917,7534,287105,"2022-03-01",2022
"22-Mar",경남,남해군,270,20322,445,21037,"2022-03-01",2022
"22-Mar",경남,밀양시,320,56694,3949,60963,"2022-03-01",2022
"22-Mar",경남,사천시,315,57081,1551,58947,"2022-03-01",2022
"22-Mar",경남,산청군,242,20446,774,21462,"2022-03-01",2022
"22-Mar",경남,양산시,421,169821,10550,180792,"2022-03-01",2022
"22-Mar",경남,의령군,204,14928,763,15895,"2022-03-01",2022
"22-Mar",경남,진주시,637,168209,6445,175291,"2022-03-01",2022
"22-Mar",경남,창녕군,227,35846,753,36826,"2022-03-01",2022
"22-Mar",경남,창원시 마산합포구,328,94758,2857,97943,"2022-03-01",2022
"22-Mar",경남,창원시 마산회원구,179,97802,5431,103412,"2022-03-01",2022
"22-Mar",경남,창원시 성산구,628,152236,51792,204656,"2022-03-01",2022
"22-Mar",경남,창원시 의창구,459,117190,3490,121139,"2022-03-01",2022
"22-Mar",경남,창원시 진해구,215,94392,1988,96595,"2022-03-01",2022
"22-Mar",경남,통영시,318,52647,1385,54350,"2022-03-01",2022
"22-Mar",경남,하동군,224,24118,383,24725,"2022-03-01",2022
"22-Mar",경남,함안군,200,43535,24306,68041,"2022-03-01",2022
"22-Mar",경남,함양군,219,19720,426,20365,"2022-03-01",2022
"22-Mar",경남,합천군,280,23697,618,24595,"2022-03-01",2022
"22-Mar",경남,계,7198,1708847,128855,1844900,"2022-03-01",2022
"22-Mar",제주,서귀포시,781,106098,2020,108899,"2022-03-01",2022
"22-Mar",제주,제주시,1612,294915,263142,559669,"2022-03-01",2022
"22-Mar",제주,계,2393,401013,265162,668568,"2022-03-01",2022
"22-Apr",서울,강남구,396,223626,21465,245487,"2022-04-01",2022
"22-Apr",서울,강동구,302,143156,8501,151959,"2022-04-01",2022
"22-Apr",서울,강북구,310,70600,4212,75122,"2022-04-01",2022
"22-Apr",서울,강서구,344,188547,17631,206522,"2022-04-01",2022
"22-Apr",서울,관악구,307,112279,5687,118273,"2022-04-01",2022
"22-Apr",서울,광진구,303,93123,5689,99115,"2022-04-01",2022
"22-Apr",서울,구로구,284,132190,13564,146038,"2022-04-01",2022
"22-Apr",서울,금천구,163,84033,6305,90501,"2022-04-01",2022
"22-Apr",서울,노원구,317,143187,8871,152375,"2022-04-01",2022
"22-Apr",서울,도봉구,283,87898,7427,95608,"2022-04-01",2022
"22-Apr",서울,동대문구,314,93353,4936,98603,"2022-04-01",2022
"22-Apr",서울,동작구,304,103320,2793,106417,"2022-04-01",2022
"22-Apr",서울,마포구,332,113635,7283,121250,"2022-04-01",2022
"22-Apr",서울,서대문구,432,83439,5671,89542,"2022-04-01",2022
"22-Apr",서울,서초구,520,165177,10797,176494,"2022-04-01",2022
"22-Apr",서울,성동구,366,93654,12001,106021,"2022-04-01",2022
"22-Apr",서울,성북구,300,116800,5116,122216,"2022-04-01",2022
"22-Apr",서울,송파구,392,234759,14105,249256,"2022-04-01",2022
"22-Apr",서울,양천구,318,142593,8431,151342,"2022-04-01",2022
"22-Apr",서울,영등포구,383,136306,8801,145490,"2022-04-01",2022
"22-Apr",서울,용산구,334,72723,2177,75234,"2022-04-01",2022
"22-Apr",서울,은평구,297,126460,7034,133791,"2022-04-01",2022
"22-Apr",서울,종로구,3886,44377,2493,50756,"2022-04-01",2022
"22-Apr",서울,중구,1248,53357,5139,59744,"2022-04-01",2022
"22-Apr",서울,중랑구,246,105433,9420,115099,"2022-04-01",2022
"22-Apr",서울,계,12681,2964025,205549,3182255,"2022-04-01",2022
"22-Apr",부산,강서구,317,82767,4467,87551,"2022-04-01",2022
"22-Apr",부산,금정구,274,79563,7327,87164,"2022-04-01",2022
"22-Apr",부산,기장군,256,81309,2677,84242,"2022-04-01",2022
"22-Apr",부산,남구,220,91306,9680,101206,"2022-04-01",2022
"22-Apr",부산,동구,187,54539,5778,60504,"2022-04-01",2022
"22-Apr",부산,동래구,169,96050,3616,99835,"2022-04-01",2022
"22-Apr",부산,부산진구,368,122513,21264,144145,"2022-04-01",2022
"22-Apr",부산,북구,231,101951,3721,105903,"2022-04-01",2022
"22-Apr",부산,사상구,283,83007,5612,88902,"2022-04-01",2022
"22-Apr",부산,사하구,263,107919,6314,114496,"2022-04-01",2022
"22-Apr",부산,서구,137,28828,1453,30418,"2022-04-01",2022
"22-Apr",부산,수영구,160,66108,44290,110558,"2022-04-01",2022
"22-Apr",부산,연제구,958,94372,12996,108326,"2022-04-01",2022
"22-Apr",부산,영도구,222,31225,2017,33464,"2022-04-01",2022
"22-Apr",부산,중구,307,30928,7030,38265,"2022-04-01",2022
"22-Apr",부산,해운대구,322,166073,17013,183408,"2022-04-01",2022
"22-Apr",부산,계,4674,1318458,155255,1478387,"2022-04-01",2022
"22-Apr",대구,남구,354,55186,1604,57144,"2022-04-01",2022
"22-Apr",대구,달서구,491,272391,14683,287565,"2022-04-01",2022
"22-Apr",대구,달성군,567,137140,5169,142876,"2022-04-01",2022
"22-Apr",대구,동구,359,156541,10843,167743,"2022-04-01",2022
"22-Apr",대구,북구,499,203931,7591,212021,"2022-04-01",2022
"22-Apr",대구,서구,251,67842,4479,72572,"2022-04-01",2022
"22-Apr",대구,수성구,585,210372,4714,215671,"2022-04-01",2022
"22-Apr",대구,중구,303,58721,2684,61708,"2022-04-01",2022
"22-Apr",대구,계,3409,1162124,51767,1217300,"2022-04-01",2022
"22-Apr",인천,강화군,349,36882,12059,49290,"2022-04-01",2022
"22-Apr",인천,계양구,299,121319,179949,301567,"2022-04-01",2022
"22-Apr",인천,남동구,860,247461,45200,293521,"2022-04-01",2022
"22-Apr",인천,동구,101,23975,2688,26764,"2022-04-01",2022
"22-Apr",인천,미추홀구,433,160809,8997,170239,"2022-04-01",2022
"22-Apr",인천,부평구,340,224051,34683,259074,"2022-04-01",2022
"22-Apr",인천,서구,467,271209,12953,284629,"2022-04-01",2022
"22-Apr",인천,연수구,428,201525,8583,210536,"2022-04-01",2022
"22-Apr",인천,옹진군,225,12567,237,13029,"2022-04-01",2022
"22-Apr",인천,중구,631,69429,12258,82318,"2022-04-01",2022
"22-Apr",인천,계,4133,1369227,317607,1690967,"2022-04-01",2022
"22-Apr",광주,광산구,526,198792,12993,212311,"2022-04-01",2022
"22-Apr",광주,남구,231,92584,3046,95861,"2022-04-01",2022
"22-Apr",광주,동구,232,43503,1047,44782,"2022-04-01",2022
"22-Apr",광주,북구,590,192156,9224,201970,"2022-04-01",2022
"22-Apr",광주,서구,728,142961,6357,150046,"2022-04-01",2022
"22-Apr",광주,계,2307,669996,32667,704970,"2022-04-01",2022
"22-Apr",대전,대덕구,236,87280,7479,94995,"2022-04-01",2022
"22-Apr",대전,동구,246,90970,4771,95987,"2022-04-01",2022
"22-Apr",대전,서구,804,207677,8617,217098,"2022-04-01",2022
"22-Apr",대전,유성구,658,181876,5289,187823,"2022-04-01",2022
"22-Apr",대전,중구,229,95904,5529,101662,"2022-04-01",2022
"22-Apr",대전,계,2173,663707,31685,697565,"2022-04-01",2022
"22-Apr",울산,남구,715,153788,7504,162007,"2022-04-01",2022
"22-Apr",울산,동구,189,61862,1154,63205,"2022-04-01",2022
"22-Apr",울산,북구,223,118225,3460,121908,"2022-04-01",2022
"22-Apr",울산,울주군,426,125809,7126,133361,"2022-04-01",2022
"22-Apr",울산,중구,320,100185,2550,103055,"2022-04-01",2022
"22-Apr",울산,계,1873,559869,21794,583536,"2022-04-01",2022
"22-Apr",세종,세종특별자치시,861,185014,3278,189153,"2022-04-01",2022
"22-Apr",세종,계,861,185014,3278,189153,"2022-04-01",2022
"22-Apr",경기,가평군,387,31634,576,32597,"2022-04-01",2022
"22-Apr",경기,고양시 덕양구,664,185910,4112,190686,"2022-04-01",2022
"22-Apr",경기,고양시 일산동구,273,127424,6104,133801,"2022-04-01",2022
"22-Apr",경기,고양시 일산서구,130,116557,4211,120898,"2022-04-01",2022
"22-Apr",경기,과천시,730,28979,712,30421,"2022-04-01",2022
"22-Apr",경기,광명시,309,100693,4450,105452,"2022-04-01",2022
"22-Apr",경기,광주시,394,197874,8506,206774,"2022-04-01",2022
"22-Apr",경기,구리시,265,70373,2781,73419,"2022-04-01",2022
"22-Apr",경기,군포시,295,98611,5145,104051,"2022-04-01",2022
"22-Apr",경기,김포시,535,231138,8363,240036,"2022-04-01",2022
"22-Apr",경기,남양주시,766,311268,8963,320997,"2022-04-01",2022
"22-Apr",경기,동두천시,216,38931,1506,40653,"2022-04-01",2022
"22-Apr",경기,부천시,714,297203,12732,310649,"2022-04-01",2022
"22-Apr",경기,성남시 분당구,371,188759,7203,196333,"2022-04-01",2022
"22-Apr",경기,성남시 수정구,352,77447,2628,80427,"2022-04-01",2022
"22-Apr",경기,성남시 중원구,347,71266,4055,75668,"2022-04-01",2022
"22-Apr",경기,수원시 권선구,478,203180,9322,212980,"2022-04-01",2022
"22-Apr",경기,수원시 영통구,258,147185,3253,150696,"2022-04-01",2022
"22-Apr",경기,수원시 장안구,473,103795,3877,108145,"2022-04-01",2022
"22-Apr",경기,수원시 팔달구,492,73210,3127,76829,"2022-04-01",2022
"22-Apr",경기,시흥시,465,255843,8426,264734,"2022-04-01",2022
"22-Apr",경기,안산시 단원구,550,160122,7568,168240,"2022-04-01",2022
"22-Apr",경기,안산시 상록구,176,145090,5822,151088,"2022-04-01",2022
"22-Apr",경기,안성시,395,109558,4731,114684,"2022-04-01",2022
"22-Apr",경기,안양시 동안구,401,120388,6612,127401,"2022-04-01",2022
"22-Apr",경기,안양시 만안구,158,84412,3960,88530,"2022-04-01",2022
"22-Apr",경기,양주시,400,112929,3448,116777,"2022-04-01",2022
"22-Apr",경기,양평군,579,62790,1941,65310,"2022-04-01",2022
"22-Apr",경기,여주시,459,65134,7146,72739,"2022-04-01",2022
"22-Apr",경기,연천군,306,24175,5283,29764,"2022-04-01",2022
"22-Apr",경기,오산시,215,109762,3958,113935,"2022-04-01",2022
"22-Apr",경기,용인시 기흥구,122,192400,6859,199381,"2022-04-01",2022
"22-Apr",경기,용인시 수지구,54,146871,2448,149373,"2022-04-01",2022
"22-Apr",경기,용인시 처인구,810,135979,7993,144782,"2022-04-01",2022
"22-Apr",경기,의왕시,300,65983,2963,69246,"2022-04-01",2022
"22-Apr",경기,의정부시,739,168265,5515,174519,"2022-04-01",2022
"22-Apr",경기,이천시,417,117799,6416,124632,"2022-04-01",2022
"22-Apr",경기,파주시,533,228261,10767,239561,"2022-04-01",2022
"22-Apr",경기,평택시,766,304623,13095,318484,"2022-04-01",2022
"22-Apr",경기,포천시,390,88621,9360,98371,"2022-04-01",2022
"22-Apr",경기,하남시,411,134908,3373,138692,"2022-04-01",2022
"22-Apr",경기,화성시,951,472103,13150,486204,"2022-04-01",2022
"22-Apr",경기,계,18046,6007453,242460,6267959,"2022-04-01",2022
"22-Apr",강원,강릉시,529,110734,4654,115917,"2022-04-01",2022
"22-Apr",강원,고성군,189,15322,232,15743,"2022-04-01",2022
"22-Apr",강원,동해시,314,46312,1464,48090,"2022-04-01",2022
"22-Apr",강원,삼척시,398,32914,776,34088,"2022-04-01",2022
"22-Apr",강원,속초시,304,39217,1394,40915,"2022-04-01",2022
"22-Apr",강원,양구군,203,12107,149,12459,"2022-04-01",2022
"22-Apr",강원,양양군,188,16283,320,16791,"2022-04-01",2022
"22-Apr",강원,영월군,330,21508,372,22210,"2022-04-01",2022
"22-Apr",강원,원주시,601,181847,5624,188072,"2022-04-01",2022
"22-Apr",강원,인제군,216,19197,314,19727,"2022-04-01",2022
"22-Apr",강원,정선군,337,20802,477,21616,"2022-04-01",2022
"22-Apr",강원,철원군,241,24429,333,25003,"2022-04-01",2022
"22-Apr",강원,춘천시,844,137379,6392,144615,"2022-04-01",2022
"22-Apr",강원,태백시,221,19859,751,20831,"2022-04-01",2022
"22-Apr",강원,평창군,301,26116,507,26924,"2022-04-01",2022
"22-Apr",강원,홍천군,415,39603,1049,41067,"2022-04-01",2022
"22-Apr",강원,화천군,233,13293,183,13709,"2022-04-01",2022
"22-Apr",강원,횡성군,258,27477,740,28475,"2022-04-01",2022
"22-Apr",강원,계,6122,804399,25731,836252,"2022-04-01",2022
"22-Apr",충북,괴산군,216,23435,419,24070,"2022-04-01",2022
"22-Apr",충북,단양군,230,15787,773,16790,"2022-04-01",2022
"22-Apr",충북,보은군,232,18348,979,19559,"2022-04-01",2022
"22-Apr",충북,영동군,253,25315,413,25981,"2022-04-01",2022
"22-Apr",충북,옥천군,211,27944,1160,29315,"2022-04-01",2022
"22-Apr",충북,음성군,259,59958,2007,62224,"2022-04-01",2022
"22-Apr",충북,제천시,337,68085,3455,71877,"2022-04-01",2022
"22-Apr",충북,증평군,92,19880,778,20750,"2022-04-01",2022
"22-Apr",충북,진천군,216,51845,1395,53456,"2022-04-01",2022
"22-Apr",충북,청원군,1,19,0,20,"2022-04-01",2022
"22-Apr",충북,청주시 상당구,501,95035,2634,98170,"2022-04-01",2022
"22-Apr",충북,청주시 서원구,237,101893,4337,106467,"2022-04-01",2022
"22-Apr",충북,청주시 청원구,365,105386,4602,110353,"2022-04-01",2022
"22-Apr",충북,청주시 흥덕구,360,133255,7728,141343,"2022-04-01",2022
"22-Apr",충북,충주시,625,112260,7584,120469,"2022-04-01",2022
"22-Apr",충북,계,4135,858445,38264,900844,"2022-04-01",2022
"22-Apr",충남,계룡시,158,23063,563,23784,"2022-04-01",2022
"22-Apr",충남,공주시,584,54755,2634,57973,"2022-04-01",2022
"22-Apr",충남,금산군,205,28762,2005,30972,"2022-04-01",2022
"22-Apr",충남,논산시,407,61534,2427,64368,"2022-04-01",2022
"22-Apr",충남,당진시,404,98211,4058,102673,"2022-04-01",2022
"22-Apr",충남,보령시,415,53011,1378,54804,"2022-04-01",2022
"22-Apr",충남,부여군,300,34509,1163,35972,"2022-04-01",2022
"22-Apr",충남,서산시,420,97752,3628,101800,"2022-04-01",2022
"22-Apr",충남,서천군,236,27231,821,28288,"2022-04-01",2022
"22-Apr",충남,아산시,534,178387,7144,186065,"2022-04-01",2022
"22-Apr",충남,예산군,430,43771,1395,45596,"2022-04-01",2022
"22-Apr",충남,천안시 동남구,291,133730,5293,139314,"2022-04-01",2022
"22-Apr",충남,천안시 서북구,536,200708,5640,206884,"2022-04-01",2022
"22-Apr",충남,청양군,252,17137,801,18190,"2022-04-01",2022
"22-Apr",충남,태안군,310,34730,557,35597,"2022-04-01",2022
"22-Apr",충남,홍성군,414,53741,1397,55552,"2022-04-01",2022
"22-Apr",충남,계,5896,1141032,40904,1187832,"2022-04-01",2022
"22-Apr",전북,고창군,306,30875,581,31762,"2022-04-01",2022
"22-Apr",전북,군산시,556,133024,6441,140021,"2022-04-01",2022
"22-Apr",전북,김제시,291,46081,2088,48460,"2022-04-01",2022
"22-Apr",전북,남원시,415,41555,3264,45234,"2022-04-01",2022
"22-Apr",전북,무주군,194,13149,398,13741,"2022-04-01",2022
"22-Apr",전북,부안군,261,27682,623,28566,"2022-04-01",2022
"22-Apr",전북,순창군,226,14824,152,15202,"2022-04-01",2022
"22-Apr",전북,완주군,420,52615,3131,56166,"2022-04-01",2022
"22-Apr",전북,익산시,530,137747,5934,144211,"2022-04-01",2022
"22-Apr",전북,임실군,215,14505,427,15147,"2022-04-01",2022
"22-Apr",전북,장수군,243,12380,180,12803,"2022-04-01",2022
"22-Apr",전북,전주시 덕진구,337,175084,6926,182347,"2022-04-01",2022
"22-Apr",전북,전주시 완산구,784,152960,4183,157927,"2022-04-01",2022
"22-Apr",전북,정읍시,358,55391,3641,59390,"2022-04-01",2022
"22-Apr",전북,진안군,262,14399,235,14896,"2022-04-01",2022
"22-Apr",전북,계,5398,922271,38204,965873,"2022-04-01",2022
"22-Apr",전남,강진군,230,18683,1056,19969,"2022-04-01",2022
"22-Apr",전남,고흥군,313,32914,600,33827,"2022-04-01",2022
"22-Apr",전남,곡성군,159,15136,713,16008,"2022-04-01",2022
"22-Apr",전남,광양시,255,86407,6049,92711,"2022-04-01",2022
"22-Apr",전남,구례군,141,13336,733,14210,"2022-04-01",2022
"22-Apr",전남,나주시,470,66511,3150,70131,"2022-04-01",2022
"22-Apr",전남,담양군,221,27752,1682,29655,"2022-04-01",2022
"22-Apr",전남,목포시,401,95213,5487,101101,"2022-04-01",2022
"22-Apr",전남,무안군,553,50194,1102,51849,"2022-04-01",2022
"22-Apr",전남,보성군,224,21767,3969,25960,"2022-04-01",2022
"22-Apr",전남,순천시,499,142872,5404,148775,"2022-04-01",2022
"22-Apr",전남,신안군,339,21982,88532,110853,"2022-04-01",2022
"22-Apr",전남,여수시,526,133119,7371,141016,"2022-04-01",2022
"22-Apr",전남,영광군,206,28377,773,29356,"2022-04-01",2022
"22-Apr",전남,영암군,280,34396,2084,36760,"2022-04-01",2022
"22-Apr",전남,완도군,282,25679,548,26509,"2022-04-01",2022
"22-Apr",전남,장성군,207,27086,1244,28537,"2022-04-01",2022
"22-Apr",전남,장흥군,259,20295,452,21006,"2022-04-01",2022
"22-Apr",전남,진도군,200,17213,293,17706,"2022-04-01",2022
"22-Apr",전남,함평군,211,18365,32190,50766,"2022-04-01",2022
"22-Apr",전남,해남군,320,39936,43758,84014,"2022-04-01",2022
"22-Apr",전남,화순군,227,33632,2122,35981,"2022-04-01",2022
"22-Apr",전남,계,6523,970865,209312,1186700,"2022-04-01",2022
"22-Apr",경북,경산시,326,140348,4415,145089,"2022-04-01",2022
"22-Apr",경북,경주시,588,143763,4604,148955,"2022-04-01",2022
"22-Apr",경북,고령군,172,20564,746,21482,"2022-04-01",2022
"22-Apr",경북,구미시,538,215573,7243,223354,"2022-04-01",2022
"22-Apr",경북,군위군,124,15378,309,15811,"2022-04-01",2022
"22-Apr",경북,김천시,391,76105,2023,78519,"2022-04-01",2022
"22-Apr",경북,문경시,278,38093,879,39250,"2022-04-01",2022
"22-Apr",경북,봉화군,195,18250,205,18650,"2022-04-01",2022
"22-Apr",경북,상주시,387,53936,1879,56202,"2022-04-01",2022
"22-Apr",경북,성주군,198,31243,1307,32748,"2022-04-01",2022
"22-Apr",경북,안동시,742,83279,2740,86761,"2022-04-01",2022
"22-Apr",경북,영덕군,250,19102,296,19648,"2022-04-01",2022
"22-Apr",경북,영양군,143,9923,144,10210,"2022-04-01",2022
"22-Apr",경북,영주시,373,56072,1529,57974,"2022-04-01",2022
"22-Apr",경북,영천시,331,60717,2588,63636,"2022-04-01",2022
"22-Apr",경북,예천군,277,30819,492,31588,"2022-04-01",2022
"22-Apr",경북,울릉군,158,5375,605,6138,"2022-04-01",2022
"22-Apr",경북,울진군,312,26455,361,27128,"2022-04-01",2022
"22-Apr",경북,의성군,311,31430,1090,32831,"2022-04-01",2022
"22-Apr",경북,청도군,215,25465,948,26628,"2022-04-01",2022
"22-Apr",경북,청송군,196,16019,210,16425,"2022-04-01",2022
"22-Apr",경북,칠곡군,300,69442,2438,72180,"2022-04-01",2022
"22-Apr",경북,포항시 남구,434,123699,8374,132507,"2022-04-01",2022
"22-Apr",경북,포항시 북구,336,142579,3565,146480,"2022-04-01",2022
"22-Apr",경북,계,7575,1453629,48990,1510194,"2022-04-01",2022
"22-Apr",경남,거제시,361,106808,2091,109260,"2022-04-01",2022
"22-Apr",경남,거창군,272,32879,760,33911,"2022-04-01",2022
"22-Apr",경남,고성군,225,26728,557,27510,"2022-04-01",2022
"22-Apr",경남,김해시,643,278951,7519,287113,"2022-04-01",2022
"22-Apr",경남,남해군,270,20340,445,21055,"2022-04-01",2022
"22-Apr",경남,밀양시,318,56606,3945,60869,"2022-04-01",2022
"22-Apr",경남,사천시,316,57099,1547,58962,"2022-04-01",2022
"22-Apr",경남,산청군,241,20475,781,21497,"2022-04-01",2022
"22-Apr",경남,양산시,421,170037,10544,181002,"2022-04-01",2022
"22-Apr",경남,의령군,206,14974,758,15938,"2022-04-01",2022
"22-Apr",경남,진주시,637,168180,6488,175305,"2022-04-01",2022
"22-Apr",경남,창녕군,226,35920,749,36895,"2022-04-01",2022
"22-Apr",경남,창원시 마산합포구,352,94690,2820,97862,"2022-04-01",2022
"22-Apr",경남,창원시 마산회원구,155,98568,5514,104237,"2022-04-01",2022
"22-Apr",경남,창원시 성산구,638,153435,51788,205861,"2022-04-01",2022
"22-Apr",경남,창원시 의창구,459,117224,3480,121163,"2022-04-01",2022
"22-Apr",경남,창원시 진해구,215,94541,1989,96745,"2022-04-01",2022
"22-Apr",경남,통영시,319,52643,1388,54350,"2022-04-01",2022
"22-Apr",경남,하동군,227,24146,383,24756,"2022-04-01",2022
"22-Apr",경남,함안군,201,43397,25696,69294,"2022-04-01",2022
"22-Apr",경남,함양군,219,19783,423,20425,"2022-04-01",2022
"22-Apr",경남,합천군,278,23653,622,24553,"2022-04-01",2022
"22-Apr",경남,계,7199,1711077,130287,1848563,"2022-04-01",2022
"22-Apr",제주,서귀포시,777,106373,2038,109188,"2022-04-01",2022
"22-Apr",제주,제주시,1608,296349,265471,563428,"2022-04-01",2022
"22-Apr",제주,계,2385,402722,267509,672616,"2022-04-01",2022
"22-May",서울,강남구,397,223723,21660,245780,"2022-05-01",2022
"22-May",서울,강동구,303,143264,8504,152071,"2022-05-01",2022
"22-May",서울,강북구,310,70525,4226,75061,"2022-05-01",2022
"22-May",서울,강서구,349,188879,17619,206847,"2022-05-01",2022
"22-May",서울,관악구,306,112282,5708,118296,"2022-05-01",2022
"22-May",서울,광진구,305,93200,5725,99230,"2022-05-01",2022
"22-May",서울,구로구,283,132133,13562,145978,"2022-05-01",2022
"22-May",서울,금천구,163,84293,6307,90763,"2022-05-01",2022
"22-May",서울,노원구,321,143235,8858,152414,"2022-05-01",2022
"22-May",서울,도봉구,280,87990,7461,95731,"2022-05-01",2022
"22-May",서울,동대문구,312,93462,4945,98719,"2022-05-01",2022
"22-May",서울,동작구,305,103372,2789,106466,"2022-05-01",2022
"22-May",서울,마포구,333,113751,7393,121477,"2022-05-01",2022
"22-May",서울,서대문구,430,83594,5697,89721,"2022-05-01",2022
"22-May",서울,서초구,519,165151,10853,176523,"2022-05-01",2022
"22-May",서울,성동구,366,93723,11959,106048,"2022-05-01",2022
"22-May",서울,성북구,301,117006,5115,122422,"2022-05-01",2022
"22-May",서울,송파구,391,234801,14270,249462,"2022-05-01",2022
"22-May",서울,양천구,318,142561,8496,151375,"2022-05-01",2022
"22-May",서울,영등포구,378,136383,8815,145576,"2022-05-01",2022
"22-May",서울,용산구,334,72856,2173,75363,"2022-05-01",2022
"22-May",서울,은평구,293,126836,7040,134169,"2022-05-01",2022
"22-May",서울,종로구,3842,44312,2455,50609,"2022-05-01",2022
"22-May",서울,중구,1234,53094,5085,59413,"2022-05-01",2022
"22-May",서울,중랑구,247,105577,9457,115281,"2022-05-01",2022
"22-May",서울,계,12620,2966003,206172,3184795,"2022-05-01",2022
"22-May",부산,강서구,317,82954,4454,87725,"2022-05-01",2022
"22-May",부산,금정구,274,79622,7315,87211,"2022-05-01",2022
"22-May",부산,기장군,258,81482,2669,84409,"2022-05-01",2022
"22-May",부산,남구,221,91301,9671,101193,"2022-05-01",2022
"22-May",부산,동구,184,55625,5797,61606,"2022-05-01",2022
"22-May",부산,동래구,170,96265,3622,100057,"2022-05-01",2022
"22-May",부산,부산진구,368,122721,21410,144499,"2022-05-01",2022
"22-May",부산,북구,235,101990,3722,105947,"2022-05-01",2022
"22-May",부산,사상구,282,83087,5606,88975,"2022-05-01",2022
"22-May",부산,사하구,264,107981,6277,114522,"2022-05-01",2022
"22-May",부산,서구,137,28816,1459,30412,"2022-05-01",2022
"22-May",부산,수영구,163,66003,45168,111334,"2022-05-01",2022
"22-May",부산,연제구,951,94775,13249,108975,"2022-05-01",2022
"22-May",부산,영도구,226,31369,2007,33602,"2022-05-01",2022
"22-May",부산,중구,307,30957,6996,38260,"2022-05-01",2022
"22-May",부산,해운대구,323,166042,16764,183129,"2022-05-01",2022
"22-May",부산,계,4680,1320990,156186,1481856,"2022-05-01",2022
"22-May",대구,남구,353,55027,1609,56989,"2022-05-01",2022
"22-May",대구,달서구,491,272545,14696,287732,"2022-05-01",2022
"22-May",대구,달성군,568,137402,5226,143196,"2022-05-01",2022
"22-May",대구,동구,360,156697,10877,167934,"2022-05-01",2022
"22-May",대구,북구,492,203851,7608,211951,"2022-05-01",2022
"22-May",대구,서구,250,67737,4479,72466,"2022-05-01",2022
"22-May",대구,수성구,582,210618,4765,215965,"2022-05-01",2022
"22-May",대구,중구,305,58922,2699,61926,"2022-05-01",2022
"22-May",대구,계,3401,1162799,51959,1218159,"2022-05-01",2022
"22-May",인천,강화군,349,37045,11575,48969,"2022-05-01",2022
"22-May",인천,계양구,300,121571,180063,301934,"2022-05-01",2022
"22-May",인천,남동구,863,247454,44984,293301,"2022-05-01",2022
"22-May",인천,동구,101,23811,2632,26544,"2022-05-01",2022
"22-May",인천,미추홀구,426,160951,8981,170358,"2022-05-01",2022
"22-May",인천,부평구,344,225655,35556,261555,"2022-05-01",2022
"22-May",인천,서구,467,272805,12796,286068,"2022-05-01",2022
"22-May",인천,연수구,427,201893,8589,210909,"2022-05-01",2022
"22-May",인천,옹진군,222,12609,235,13066,"2022-05-01",2022
"22-May",인천,중구,631,69863,12221,82715,"2022-05-01",2022
"22-May",인천,계,4130,1373657,317632,1695419,"2022-05-01",2022
"22-May",광주,광산구,517,198945,13098,212560,"2022-05-01",2022
"22-May",광주,남구,230,93024,3064,96318,"2022-05-01",2022
"22-May",광주,동구,227,43484,1042,44753,"2022-05-01",2022
"22-May",광주,북구,589,192248,9299,202136,"2022-05-01",2022
"22-May",광주,서구,732,142841,6310,149883,"2022-05-01",2022
"22-May",광주,계,2295,670542,32813,705650,"2022-05-01",2022
"22-May",대전,대덕구,238,87432,7535,95205,"2022-05-01",2022
"22-May",대전,동구,244,91411,4783,96438,"2022-05-01",2022
"22-May",대전,서구,808,207870,8752,217430,"2022-05-01",2022
"22-May",대전,유성구,663,182247,5393,188303,"2022-05-01",2022
"22-May",대전,중구,229,95811,5526,101566,"2022-05-01",2022
"22-May",대전,계,2182,664771,31989,698942,"2022-05-01",2022
"22-May",울산,남구,714,154037,7539,162290,"2022-05-01",2022
"22-May",울산,동구,190,61897,1167,63254,"2022-05-01",2022
"22-May",울산,북구,224,118300,3455,121979,"2022-05-01",2022
"22-May",울산,울주군,420,125870,7135,133425,"2022-05-01",2022
"22-May",울산,중구,322,100083,2551,102956,"2022-05-01",2022
"22-May",울산,계,1870,560187,21847,583904,"2022-05-01",2022
"22-May",세종,세종특별자치시,864,185685,3310,189859,"2022-05-01",2022
"22-May",세종,계,864,185685,3310,189859,"2022-05-01",2022
"22-May",경기,가평군,389,31755,573,32717,"2022-05-01",2022
"22-May",경기,고양시 덕양구,660,186297,4120,191077,"2022-05-01",2022
"22-May",경기,고양시 일산동구,271,127731,6194,134196,"2022-05-01",2022
"22-May",경기,고양시 일산서구,130,116789,4219,121138,"2022-05-01",2022
"22-May",경기,과천시,730,29077,704,30511,"2022-05-01",2022
"22-May",경기,광명시,305,100916,4508,105729,"2022-05-01",2022
"22-May",경기,광주시,396,198593,8543,207532,"2022-05-01",2022
"22-May",경기,구리시,267,70481,2788,73536,"2022-05-01",2022
"22-May",경기,군포시,295,98869,5162,104326,"2022-05-01",2022
"22-May",경기,김포시,533,231583,8410,240526,"2022-05-01",2022
"22-May",경기,남양주시,772,312176,9038,321986,"2022-05-01",2022
"22-May",경기,동두천시,216,38998,1507,40721,"2022-05-01",2022
"22-May",경기,부천시,711,297415,12780,310906,"2022-05-01",2022
"22-May",경기,성남시 분당구,370,189015,7213,196598,"2022-05-01",2022
"22-May",경기,성남시 수정구,352,77421,2624,80397,"2022-05-01",2022
"22-May",경기,성남시 중원구,347,71288,4044,75679,"2022-05-01",2022
"22-May",경기,수원시 권선구,478,203524,9465,213467,"2022-05-01",2022
"22-May",경기,수원시 영통구,257,147551,3261,151069,"2022-05-01",2022
"22-May",경기,수원시 장안구,476,103827,3882,108185,"2022-05-01",2022
"22-May",경기,수원시 팔달구,492,73316,3235,77043,"2022-05-01",2022
"22-May",경기,시흥시,465,256643,8432,265540,"2022-05-01",2022
"22-May",경기,안산시 단원구,580,160582,7578,168740,"2022-05-01",2022
"22-May",경기,안산시 상록구,150,145147,5822,151119,"2022-05-01",2022
"22-May",경기,안성시,395,109721,4737,114853,"2022-05-01",2022
"22-May",경기,안양시 동안구,402,120899,6644,127945,"2022-05-01",2022
"22-May",경기,안양시 만안구,159,84364,3908,88431,"2022-05-01",2022
"22-May",경기,양주시,399,113107,3443,116949,"2022-05-01",2022
"22-May",경기,양평군,577,62961,1959,65497,"2022-05-01",2022
"22-May",경기,여주시,460,65256,7138,72854,"2022-05-01",2022
"22-May",경기,연천군,306,24224,5278,29808,"2022-05-01",2022
"22-May",경기,오산시,215,110203,3965,114383,"2022-05-01",2022
"22-May",경기,용인시 기흥구,115,192761,6906,199782,"2022-05-01",2022
"22-May",경기,용인시 수지구,55,147191,2430,149676,"2022-05-01",2022
"22-May",경기,용인시 처인구,805,136308,8009,145122,"2022-05-01",2022
"22-May",경기,의왕시,297,65902,2962,69161,"2022-05-01",2022
"22-May",경기,의정부시,742,168783,5512,175037,"2022-05-01",2022
"22-May",경기,이천시,420,118189,6417,125026,"2022-05-01",2022
"22-May",경기,파주시,531,228871,10807,240209,"2022-05-01",2022
"22-May",경기,평택시,766,305813,13145,319724,"2022-05-01",2022
"22-May",경기,포천시,392,88808,9187,98387,"2022-05-01",2022
"22-May",경기,하남시,419,135091,3420,138930,"2022-05-01",2022
"22-May",경기,화성시,957,474331,13130,488418,"2022-05-01",2022
"22-May",경기,계,18054,6021777,243099,6282930,"2022-05-01",2022
"22-May",강원,강릉시,533,110889,4670,116092,"2022-05-01",2022
"22-May",강원,고성군,191,15404,232,15827,"2022-05-01",2022
"22-May",강원,동해시,315,46444,1474,48233,"2022-05-01",2022
"22-May",강원,삼척시,400,32896,775,34071,"2022-05-01",2022
"22-May",강원,속초시,302,39311,1406,41019,"2022-05-01",2022
"22-May",강원,양구군,203,12133,149,12485,"2022-05-01",2022
"22-May",강원,양양군,187,16303,322,16812,"2022-05-01",2022
"22-May",강원,영월군,332,21509,371,22212,"2022-05-01",2022
"22-May",강원,원주시,603,182057,5597,188257,"2022-05-01",2022
"22-May",강원,인제군,214,19244,315,19773,"2022-05-01",2022
"22-May",강원,정선군,338,20819,477,21634,"2022-05-01",2022
"22-May",강원,철원군,246,24359,334,24939,"2022-05-01",2022
"22-May",강원,춘천시,842,137758,6391,144991,"2022-05-01",2022
"22-May",강원,태백시,223,19870,745,20838,"2022-05-01",2022
"22-May",강원,평창군,304,26134,513,26951,"2022-05-01",2022
"22-May",강원,홍천군,418,39602,1042,41062,"2022-05-01",2022
"22-May",강원,화천군,234,13310,182,13726,"2022-05-01",2022
"22-May",강원,횡성군,261,27509,831,28601,"2022-05-01",2022
"22-May",강원,계,6146,805551,25826,837523,"2022-05-01",2022
"22-May",충북,괴산군,219,23488,422,24129,"2022-05-01",2022
"22-May",충북,단양군,229,15800,769,16798,"2022-05-01",2022
"22-May",충북,보은군,231,18376,977,19584,"2022-05-01",2022
"22-May",충북,영동군,256,25303,413,25972,"2022-05-01",2022
"22-May",충북,옥천군,211,27894,1156,29261,"2022-05-01",2022
"22-May",충북,음성군,259,60100,2015,62374,"2022-05-01",2022
"22-May",충북,제천시,335,68193,3474,72002,"2022-05-01",2022
"22-May",충북,증평군,92,19968,786,20846,"2022-05-01",2022
"22-May",충북,진천군,216,51971,1378,53565,"2022-05-01",2022
"22-May",충북,청원군,1,19,0,20,"2022-05-01",2022
"22-May",충북,청주시 상당구,503,95295,2638,98436,"2022-05-01",2022
"22-May",충북,청주시 서원구,233,101834,4330,106397,"2022-05-01",2022
"22-May",충북,청주시 청원구,367,105674,4635,110676,"2022-05-01",2022
"22-May",충북,청주시 흥덕구,359,133691,7727,141777,"2022-05-01",2022
"22-May",충북,충주시,620,112435,7644,120699,"2022-05-01",2022
"22-May",충북,계,4131,860041,38364,902536,"2022-05-01",2022
"22-May",충남,계룡시,159,23145,569,23873,"2022-05-01",2022
"22-May",충남,공주시,586,54873,2643,58102,"2022-05-01",2022
"22-May",충남,금산군,202,28785,2021,31008,"2022-05-01",2022
"22-May",충남,논산시,407,61541,2393,64341,"2022-05-01",2022
"22-May",충남,당진시,402,98590,4058,103050,"2022-05-01",2022
"22-May",충남,보령시,415,53033,1382,54830,"2022-05-01",2022
"22-May",충남,부여군,300,34563,1154,36017,"2022-05-01",2022
"22-May",충남,서산시,420,97932,3598,101950,"2022-05-01",2022
"22-May",충남,서천군,237,27306,820,28363,"2022-05-01",2022
"22-May",충남,아산시,531,179079,7132,186742,"2022-05-01",2022
"22-May",충남,예산군,429,43893,1389,45711,"2022-05-01",2022
"22-May",충남,천안시 동남구,291,133980,5366,139637,"2022-05-01",2022
"22-May",충남,천안시 서북구,538,200889,5627,207054,"2022-05-01",2022
"22-May",충남,청양군,252,17119,801,18172,"2022-05-01",2022
"22-May",충남,태안군,310,34857,557,35724,"2022-05-01",2022
"22-May",충남,홍성군,416,53669,1428,55513,"2022-05-01",2022
"22-May",충남,계,5895,1143254,40938,1190087,"2022-05-01",2022
"22-May",전북,고창군,308,30877,583,31768,"2022-05-01",2022
"22-May",전북,군산시,553,133166,6429,140148,"2022-05-01",2022
"22-May",전북,김제시,292,46236,2090,48618,"2022-05-01",2022
"22-May",전북,남원시,411,41537,3140,45088,"2022-05-01",2022
"22-May",전북,무주군,195,13191,399,13785,"2022-05-01",2022
"22-May",전북,부안군,263,27728,623,28614,"2022-05-01",2022
"22-May",전북,순창군,228,14886,155,15269,"2022-05-01",2022
"22-May",전북,완주군,415,52705,3134,56254,"2022-05-01",2022
"22-May",전북,익산시,524,137826,5922,144272,"2022-05-01",2022
"22-May",전북,임실군,218,14560,427,15205,"2022-05-01",2022
"22-May",전북,장수군,242,12403,177,12822,"2022-05-01",2022
"22-May",전북,전주시 덕진구,339,175213,6909,182461,"2022-05-01",2022
"22-May",전북,전주시 완산구,777,152913,4152,157842,"2022-05-01",2022
"22-May",전북,정읍시,357,55436,3690,59483,"2022-05-01",2022
"22-May",전북,진안군,262,14441,232,14935,"2022-05-01",2022
"22-May",전북,계,5384,923118,38062,966564,"2022-05-01",2022
"22-May",전남,강진군,230,18703,1053,19986,"2022-05-01",2022
"22-May",전남,고흥군,314,32884,596,33794,"2022-05-01",2022
"22-May",전남,곡성군,160,15161,702,16023,"2022-05-01",2022
"22-May",전남,광양시,260,86367,6051,92678,"2022-05-01",2022
"22-May",전남,구례군,146,13325,749,14220,"2022-05-01",2022
"22-May",전남,나주시,472,66514,3172,70158,"2022-05-01",2022
"22-May",전남,담양군,222,27808,1670,29700,"2022-05-01",2022
"22-May",전남,목포시,401,95223,5503,101127,"2022-05-01",2022
"22-May",전남,무안군,556,50256,1099,51911,"2022-05-01",2022
"22-May",전남,보성군,227,21762,3164,25153,"2022-05-01",2022
"22-May",전남,순천시,497,143111,5381,148989,"2022-05-01",2022
"22-May",전남,신안군,337,22049,90485,112871,"2022-05-01",2022
"22-May",전남,여수시,526,133230,7378,141134,"2022-05-01",2022
"22-May",전남,영광군,205,28435,770,29410,"2022-05-01",2022
"22-May",전남,영암군,281,34499,1944,36724,"2022-05-01",2022
"22-May",전남,완도군,282,25725,550,26557,"2022-05-01",2022
"22-May",전남,장성군,207,27141,1264,28612,"2022-05-01",2022
"22-May",전남,장흥군,261,20296,448,21005,"2022-05-01",2022
"22-May",전남,진도군,204,17222,294,17720,"2022-05-01",2022
"22-May",전남,함평군,210,18379,31236,49825,"2022-05-01",2022
"22-May",전남,해남군,324,39912,46023,86259,"2022-05-01",2022
"22-May",전남,화순군,227,33644,2117,35988,"2022-05-01",2022
"22-May",전남,계,6549,971646,211649,1189844,"2022-05-01",2022
"22-May",경북,경산시,328,140443,4428,145199,"2022-05-01",2022
"22-May",경북,경주시,588,143630,4610,148828,"2022-05-01",2022
"22-May",경북,고령군,171,20518,746,21435,"2022-05-01",2022
"22-May",경북,구미시,539,215524,7262,223325,"2022-05-01",2022
"22-May",경북,군위군,124,15459,311,15894,"2022-05-01",2022
"22-May",경북,김천시,392,76253,2019,78664,"2022-05-01",2022
"22-May",경북,문경시,278,38226,881,39385,"2022-05-01",2022
"22-May",경북,봉화군,194,18232,204,18630,"2022-05-01",2022
"22-May",경북,상주시,385,53757,1881,56023,"2022-05-01",2022
"22-May",경북,성주군,198,31303,1307,32808,"2022-05-01",2022
"22-May",경북,안동시,748,83298,2706,86752,"2022-05-01",2022
"22-May",경북,영덕군,250,19077,296,19623,"2022-05-01",2022
"22-May",경북,영양군,144,9934,115,10193,"2022-05-01",2022
"22-May",경북,영주시,374,56129,1520,58023,"2022-05-01",2022
"22-May",경북,영천시,333,60805,2587,63725,"2022-05-01",2022
"22-May",경북,예천군,282,30817,489,31588,"2022-05-01",2022
"22-May",경북,울릉군,156,5405,611,6172,"2022-05-01",2022
"22-May",경북,울진군,314,26536,359,27209,"2022-05-01",2022
"22-May",경북,의성군,321,31445,1085,32851,"2022-05-01",2022
"22-May",경북,청도군,215,25471,947,26633,"2022-05-01",2022
"22-May",경북,청송군,196,16008,208,16412,"2022-05-01",2022
"22-May",경북,칠곡군,299,69633,2444,72376,"2022-05-01",2022
"22-May",경북,포항시 남구,435,123484,8388,132307,"2022-05-01",2022
"22-May",경북,포항시 북구,338,142388,3543,146269,"2022-05-01",2022
"22-May",경북,계,7602,1453775,48947,1510324,"2022-05-01",2022
"22-May",경남,거제시,362,106871,2092,109325,"2022-05-01",2022
"22-May",경남,거창군,272,32874,762,33908,"2022-05-01",2022
"22-May",경남,고성군,225,26712,556,27493,"2022-05-01",2022
"22-May",경남,김해시,643,279406,7516,287565,"2022-05-01",2022
"22-May",경남,남해군,273,20381,442,21096,"2022-05-01",2022
"22-May",경남,밀양시,318,56669,3936,60923,"2022-05-01",2022
"22-May",경남,사천시,326,57160,1536,59022,"2022-05-01",2022
"22-May",경남,산청군,241,20558,774,21573,"2022-05-01",2022
"22-May",경남,양산시,420,169974,10565,180959,"2022-05-01",2022
"22-May",경남,의령군,206,15001,755,15962,"2022-05-01",2022
"22-May",경남,진주시,637,168329,6509,175475,"2022-05-01",2022
"22-May",경남,창녕군,227,36017,755,36999,"2022-05-01",2022
"22-May",경남,창원시 마산합포구,354,94613,2873,97840,"2022-05-01",2022
"22-May",경남,창원시 마산회원구,155,99026,5534,104715,"2022-05-01",2022
"22-May",경남,창원시 성산구,637,154544,51746,206927,"2022-05-01",2022
"22-May",경남,창원시 의창구,456,117368,3494,121318,"2022-05-01",2022
"22-May",경남,창원시 진해구,215,94677,2002,96894,"2022-05-01",2022
"22-May",경남,통영시,309,52675,1389,54373,"2022-05-01",2022
"22-May",경남,하동군,224,24197,390,24811,"2022-05-01",2022
"22-May",경남,함안군,201,43819,27159,71179,"2022-05-01",2022
"22-May",경남,함양군,220,19846,422,20488,"2022-05-01",2022
"22-May",경남,합천군,279,23690,622,24591,"2022-05-01",2022
"22-May",경남,계,7200,1714407,131829,1853436,"2022-05-01",2022
"22-May",제주,서귀포시,777,106225,1865,108867,"2022-05-01",2022
"22-May",제주,제주시,1611,297412,267691,566714,"2022-05-01",2022
"22-May",제주,계,2388,403637,269556,675581,"2022-05-01",2022
"22-Jun",서울,강남구,396,224222,22451,247069,"2022-06-01",2022
"22-Jun",서울,강동구,303,143447,8533,152283,"2022-06-01",2022
"22-Jun",서울,강북구,309,70638,4239,75186,"2022-06-01",2022
"22-Jun",서울,강서구,348,189405,17255,207008,"2022-06-01",2022
"22-Jun",서울,관악구,306,112303,5685,118294,"2022-06-01",2022
"22-Jun",서울,광진구,306,93245,5776,99327,"2022-06-01",2022
"22-Jun",서울,구로구,288,132111,13562,145961,"2022-06-01",2022
"22-Jun",서울,금천구,163,84460,6304,90927,"2022-06-01",2022
"22-Jun",서울,노원구,321,143326,8839,152486,"2022-06-01",2022
"22-Jun",서울,도봉구,280,87996,7466,95742,"2022-06-01",2022
"22-Jun",서울,동대문구,311,93431,4699,98441,"2022-06-01",2022
"22-Jun",서울,동작구,305,103427,2771,106503,"2022-06-01",2022
"22-Jun",서울,마포구,336,113627,7447,121410,"2022-06-01",2022
"22-Jun",서울,서대문구,440,83630,5695,89765,"2022-06-01",2022
"22-Jun",서울,서초구,527,165001,11016,176544,"2022-06-01",2022
"22-Jun",서울,성동구,376,93784,11828,105988,"2022-06-01",2022
"22-Jun",서울,성북구,301,117104,5119,122524,"2022-06-01",2022
"22-Jun",서울,송파구,390,235036,14417,249843,"2022-06-01",2022
"22-Jun",서울,양천구,319,142521,8542,151382,"2022-06-01",2022
"22-Jun",서울,영등포구,380,136480,8839,145699,"2022-06-01",2022
"22-Jun",서울,용산구,334,72967,2400,75701,"2022-06-01",2022
"22-Jun",서울,은평구,300,127000,7036,134336,"2022-06-01",2022
"22-Jun",서울,종로구,3891,44324,2318,50533,"2022-06-01",2022
"22-Jun",서울,중구,1239,52721,4959,58919,"2022-06-01",2022
"22-Jun",서울,중랑구,247,105762,9453,115462,"2022-06-01",2022
"22-Jun",서울,계,12716,2967968,206649,3187333,"2022-06-01",2022
"22-Jun",부산,강서구,323,83137,4459,87919,"2022-06-01",2022
"22-Jun",부산,금정구,274,79648,7315,87237,"2022-06-01",2022
"22-Jun",부산,기장군,258,82055,2678,84991,"2022-06-01",2022
"22-Jun",부산,남구,222,91259,9659,101140,"2022-06-01",2022
"22-Jun",부산,동구,185,55910,5850,61945,"2022-06-01",2022
"22-Jun",부산,동래구,170,96528,3626,100324,"2022-06-01",2022
"22-Jun",부산,부산진구,370,122820,21806,144996,"2022-06-01",2022
"22-Jun",부산,북구,237,102014,3726,105977,"2022-06-01",2022
"22-Jun",부산,사상구,283,83287,5596,89166,"2022-06-01",2022
"22-Jun",부산,사하구,263,107966,6278,114507,"2022-06-01",2022
"22-Jun",부산,서구,138,29168,1458,30764,"2022-06-01",2022
"22-Jun",부산,수영구,165,65864,46117,112146,"2022-06-01",2022
"22-Jun",부산,연제구,968,95223,13515,109706,"2022-06-01",2022
"22-Jun",부산,영도구,224,31461,2013,33698,"2022-06-01",2022
"22-Jun",부산,중구,307,30956,6943,38206,"2022-06-01",2022
"22-Jun",부산,해운대구,323,165873,16542,182738,"2022-06-01",2022
"22-Jun",부산,계,4710,1323169,157581,1485460,"2022-06-01",2022
"22-Jun",대구,남구,355,55001,1608,56964,"2022-06-01",2022
"22-Jun",대구,달서구,498,272955,14557,288010,"2022-06-01",2022
"22-Jun",대구,달성군,570,137754,5250,143574,"2022-06-01",2022
"22-Jun",대구,동구,363,156928,10966,168257,"2022-06-01",2022
"22-Jun",대구,북구,493,203615,7593,211701,"2022-06-01",2022
"22-Jun",대구,서구,254,67829,4542,72625,"2022-06-01",2022
"22-Jun",대구,수성구,583,211382,4736,216701,"2022-06-01",2022
"22-Jun",대구,중구,304,58986,2742,62032,"2022-06-01",2022
"22-Jun",대구,계,3420,1164450,51994,1219864,"2022-06-01",2022
"22-Jun",인천,강화군,353,37175,11026,48554,"2022-06-01",2022
"22-Jun",인천,계양구,305,121693,179034,301032,"2022-06-01",2022
"22-Jun",인천,남동구,878,247953,44660,293491,"2022-06-01",2022
"22-Jun",인천,동구,101,23629,2623,26353,"2022-06-01",2022
"22-Jun",인천,미추홀구,432,161238,8987,170657,"2022-06-01",2022
"22-Jun",인천,부평구,350,226879,36402,263631,"2022-06-01",2022
"22-Jun",인천,서구,479,274319,12553,287351,"2022-06-01",2022
"22-Jun",인천,연수구,427,202389,8636,211452,"2022-06-01",2022
"22-Jun",인천,옹진군,222,12640,236,13098,"2022-06-01",2022
"22-Jun",인천,중구,631,70225,12250,83106,"2022-06-01",2022
"22-Jun",인천,계,4178,1378140,316407,1698725,"2022-06-01",2022
"22-Jun",광주,광산구,527,199355,13133,213015,"2022-06-01",2022
"22-Jun",광주,남구,233,93193,2955,96381,"2022-06-01",2022
"22-Jun",광주,동구,230,43713,1045,44988,"2022-06-01",2022
"22-Jun",광주,북구,607,192364,9248,202219,"2022-06-01",2022
"22-Jun",광주,서구,755,142867,6375,149997,"2022-06-01",2022
"22-Jun",광주,계,2352,671492,32756,706600,"2022-06-01",2022
"22-Jun",대전,대덕구,239,87575,7527,95341,"2022-06-01",2022
"22-Jun",대전,동구,243,91643,4786,96672,"2022-06-01",2022
"22-Jun",대전,서구,812,207719,8803,217334,"2022-06-01",2022
"22-Jun",대전,유성구,669,182542,5410,188621,"2022-06-01",2022
"22-Jun",대전,중구,227,96155,5523,101905,"2022-06-01",2022
"22-Jun",대전,계,2190,665634,32049,699873,"2022-06-01",2022
"22-Jun",울산,남구,723,154223,7558,162504,"2022-06-01",2022
"22-Jun",울산,동구,188,61928,1166,63282,"2022-06-01",2022
"22-Jun",울산,북구,222,118657,3466,122345,"2022-06-01",2022
"22-Jun",울산,울주군,416,126077,7155,133648,"2022-06-01",2022
"22-Jun",울산,중구,330,99996,2555,102881,"2022-06-01",2022
"22-Jun",울산,계,1879,560881,21900,584660,"2022-06-01",2022
"22-Jun",세종,세종특별자치시,885,186258,3391,190534,"2022-06-01",2022
"22-Jun",세종,계,885,186258,3391,190534,"2022-06-01",2022
"22-Jun",경기,가평군,389,31856,572,32817,"2022-06-01",2022
"22-Jun",경기,고양시 덕양구,662,186690,4109,191461,"2022-06-01",2022
"22-Jun",경기,고양시 일산동구,271,128117,6307,134695,"2022-06-01",2022
"22-Jun",경기,고양시 일산서구,130,116717,4225,121072,"2022-06-01",2022
"22-Jun",경기,과천시,733,29170,704,30607,"2022-06-01",2022
"22-Jun",경기,광명시,308,101117,4485,105910,"2022-06-01",2022
"22-Jun",경기,광주시,402,198993,8567,207962,"2022-06-01",2022
"22-Jun",경기,구리시,272,70469,2786,73527,"2022-06-01",2022
"22-Jun",경기,군포시,293,99004,5199,104496,"2022-06-01",2022
"22-Jun",경기,김포시,536,231893,8468,240897,"2022-06-01",2022
"22-Jun",경기,남양주시,786,312859,9085,322730,"2022-06-01",2022
"22-Jun",경기,동두천시,216,38992,1512,40720,"2022-06-01",2022
"22-Jun",경기,부천시,735,297681,12826,311242,"2022-06-01",2022
"22-Jun",경기,성남시 분당구,369,189356,7292,197017,"2022-06-01",2022
"22-Jun",경기,성남시 수정구,304,77569,2634,80507,"2022-06-01",2022
"22-Jun",경기,성남시 중원구,395,71232,4012,75639,"2022-06-01",2022
"22-Jun",경기,수원시 권선구,487,203722,9507,213716,"2022-06-01",2022
"22-Jun",경기,수원시 영통구,259,147636,3286,151181,"2022-06-01",2022
"22-Jun",경기,수원시 장안구,481,104191,3870,108542,"2022-06-01",2022
"22-Jun",경기,수원시 팔달구,493,73445,3247,77185,"2022-06-01",2022
"22-Jun",경기,시흥시,465,257527,8448,266440,"2022-06-01",2022
"22-Jun",경기,안산시 단원구,580,160869,7587,169036,"2022-06-01",2022
"22-Jun",경기,안산시 상록구,148,145317,5821,151286,"2022-06-01",2022
"22-Jun",경기,안성시,401,109876,4778,115055,"2022-06-01",2022
"22-Jun",경기,안양시 동안구,401,121213,6649,128263,"2022-06-01",2022
"22-Jun",경기,안양시 만안구,159,84308,3900,88367,"2022-06-01",2022
"22-Jun",경기,양주시,399,113770,3485,117654,"2022-06-01",2022
"22-Jun",경기,양평군,576,63056,1958,65590,"2022-06-01",2022
"22-Jun",경기,여주시,458,65491,7141,73090,"2022-06-01",2022
"22-Jun",경기,연천군,307,24280,5270,29857,"2022-06-01",2022
"22-Jun",경기,오산시,216,110431,3985,114632,"2022-06-01",2022
"22-Jun",경기,용인시 기흥구,116,192929,6973,200018,"2022-06-01",2022
"22-Jun",경기,용인시 수지구,54,147785,2426,150265,"2022-06-01",2022
"22-Jun",경기,용인시 처인구,799,136625,8012,145436,"2022-06-01",2022
"22-Jun",경기,의왕시,303,65921,2942,69166,"2022-06-01",2022
"22-Jun",경기,의정부시,743,169053,5651,175447,"2022-06-01",2022
"22-Jun",경기,이천시,421,118460,6430,125311,"2022-06-01",2022
"22-Jun",경기,파주시,533,229829,10824,241186,"2022-06-01",2022
"22-Jun",경기,평택시,770,307017,13207,320994,"2022-06-01",2022
"22-Jun",경기,포천시,391,89086,9006,98483,"2022-06-01",2022
"22-Jun",경기,하남시,418,135390,3488,139296,"2022-06-01",2022
"22-Jun",경기,화성시,963,475801,13169,489933,"2022-06-01",2022
"22-Jun",경기,계,18142,6034743,243843,6296728,"2022-06-01",2022
"22-Jun",강원,강릉시,536,111052,4718,116306,"2022-06-01",2022
"22-Jun",강원,고성군,190,15434,230,15854,"2022-06-01",2022
"22-Jun",강원,동해시,316,46500,1468,48284,"2022-06-01",2022
"22-Jun",강원,삼척시,401,32959,781,34141,"2022-06-01",2022
"22-Jun",강원,속초시,305,39451,1407,41163,"2022-06-01",2022
"22-Jun",강원,양구군,203,12152,147,12502,"2022-06-01",2022
"22-Jun",강원,양양군,189,16341,319,16849,"2022-06-01",2022
"22-Jun",강원,영월군,333,21543,383,22259,"2022-06-01",2022
"22-Jun",강원,원주시,614,182630,5598,188842,"2022-06-01",2022
"22-Jun",강원,인제군,216,19261,313,19790,"2022-06-01",2022
"22-Jun",강원,정선군,344,20858,477,21679,"2022-06-01",2022
"22-Jun",강원,철원군,246,24413,332,24991,"2022-06-01",2022
"22-Jun",강원,춘천시,846,138129,6398,145373,"2022-06-01",2022
"22-Jun",강원,태백시,226,19850,746,20822,"2022-06-01",2022
"22-Jun",강원,평창군,304,26154,524,26982,"2022-06-01",2022
"22-Jun",강원,홍천군,416,39685,1041,41142,"2022-06-01",2022
"22-Jun",강원,화천군,235,13300,182,13717,"2022-06-01",2022
"22-Jun",강원,횡성군,262,27547,837,28646,"2022-06-01",2022
"22-Jun",강원,계,6182,807259,25901,839342,"2022-06-01",2022
"22-Jun",충북,괴산군,220,23479,427,24126,"2022-06-01",2022
"22-Jun",충북,단양군,229,15834,782,16845,"2022-06-01",2022
"22-Jun",충북,보은군,231,18389,976,19596,"2022-06-01",2022
"22-Jun",충북,영동군,256,25343,410,26009,"2022-06-01",2022
"22-Jun",충북,옥천군,210,27916,1150,29276,"2022-06-01",2022
"22-Jun",충북,음성군,263,60283,2023,62569,"2022-06-01",2022
"22-Jun",충북,제천시,337,68338,3442,72117,"2022-06-01",2022
"22-Jun",충북,증평군,93,19991,780,20864,"2022-06-01",2022
"22-Jun",충북,진천군,217,52179,1377,53773,"2022-06-01",2022
"22-Jun",충북,청원군,1,19,0,20,"2022-06-01",2022
"22-Jun",충북,청주시 상당구,503,95446,2643,98592,"2022-06-01",2022
"22-Jun",충북,청주시 서원구,232,101768,4321,106321,"2022-06-01",2022
"22-Jun",충북,청주시 청원구,370,105800,4655,110825,"2022-06-01",2022
"22-Jun",충북,청주시 흥덕구,360,134381,7722,142463,"2022-06-01",2022
"22-Jun",충북,충주시,628,112655,7648,120931,"2022-06-01",2022
"22-Jun",충북,계,4150,861821,38356,904327,"2022-06-01",2022
"22-Jun",충남,계룡시,161,23183,569,23913,"2022-06-01",2022
"22-Jun",충남,공주시,585,54876,2654,58115,"2022-06-01",2022
"22-Jun",충남,금산군,199,28798,2032,31029,"2022-06-01",2022
"22-Jun",충남,논산시,404,61651,2405,64460,"2022-06-01",2022
"22-Jun",충남,당진시,398,98987,4057,103442,"2022-06-01",2022
"22-Jun",충남,보령시,412,53061,1397,54870,"2022-06-01",2022
"22-Jun",충남,부여군,303,34491,1148,35942,"2022-06-01",2022
"22-Jun",충남,서산시,418,98049,3626,102093,"2022-06-01",2022
"22-Jun",충남,서천군,235,27327,822,28384,"2022-06-01",2022
"22-Jun",충남,아산시,531,179979,7109,187619,"2022-06-01",2022
"22-Jun",충남,예산군,424,43990,1392,45806,"2022-06-01",2022
"22-Jun",충남,천안시 동남구,289,134513,5384,140186,"2022-06-01",2022
"22-Jun",충남,천안시 서북구,533,201214,5626,207373,"2022-06-01",2022
"22-Jun",충남,청양군,252,17120,794,18166,"2022-06-01",2022
"22-Jun",충남,태안군,313,34969,562,35844,"2022-06-01",2022
"22-Jun",충남,홍성군,419,53725,1430,55574,"2022-06-01",2022
"22-Jun",충남,계,5876,1145933,41007,1192816,"2022-06-01",2022
"22-Jun",전북,고창군,309,30931,588,31828,"2022-06-01",2022
"22-Jun",전북,군산시,553,133448,6441,140442,"2022-06-01",2022
"22-Jun",전북,김제시,310,46332,2074,48716,"2022-06-01",2022
"22-Jun",전북,남원시,412,41604,3005,45021,"2022-06-01",2022
"22-Jun",전북,무주군,198,13184,401,13783,"2022-06-01",2022
"22-Jun",전북,부안군,265,27753,615,28633,"2022-06-01",2022
"22-Jun",전북,순창군,228,14899,159,15286,"2022-06-01",2022
"22-Jun",전북,완주군,417,52740,3120,56277,"2022-06-01",2022
"22-Jun",전북,익산시,536,138194,5916,144646,"2022-06-01",2022
"22-Jun",전북,임실군,219,14538,426,15183,"2022-06-01",2022
"22-Jun",전북,장수군,244,12413,179,12836,"2022-06-01",2022
"22-Jun",전북,전주시 덕진구,337,175439,6862,182638,"2022-06-01",2022
"22-Jun",전북,전주시 완산구,784,153428,4175,158387,"2022-06-01",2022
"22-Jun",전북,정읍시,356,55542,3679,59577,"2022-06-01",2022
"22-Jun",전북,진안군,267,14423,231,14921,"2022-06-01",2022
"22-Jun",전북,계,5435,924868,37871,968174,"2022-06-01",2022
"22-Jun",전남,강진군,232,18761,1050,20043,"2022-06-01",2022
"22-Jun",전남,고흥군,310,32892,594,33796,"2022-06-01",2022
"22-Jun",전남,곡성군,162,15164,702,16028,"2022-06-01",2022
"22-Jun",전남,광양시,260,86645,6072,92977,"2022-06-01",2022
"22-Jun",전남,구례군,147,13261,760,14168,"2022-06-01",2022
"22-Jun",전남,나주시,472,66577,3174,70223,"2022-06-01",2022
"22-Jun",전남,담양군,222,27882,1678,29782,"2022-06-01",2022
"22-Jun",전남,목포시,404,95197,5519,101120,"2022-06-01",2022
"22-Jun",전남,무안군,567,50383,1101,52051,"2022-06-01",2022
"22-Jun",전남,보성군,228,21769,2721,24718,"2022-06-01",2022
"22-Jun",전남,순천시,505,143267,5381,149153,"2022-06-01",2022
"22-Jun",전남,신안군,337,22085,92590,115012,"2022-06-01",2022
"22-Jun",전남,여수시,539,133452,7367,141358,"2022-06-01",2022
"22-Jun",전남,영광군,205,28536,772,29513,"2022-06-01",2022
"22-Jun",전남,영암군,282,34521,1763,36566,"2022-06-01",2022
"22-Jun",전남,완도군,283,25763,544,26590,"2022-06-01",2022
"22-Jun",전남,장성군,207,27162,1277,28646,"2022-06-01",2022
"22-Jun",전남,장흥군,266,20309,449,21024,"2022-06-01",2022
"22-Jun",전남,진도군,206,17206,295,17707,"2022-06-01",2022
"22-Jun",전남,함평군,209,18392,30362,48963,"2022-06-01",2022
"22-Jun",전남,해남군,324,40009,48358,88691,"2022-06-01",2022
"22-Jun",전남,화순군,236,33663,2097,35996,"2022-06-01",2022
"22-Jun",전남,계,6603,972896,214626,1194125,"2022-06-01",2022
"22-Jun",경북,경산시,339,140660,4386,145385,"2022-06-01",2022
"22-Jun",경북,경주시,595,143644,4617,148856,"2022-06-01",2022
"22-Jun",경북,고령군,172,20547,739,21458,"2022-06-01",2022
"22-Jun",경북,구미시,544,215717,7262,223523,"2022-06-01",2022
"22-Jun",경북,군위군,123,15474,312,15909,"2022-06-01",2022
"22-Jun",경북,김천시,394,76282,2011,78687,"2022-06-01",2022
"22-Jun",경북,문경시,279,38164,881,39324,"2022-06-01",2022
"22-Jun",경북,봉화군,199,18260,206,18665,"2022-06-01",2022
"22-Jun",경북,상주시,392,53824,1882,56098,"2022-06-01",2022
"22-Jun",경북,성주군,200,31353,1308,32861,"2022-06-01",2022
"22-Jun",경북,안동시,770,83421,2699,86890,"2022-06-01",2022
"22-Jun",경북,영덕군,251,19083,297,19631,"2022-06-01",2022
"22-Jun",경북,영양군,146,9929,113,10188,"2022-06-01",2022
"22-Jun",경북,영주시,385,56256,1521,58162,"2022-06-01",2022
"22-Jun",경북,영천시,334,60979,2585,63898,"2022-06-01",2022
"22-Jun",경북,예천군,286,30893,492,31671,"2022-06-01",2022
"22-Jun",경북,울릉군,158,5453,618,6229,"2022-06-01",2022
"22-Jun",경북,울진군,314,26603,357,27274,"2022-06-01",2022
"22-Jun",경북,의성군,321,31454,1075,32850,"2022-06-01",2022
"22-Jun",경북,청도군,216,25489,945,26650,"2022-06-01",2022
"22-Jun",경북,청송군,198,16023,209,16430,"2022-06-01",2022
"22-Jun",경북,칠곡군,300,69713,2451,72464,"2022-06-01",2022
"22-Jun",경북,포항시 남구,436,123658,8364,132458,"2022-06-01",2022
"22-Jun",경북,포항시 북구,339,142466,3563,146368,"2022-06-01",2022
"22-Jun",경북,계,7691,1455345,48893,1511929,"2022-06-01",2022
"22-Jun",경남,거제시,362,106990,2081,109433,"2022-06-01",2022
"22-Jun",경남,거창군,271,32917,758,33946,"2022-06-01",2022
"22-Jun",경남,고성군,228,26778,557,27563,"2022-06-01",2022
"22-Jun",경남,김해시,652,279860,7493,288005,"2022-06-01",2022
"22-Jun",경남,남해군,277,20413,444,21134,"2022-06-01",2022
"22-Jun",경남,밀양시,314,56767,3921,61002,"2022-06-01",2022
"22-Jun",경남,사천시,315,57380,1532,59227,"2022-06-01",2022
"22-Jun",경남,산청군,242,20550,775,21567,"2022-06-01",2022
"22-Jun",경남,양산시,419,170563,10609,181591,"2022-06-01",2022
"22-Jun",경남,의령군,206,14985,751,15942,"2022-06-01",2022
"22-Jun",경남,진주시,642,168779,6484,175905,"2022-06-01",2022
"22-Jun",경남,창녕군,229,36036,757,37022,"2022-06-01",2022
"22-Jun",경남,창원시 마산합포구,358,94536,2875,97769,"2022-06-01",2022
"22-Jun",경남,창원시 마산회원구,158,99474,5600,105232,"2022-06-01",2022
"22-Jun",경남,창원시 성산구,638,155200,52075,207913,"2022-06-01",2022
"22-Jun",경남,창원시 의창구,465,117316,3474,121255,"2022-06-01",2022
"22-Jun",경남,창원시 진해구,219,94855,2013,97087,"2022-06-01",2022
"22-Jun",경남,통영시,310,52695,1388,54393,"2022-06-01",2022
"22-Jun",경남,하동군,227,24214,384,24825,"2022-06-01",2022
"22-Jun",경남,함안군,202,43772,28590,72564,"2022-06-01",2022
"22-Jun",경남,함양군,224,19864,420,20508,"2022-06-01",2022
"22-Jun",경남,합천군,283,23703,623,24609,"2022-06-01",2022
"22-Jun",경남,계,7241,1717647,133604,1858492,"2022-06-01",2022
"22-Jun",제주,서귀포시,777,106025,1871,108673,"2022-06-01",2022
"22-Jun",제주,제주시,1620,298036,268381,568037,"2022-06-01",2022
"22-Jun",제주,계,2397,404061,270252,676710,"2022-06-01",2022
"22-Jul",서울,강남구,407,224426,22554,247387,"2022-07-01",2022
"22-Jul",서울,강동구,305,143617,8534,152456,"2022-07-01",2022
"22-Jul",서울,강북구,313,70760,4242,75315,"2022-07-01",2022
"22-Jul",서울,강서구,350,189648,17289,207287,"2022-07-01",2022
"22-Jul",서울,관악구,303,112342,5697,118342,"2022-07-01",2022
"22-Jul",서울,광진구,298,93189,5835,99322,"2022-07-01",2022
"22-Jul",서울,구로구,292,132097,13581,145970,"2022-07-01",2022
"22-Jul",서울,금천구,165,84739,6286,91190,"2022-07-01",2022
"22-Jul",서울,노원구,324,143365,8827,152516,"2022-07-01",2022
"22-Jul",서울,도봉구,280,88050,7490,95820,"2022-07-01",2022
"22-Jul",서울,동대문구,312,93546,4664,98522,"2022-07-01",2022
"22-Jul",서울,동작구,304,103482,2752,106538,"2022-07-01",2022
"22-Jul",서울,마포구,339,113697,7545,121581,"2022-07-01",2022
"22-Jul",서울,서대문구,443,83700,5696,89839,"2022-07-01",2022
"22-Jul",서울,서초구,520,165077,10904,176501,"2022-07-01",2022
"22-Jul",서울,성동구,377,93851,11723,105951,"2022-07-01",2022
"22-Jul",서울,성북구,300,117268,5114,122682,"2022-07-01",2022
"22-Jul",서울,송파구,393,235173,14514,250080,"2022-07-01",2022
"22-Jul",서울,양천구,318,142789,8552,151659,"2022-07-01",2022
"22-Jul",서울,영등포구,377,136799,8819,145995,"2022-07-01",2022
"22-Jul",서울,용산구,347,72835,2245,75427,"2022-07-01",2022
"22-Jul",서울,은평구,303,127158,7042,134503,"2022-07-01",2022
"22-Jul",서울,종로구,3909,44385,2191,50485,"2022-07-01",2022
"22-Jul",서울,중구,1239,52493,4938,58670,"2022-07-01",2022
"22-Jul",서울,중랑구,247,105894,9491,115632,"2022-07-01",2022
"22-Jul",서울,계,12765,2970380,206525,3189670,"2022-07-01",2022
"22-Jul",부산,강서구,322,83420,4459,88201,"2022-07-01",2022
"22-Jul",부산,금정구,273,79614,7318,87205,"2022-07-01",2022
"22-Jul",부산,기장군,260,82301,2681,85242,"2022-07-01",2022
"22-Jul",부산,남구,226,91238,9702,101166,"2022-07-01",2022
"22-Jul",부산,동구,184,56074,5826,62084,"2022-07-01",2022
"22-Jul",부산,동래구,171,96810,3631,100612,"2022-07-01",2022
"22-Jul",부산,부산진구,373,123093,21856,145322,"2022-07-01",2022
"22-Jul",부산,북구,233,102083,3728,106044,"2022-07-01",2022
"22-Jul",부산,사상구,283,83279,5631,89193,"2022-07-01",2022
"22-Jul",부산,사하구,267,107941,6188,114396,"2022-07-01",2022
"22-Jul",부산,서구,143,29554,1460,31157,"2022-07-01",2022
"22-Jul",부산,수영구,166,65741,47148,113055,"2022-07-01",2022
"22-Jul",부산,연제구,968,95569,13268,109805,"2022-07-01",2022
"22-Jul",부산,영도구,227,31542,1992,33761,"2022-07-01",2022
"22-Jul",부산,중구,309,30792,6959,38060,"2022-07-01",2022
"22-Jul",부산,해운대구,321,165812,16322,182455,"2022-07-01",2022
"22-Jul",부산,계,4726,1324863,158169,1487758,"2022-07-01",2022
"22-Jul",대구,남구,352,55189,1616,57157,"2022-07-01",2022
"22-Jul",대구,달서구,504,273817,14721,289042,"2022-07-01",2022
"22-Jul",대구,달성군,573,138103,5263,143939,"2022-07-01",2022
"22-Jul",대구,동구,360,157283,11119,168762,"2022-07-01",2022
"22-Jul",대구,북구,496,203574,7885,211955,"2022-07-01",2022
"22-Jul",대구,서구,254,68264,4491,73009,"2022-07-01",2022
"22-Jul",대구,수성구,584,211660,4729,216973,"2022-07-01",2022
"22-Jul",대구,중구,305,58909,2673,61887,"2022-07-01",2022
"22-Jul",대구,계,3428,1166799,52497,1222724,"2022-07-01",2022
"22-Jul",인천,강화군,358,37290,10517,48165,"2022-07-01",2022
"22-Jul",인천,계양구,306,121834,178234,300374,"2022-07-01",2022
"22-Jul",인천,남동구,876,248408,44423,293707,"2022-07-01",2022
"22-Jul",인천,동구,106,23616,2641,26363,"2022-07-01",2022
"22-Jul",인천,미추홀구,435,161442,8977,170854,"2022-07-01",2022
"22-Jul",인천,부평구,351,228414,37375,266140,"2022-07-01",2022
"22-Jul",인천,서구,480,276939,12500,289919,"2022-07-01",2022
"22-Jul",인천,연수구,426,202663,8704,211793,"2022-07-01",2022
"22-Jul",인천,옹진군,225,12710,236,13171,"2022-07-01",2022
"22-Jul",인천,중구,627,70667,12265,83559,"2022-07-01",2022
"22-Jul",인천,계,4190,1383983,315872,1704045,"2022-07-01",2022
"22-Jul",광주,광산구,533,199749,13274,213556,"2022-07-01",2022
"22-Jul",광주,남구,226,93231,2939,96396,"2022-07-01",2022
"22-Jul",광주,동구,230,43912,1034,45176,"2022-07-01",2022
"22-Jul",광주,북구,597,192744,9326,202667,"2022-07-01",2022
"22-Jul",광주,서구,754,143328,6380,150462,"2022-07-01",2022
"22-Jul",광주,계,2340,672964,32953,708257,"2022-07-01",2022
"22-Jul",대전,대덕구,240,87786,7592,95618,"2022-07-01",2022
"22-Jul",대전,동구,246,91761,4808,96815,"2022-07-01",2022
"22-Jul",대전,서구,815,208078,9061,217954,"2022-07-01",2022
"22-Jul",대전,유성구,664,183090,5442,189196,"2022-07-01",2022
"22-Jul",대전,중구,229,96572,5544,102345,"2022-07-01",2022
"22-Jul",대전,계,2194,667287,32447,701928,"2022-07-01",2022
"22-Jul",울산,남구,721,154454,7178,162353,"2022-07-01",2022
"22-Jul",울산,동구,192,61983,1176,63351,"2022-07-01",2022
"22-Jul",울산,북구,225,118871,3500,122596,"2022-07-01",2022
"22-Jul",울산,울주군,418,126324,7134,133876,"2022-07-01",2022
"22-Jul",울산,중구,331,100043,2564,102938,"2022-07-01",2022
"22-Jul",울산,계,1887,561675,21552,585114,"2022-07-01",2022
"22-Jul",세종,세종특별자치시,886,186971,3422,191279,"2022-07-01",2022
"22-Jul",세종,계,886,186971,3422,191279,"2022-07-01",2022
"22-Jul",경기,가평군,386,31947,570,32903,"2022-07-01",2022
"22-Jul",경기,고양시 덕양구,665,187095,4126,191886,"2022-07-01",2022
"22-Jul",경기,고양시 일산동구,272,128339,6342,134953,"2022-07-01",2022
"22-Jul",경기,고양시 일산서구,130,116795,4252,121177,"2022-07-01",2022
"22-Jul",경기,과천시,734,29278,710,30722,"2022-07-01",2022
"22-Jul",경기,광명시,301,101381,4476,106158,"2022-07-01",2022
"22-Jul",경기,광주시,415,199366,8588,208369,"2022-07-01",2022
"22-Jul",경기,구리시,273,70571,2792,73636,"2022-07-01",2022
"22-Jul",경기,군포시,298,99184,5239,104721,"2022-07-01",2022
"22-Jul",경기,김포시,540,232172,8542,241254,"2022-07-01",2022
"22-Jul",경기,남양주시,796,313625,9144,323565,"2022-07-01",2022
"22-Jul",경기,동두천시,215,38993,1525,40733,"2022-07-01",2022
"22-Jul",경기,부천시,735,297763,12931,311429,"2022-07-01",2022
"22-Jul",경기,성남시 분당구,370,189658,7416,197444,"2022-07-01",2022
"22-Jul",경기,성남시 수정구,304,77796,2632,80732,"2022-07-01",2022
"22-Jul",경기,성남시 중원구,396,71225,4017,75638,"2022-07-01",2022
"22-Jul",경기,수원시 권선구,492,204912,9557,214961,"2022-07-01",2022
"22-Jul",경기,수원시 영통구,270,147877,3299,151446,"2022-07-01",2022
"22-Jul",경기,수원시 장안구,481,104463,3822,108766,"2022-07-01",2022
"22-Jul",경기,수원시 팔달구,488,73725,3224,77437,"2022-07-01",2022
"22-Jul",경기,시흥시,467,258028,8475,266970,"2022-07-01",2022
"22-Jul",경기,안산시 단원구,581,161141,7602,169324,"2022-07-01",2022
"22-Jul",경기,안산시 상록구,149,145524,5855,151528,"2022-07-01",2022
"22-Jul",경기,안성시,403,110388,4771,115562,"2022-07-01",2022
"22-Jul",경기,안양시 동안구,400,121430,6549,128379,"2022-07-01",2022
"22-Jul",경기,안양시 만안구,162,84425,3965,88552,"2022-07-01",2022
"22-Jul",경기,양주시,407,114413,3497,118317,"2022-07-01",2022
"22-Jul",경기,양평군,580,63288,1957,65825,"2022-07-01",2022
"22-Jul",경기,여주시,459,65635,7277,73371,"2022-07-01",2022
"22-Jul",경기,연천군,310,24305,5258,29873,"2022-07-01",2022
"22-Jul",경기,오산시,217,110659,3996,114872,"2022-07-01",2022
"22-Jul",경기,용인시 기흥구,116,193212,7036,200364,"2022-07-01",2022
"22-Jul",경기,용인시 수지구,59,148318,2424,150801,"2022-07-01",2022
"22-Jul",경기,용인시 처인구,790,136940,8046,145776,"2022-07-01",2022
"22-Jul",경기,의왕시,302,66016,2945,69263,"2022-07-01",2022
"22-Jul",경기,의정부시,751,169344,5683,175778,"2022-07-01",2022
"22-Jul",경기,이천시,425,118905,6415,125745,"2022-07-01",2022
"22-Jul",경기,파주시,538,230741,10810,242089,"2022-07-01",2022
"22-Jul",경기,평택시,765,308333,13275,322373,"2022-07-01",2022
"22-Jul",경기,포천시,397,89209,8872,98478,"2022-07-01",2022
"22-Jul",경기,하남시,426,135642,3528,139596,"2022-07-01",2022
"22-Jul",경기,화성시,958,477847,13344,492149,"2022-07-01",2022
"22-Jul",경기,계,18223,6049908,244784,6312915,"2022-07-01",2022
"22-Jul",강원,강릉시,543,111360,4746,116649,"2022-07-01",2022
"22-Jul",강원,고성군,190,15503,233,15926,"2022-07-01",2022
"22-Jul",강원,동해시,318,46635,1469,48422,"2022-07-01",2022
"22-Jul",강원,삼척시,409,33063,787,34259,"2022-07-01",2022
"22-Jul",강원,속초시,309,39660,1408,41377,"2022-07-01",2022
"22-Jul",강원,양구군,205,12180,148,12533,"2022-07-01",2022
"22-Jul",강원,양양군,191,16363,320,16874,"2022-07-01",2022
"22-Jul",강원,영월군,337,21588,381,22306,"2022-07-01",2022
"22-Jul",강원,원주시,616,183313,5618,189547,"2022-07-01",2022
"22-Jul",강원,인제군,215,19331,306,19852,"2022-07-01",2022
"22-Jul",강원,정선군,348,20869,476,21693,"2022-07-01",2022
"22-Jul",강원,철원군,248,24388,334,24970,"2022-07-01",2022
"22-Jul",강원,춘천시,844,138590,6406,145840,"2022-07-01",2022
"22-Jul",강원,태백시,226,19855,743,20824,"2022-07-01",2022
"22-Jul",강원,평창군,309,26246,536,27091,"2022-07-01",2022
"22-Jul",강원,홍천군,420,39748,1043,41211,"2022-07-01",2022
"22-Jul",강원,화천군,235,13275,180,13690,"2022-07-01",2022
"22-Jul",강원,횡성군,263,27609,848,28720,"2022-07-01",2022
"22-Jul",강원,계,6226,809576,25982,841784,"2022-07-01",2022
"22-Jul",충북,괴산군,220,23500,413,24133,"2022-07-01",2022
"22-Jul",충북,단양군,233,15855,777,16865,"2022-07-01",2022
"22-Jul",충북,보은군,233,18438,972,19643,"2022-07-01",2022
"22-Jul",충북,영동군,258,25415,413,26086,"2022-07-01",2022
"22-Jul",충북,옥천군,211,28002,1162,29375,"2022-07-01",2022
"22-Jul",충북,음성군,264,60468,2003,62735,"2022-07-01",2022
"22-Jul",충북,제천시,336,68490,3439,72265,"2022-07-01",2022
"22-Jul",충북,증평군,93,20086,784,20963,"2022-07-01",2022
"22-Jul",충북,진천군,222,52344,1389,53955,"2022-07-01",2022
"22-Jul",충북,청원군,1,19,0,20,"2022-07-01",2022
"22-Jul",충북,청주시 상당구,503,95880,2644,99027,"2022-07-01",2022
"22-Jul",충북,청주시 서원구,240,101831,4418,106489,"2022-07-01",2022
"22-Jul",충북,청주시 청원구,372,106140,4681,111193,"2022-07-01",2022
"22-Jul",충북,청주시 흥덕구,362,134880,7714,142956,"2022-07-01",2022
"22-Jul",충북,충주시,630,112960,7713,121303,"2022-07-01",2022
"22-Jul",충북,계,4178,864308,38522,907008,"2022-07-01",2022
"22-Jul",충남,계룡시,163,23206,570,23939,"2022-07-01",2022
"22-Jul",충남,공주시,585,55065,2687,58337,"2022-07-01",2022
"22-Jul",충남,금산군,201,28839,2080,31120,"2022-07-01",2022
"22-Jul",충남,논산시,406,61677,2420,64503,"2022-07-01",2022
"22-Jul",충남,당진시,401,99385,4055,103841,"2022-07-01",2022
"22-Jul",충남,보령시,413,53128,1390,54931,"2022-07-01",2022
"22-Jul",충남,부여군,302,34615,1146,36063,"2022-07-01",2022
"22-Jul",충남,서산시,423,98359,3665,102447,"2022-07-01",2022
"22-Jul",충남,서천군,236,27353,818,28407,"2022-07-01",2022
"22-Jul",충남,아산시,534,180814,7156,188504,"2022-07-01",2022
"22-Jul",충남,예산군,421,44110,1397,45928,"2022-07-01",2022
"22-Jul",충남,천안시 동남구,289,135161,5408,140858,"2022-07-01",2022
"22-Jul",충남,천안시 서북구,543,201702,5613,207858,"2022-07-01",2022
"22-Jul",충남,청양군,254,17166,794,18214,"2022-07-01",2022
"22-Jul",충남,태안군,313,35073,556,35942,"2022-07-01",2022
"22-Jul",충남,홍성군,403,53842,1433,55678,"2022-07-01",2022
"22-Jul",충남,계,5887,1149495,41188,1196570,"2022-07-01",2022
"22-Jul",전북,고창군,324,31033,588,31945,"2022-07-01",2022
"22-Jul",전북,군산시,556,133783,6436,140775,"2022-07-01",2022
"22-Jul",전북,김제시,314,46416,2064,48794,"2022-07-01",2022
"22-Jul",전북,남원시,409,41665,2869,44943,"2022-07-01",2022
"22-Jul",전북,무주군,196,13251,402,13849,"2022-07-01",2022
"22-Jul",전북,부안군,268,27781,616,28665,"2022-07-01",2022
"22-Jul",전북,순창군,230,14930,160,15320,"2022-07-01",2022
"22-Jul",전북,완주군,422,53215,3124,56761,"2022-07-01",2022
"22-Jul",전북,익산시,540,138379,5920,144839,"2022-07-01",2022
"22-Jul",전북,임실군,221,14552,428,15201,"2022-07-01",2022
"22-Jul",전북,장수군,249,12417,178,12844,"2022-07-01",2022
"22-Jul",전북,전주시 덕진구,338,175314,6898,182550,"2022-07-01",2022
"22-Jul",전북,전주시 완산구,785,153854,4236,158875,"2022-07-01",2022
"22-Jul",전북,정읍시,357,55659,3637,59653,"2022-07-01",2022
"22-Jul",전북,진안군,270,14471,233,14974,"2022-07-01",2022
"22-Jul",전북,계,5479,926720,37789,969988,"2022-07-01",2022
"22-Jul",전남,강진군,254,18845,1044,20143,"2022-07-01",2022
"22-Jul",전남,고흥군,313,32961,593,33867,"2022-07-01",2022
"22-Jul",전남,곡성군,161,15238,697,16096,"2022-07-01",2022
"22-Jul",전남,광양시,262,87004,6085,93351,"2022-07-01",2022
"22-Jul",전남,구례군,147,13275,748,14170,"2022-07-01",2022
"22-Jul",전남,나주시,476,66734,3179,70389,"2022-07-01",2022
"22-Jul",전남,담양군,226,27926,1684,29836,"2022-07-01",2022
"22-Jul",전남,목포시,412,95425,5522,101359,"2022-07-01",2022
"22-Jul",전남,무안군,566,50552,1098,52216,"2022-07-01",2022
"22-Jul",전남,보성군,231,21804,2513,24548,"2022-07-01",2022
"22-Jul",전남,순천시,507,143723,5363,149593,"2022-07-01",2022
"22-Jul",전남,신안군,341,22169,94851,117361,"2022-07-01",2022
"22-Jul",전남,여수시,549,133808,7389,141746,"2022-07-01",2022
"22-Jul",전남,영광군,209,28704,772,29685,"2022-07-01",2022
"22-Jul",전남,영암군,289,34576,1548,36413,"2022-07-01",2022
"22-Jul",전남,완도군,284,25782,545,26611,"2022-07-01",2022
"22-Jul",전남,장성군,210,27310,1254,28774,"2022-07-01",2022
"22-Jul",전남,장흥군,267,20368,447,21082,"2022-07-01",2022
"22-Jul",전남,진도군,212,17222,299,17733,"2022-07-01",2022
"22-Jul",전남,함평군,212,18437,29417,48066,"2022-07-01",2022
"22-Jul",전남,해남군,326,40120,50613,91059,"2022-07-01",2022
"22-Jul",전남,화순군,241,33727,2023,35991,"2022-07-01",2022
"22-Jul",전남,계,6695,975710,217684,1200089,"2022-07-01",2022
"22-Jul",경북,경산시,341,141111,4333,145785,"2022-07-01",2022
"22-Jul",경북,경주시,595,144120,4596,149311,"2022-07-01",2022
"22-Jul",경북,고령군,175,20618,748,21541,"2022-07-01",2022
"22-Jul",경북,구미시,548,216002,7260,223810,"2022-07-01",2022
"22-Jul",경북,군위군,124,15514,311,15949,"2022-07-01",2022
"22-Jul",경북,김천시,398,76525,2019,78942,"2022-07-01",2022
"22-Jul",경북,문경시,279,38159,882,39320,"2022-07-01",2022
"22-Jul",경북,봉화군,234,18277,201,18712,"2022-07-01",2022
"22-Jul",경북,상주시,392,54006,1878,56276,"2022-07-01",2022
"22-Jul",경북,성주군,201,31435,1310,32946,"2022-07-01",2022
"22-Jul",경북,안동시,728,83602,2698,87028,"2022-07-01",2022
"22-Jul",경북,영덕군,251,19115,297,19663,"2022-07-01",2022
"22-Jul",경북,영양군,148,9930,112,10190,"2022-07-01",2022
"22-Jul",경북,영주시,359,56397,1521,58277,"2022-07-01",2022
"22-Jul",경북,영천시,336,61120,2586,64042,"2022-07-01",2022
"22-Jul",경북,예천군,287,30962,487,31736,"2022-07-01",2022
"22-Jul",경북,울릉군,162,5503,626,6291,"2022-07-01",2022
"22-Jul",경북,울진군,315,26729,336,27380,"2022-07-01",2022
"22-Jul",경북,의성군,325,31540,1075,32940,"2022-07-01",2022
"22-Jul",경북,청도군,218,25562,951,26731,"2022-07-01",2022
"22-Jul",경북,청송군,225,16008,211,16444,"2022-07-01",2022
"22-Jul",경북,칠곡군,302,69865,2452,72619,"2022-07-01",2022
"22-Jul",경북,포항시 남구,436,123850,8401,132687,"2022-07-01",2022
"22-Jul",경북,포항시 북구,362,142668,3575,146605,"2022-07-01",2022
"22-Jul",경북,계,7741,1458618,48866,1515225,"2022-07-01",2022
"22-Jul",경남,거제시,365,107107,2103,109575,"2022-07-01",2022
"22-Jul",경남,거창군,273,33022,759,34054,"2022-07-01",2022
"22-Jul",경남,고성군,229,26932,552,27713,"2022-07-01",2022
"22-Jul",경남,김해시,662,280397,7517,288576,"2022-07-01",2022
"22-Jul",경남,남해군,278,20429,443,21150,"2022-07-01",2022
"22-Jul",경남,밀양시,318,56913,3923,61154,"2022-07-01",2022
"22-Jul",경남,사천시,319,57555,1519,59393,"2022-07-01",2022
"22-Jul",경남,산청군,243,20615,739,21597,"2022-07-01",2022
"22-Jul",경남,양산시,423,170794,10593,181810,"2022-07-01",2022
"22-Jul",경남,의령군,204,15044,747,15995,"2022-07-01",2022
"22-Jul",경남,진주시,649,168952,6452,176053,"2022-07-01",2022
"22-Jul",경남,창녕군,227,36041,757,37025,"2022-07-01",2022
"22-Jul",경남,창원시 마산합포구,357,94466,2893,97716,"2022-07-01",2022
"22-Jul",경남,창원시 마산회원구,154,99876,5622,105652,"2022-07-01",2022
"22-Jul",경남,창원시 성산구,652,156265,52725,209642,"2022-07-01",2022
"22-Jul",경남,창원시 의창구,471,117563,3483,121517,"2022-07-01",2022
"22-Jul",경남,창원시 진해구,218,95004,2018,97240,"2022-07-01",2022
"22-Jul",경남,통영시,309,52800,1384,54493,"2022-07-01",2022
"22-Jul",경남,하동군,227,24254,381,24862,"2022-07-01",2022
"22-Jul",경남,함안군,207,43641,31301,75149,"2022-07-01",2022
"22-Jul",경남,함양군,228,19899,420,20547,"2022-07-01",2022
"22-Jul",경남,합천군,285,23772,624,24681,"2022-07-01",2022
"22-Jul",경남,계,7298,1721341,136955,1865594,"2022-07-01",2022
"22-Jul",제주,서귀포시,782,106219,1876,108877,"2022-07-01",2022
"22-Jul",제주,제주시,1639,299361,269965,570965,"2022-07-01",2022
"22-Jul",제주,계,2421,405580,271841,679842,"2022-07-01",2022
"22-Aug",서울,강남구,415,224369,22854,247638,"2022-08-01",2022
"22-Aug",서울,강동구,308,143737,8573,152618,"2022-08-01",2022
"22-Aug",서울,강북구,313,70830,4236,75379,"2022-08-01",2022
"22-Aug",서울,강서구,352,189440,17240,207032,"2022-08-01",2022
"22-Aug",서울,관악구,305,112203,5718,118226,"2022-08-01",2022
"22-Aug",서울,광진구,302,92919,5900,99121,"2022-08-01",2022
"22-Aug",서울,구로구,292,132084,13787,146163,"2022-08-01",2022
"22-Aug",서울,금천구,166,84819,6372,91357,"2022-08-01",2022
"22-Aug",서울,노원구,325,143371,8823,152519,"2022-08-01",2022
"22-Aug",서울,도봉구,284,88016,7483,95783,"2022-08-01",2022
"22-Aug",서울,동대문구,312,93594,4668,98574,"2022-08-01",2022
"22-Aug",서울,동작구,304,103344,2756,106404,"2022-08-01",2022
"22-Aug",서울,마포구,341,113609,7536,121486,"2022-08-01",2022
"22-Aug",서울,서대문구,448,83923,5751,90122,"2022-08-01",2022
"22-Aug",서울,서초구,522,164577,10958,176057,"2022-08-01",2022
"22-Aug",서울,성동구,375,93696,11742,105813,"2022-08-01",2022
"22-Aug",서울,성북구,301,117317,5119,122737,"2022-08-01",2022
"22-Aug",서울,송파구,393,235235,14532,250160,"2022-08-01",2022
"22-Aug",서울,양천구,326,142692,8556,151574,"2022-08-01",2022
"22-Aug",서울,영등포구,374,136860,8801,146035,"2022-08-01",2022
"22-Aug",서울,용산구,528,72854,2127,75509,"2022-08-01",2022
"22-Aug",서울,은평구,306,127102,7033,134441,"2022-08-01",2022
"22-Aug",서울,종로구,3666,44385,2112,50163,"2022-08-01",2022
"22-Aug",서울,중구,1244,52252,4867,58363,"2022-08-01",2022
"22-Aug",서울,중랑구,252,105957,9575,115784,"2022-08-01",2022
"22-Aug",서울,계,12754,2969185,207119,3189058,"2022-08-01",2022
"22-Aug",부산,강서구,322,83535,4548,88405,"2022-08-01",2022
"22-Aug",부산,금정구,272,79594,7285,87151,"2022-08-01",2022
"22-Aug",부산,기장군,262,82402,2670,85334,"2022-08-01",2022
"22-Aug",부산,남구,224,91161,9615,101000,"2022-08-01",2022
"22-Aug",부산,동구,183,56055,5834,62072,"2022-08-01",2022
"22-Aug",부산,동래구,173,96929,3525,100627,"2022-08-01",2022
"22-Aug",부산,부산진구,369,123309,22044,145722,"2022-08-01",2022
"22-Aug",부산,북구,234,102172,3716,106122,"2022-08-01",2022
"22-Aug",부산,사상구,283,83190,5627,89100,"2022-08-01",2022
"22-Aug",부산,사하구,266,107938,6174,114378,"2022-08-01",2022
"22-Aug",부산,서구,143,29915,1457,31515,"2022-08-01",2022
"22-Aug",부산,수영구,167,65604,47853,113624,"2022-08-01",2022
"22-Aug",부산,연제구,960,95411,13486,109857,"2022-08-01",2022
"22-Aug",부산,영도구,227,31589,1994,33810,"2022-08-01",2022
"22-Aug",부산,중구,307,30890,6964,38161,"2022-08-01",2022
"22-Aug",부산,해운대구,322,165746,16258,182326,"2022-08-01",2022
"22-Aug",부산,계,4714,1325440,159050,1489204,"2022-08-01",2022
"22-Aug",대구,남구,352,55321,1619,57292,"2022-08-01",2022
"22-Aug",대구,달서구,501,274428,14835,289764,"2022-08-01",2022
"22-Aug",대구,달성군,573,138394,5273,144240,"2022-08-01",2022
"22-Aug",대구,동구,360,157458,11130,168948,"2022-08-01",2022
"22-Aug",대구,북구,497,203670,7891,212058,"2022-08-01",2022
"22-Aug",대구,서구,256,68054,4491,72801,"2022-08-01",2022
"22-Aug",대구,수성구,586,211796,4727,217109,"2022-08-01",2022
"22-Aug",대구,중구,306,58782,2823,61911,"2022-08-01",2022
"22-Aug",대구,계,3431,1167903,52789,1224123,"2022-08-01",2022
"22-Aug",인천,강화군,354,37452,10007,47813,"2022-08-01",2022
"22-Aug",인천,계양구,306,122113,175953,298372,"2022-08-01",2022
"22-Aug",인천,남동구,867,248967,44162,293996,"2022-08-01",2022
"22-Aug",인천,동구,106,23531,2653,26290,"2022-08-01",2022
"22-Aug",인천,미추홀구,435,161943,8965,171343,"2022-08-01",2022
"22-Aug",인천,부평구,350,229634,38587,268571,"2022-08-01",2022
"22-Aug",인천,서구,473,278335,12333,291141,"2022-08-01",2022
"22-Aug",인천,연수구,431,202990,8938,212359,"2022-08-01",2022
"22-Aug",인천,옹진군,224,12738,246,13208,"2022-08-01",2022
"22-Aug",인천,중구,627,70991,12180,83798,"2022-08-01",2022
"22-Aug",인천,계,4173,1388694,314024,1706891,"2022-08-01",2022
"22-Aug",광주,광산구,532,199975,13222,213729,"2022-08-01",2022
"22-Aug",광주,남구,225,93099,2838,96162,"2022-08-01",2022
"22-Aug",광주,동구,231,44716,1045,45992,"2022-08-01",2022
"22-Aug",광주,북구,619,192775,9310,202704,"2022-08-01",2022
"22-Aug",광주,서구,731,143522,6355,150608,"2022-08-01",2022
"22-Aug",광주,계,2338,674087,32770,709195,"2022-08-01",2022
"22-Aug",대전,대덕구,239,87861,7655,95755,"2022-08-01",2022
"22-Aug",대전,동구,247,91848,4802,96897,"2022-08-01",2022
"22-Aug",대전,서구,816,208964,9171,218951,"2022-08-01",2022
"22-Aug",대전,유성구,662,182865,5462,188989,"2022-08-01",2022
"22-Aug",대전,중구,230,96600,5550,102380,"2022-08-01",2022
"22-Aug",대전,계,2194,668138,32640,702972,"2022-08-01",2022
"22-Aug",울산,남구,720,154542,7082,162344,"2022-08-01",2022
"22-Aug",울산,동구,193,62005,1227,63425,"2022-08-01",2022
"22-Aug",울산,북구,226,118863,3537,122626,"2022-08-01",2022
"22-Aug",울산,울주군,421,126608,7121,134150,"2022-08-01",2022
"22-Aug",울산,중구,328,99881,2557,102766,"2022-08-01",2022
"22-Aug",울산,계,1888,561899,21524,585311,"2022-08-01",2022
"22-Aug",세종,세종특별자치시,888,187342,3449,191679,"2022-08-01",2022
"22-Aug",세종,계,888,187342,3449,191679,"2022-08-01",2022
"22-Aug",경기,가평군,390,31998,568,32956,"2022-08-01",2022
"22-Aug",경기,고양시 덕양구,668,187708,4131,192507,"2022-08-01",2022
"22-Aug",경기,고양시 일산동구,274,128378,6420,135072,"2022-08-01",2022
"22-Aug",경기,고양시 일산서구,134,116716,4260,121110,"2022-08-01",2022
"22-Aug",경기,과천시,699,29345,703,30747,"2022-08-01",2022
"22-Aug",경기,광명시,304,101270,4396,105970,"2022-08-01",2022
"22-Aug",경기,광주시,413,199904,8544,208861,"2022-08-01",2022
"22-Aug",경기,구리시,276,70669,2780,73725,"2022-08-01",2022
"22-Aug",경기,군포시,299,99191,5198,104688,"2022-08-01",2022
"22-Aug",경기,김포시,547,232033,8605,241185,"2022-08-01",2022
"22-Aug",경기,남양주시,803,314203,9160,324166,"2022-08-01",2022
"22-Aug",경기,동두천시,214,39041,1521,40776,"2022-08-01",2022
"22-Aug",경기,부천시,739,297144,12952,310835,"2022-08-01",2022
"22-Aug",경기,성남시 분당구,371,189548,7414,197333,"2022-08-01",2022
"22-Aug",경기,성남시 수정구,304,77760,2656,80720,"2022-08-01",2022
"22-Aug",경기,성남시 중원구,392,70886,3993,75271,"2022-08-01",2022
"22-Aug",경기,수원시 권선구,488,202980,9564,213032,"2022-08-01",2022
"22-Aug",경기,수원시 영통구,273,147719,3244,151236,"2022-08-01",2022
"22-Aug",경기,수원시 장안구,486,104421,3818,108725,"2022-08-01",2022
"22-Aug",경기,수원시 팔달구,487,75439,3298,79224,"2022-08-01",2022
"22-Aug",경기,시흥시,468,258052,8497,267017,"2022-08-01",2022
"22-Aug",경기,안산시 단원구,589,161119,7627,169335,"2022-08-01",2022
"22-Aug",경기,안산시 상록구,151,145730,5905,151786,"2022-08-01",2022
"22-Aug",경기,안성시,410,110482,4782,115674,"2022-08-01",2022
"22-Aug",경기,안양시 동안구,401,121315,6705,128421,"2022-08-01",2022
"22-Aug",경기,안양시 만안구,165,84455,3962,88582,"2022-08-01",2022
"22-Aug",경기,양주시,410,114972,3507,118889,"2022-08-01",2022
"22-Aug",경기,양평군,587,63378,1950,65915,"2022-08-01",2022
"22-Aug",경기,여주시,460,65805,7351,73616,"2022-08-01",2022
"22-Aug",경기,연천군,311,24335,5247,29893,"2022-08-01",2022
"22-Aug",경기,오산시,219,110595,4013,114827,"2022-08-01",2022
"22-Aug",경기,용인시 기흥구,123,192924,6954,200001,"2022-08-01",2022
"22-Aug",경기,용인시 수지구,59,148687,2416,151162,"2022-08-01",2022
"22-Aug",경기,용인시 처인구,797,137077,8118,145992,"2022-08-01",2022
"22-Aug",경기,의왕시,301,66044,2928,69273,"2022-08-01",2022
"22-Aug",경기,의정부시,750,169568,5718,176036,"2022-08-01",2022
"22-Aug",경기,이천시,424,119140,6419,125983,"2022-08-01",2022
"22-Aug",경기,파주시,540,231745,10940,243225,"2022-08-01",2022
"22-Aug",경기,평택시,765,309923,13321,324009,"2022-08-01",2022
"22-Aug",경기,포천시,396,89276,8754,98426,"2022-08-01",2022
"22-Aug",경기,하남시,425,135600,3571,139596,"2022-08-01",2022
"22-Aug",경기,화성시,958,479252,13399,493609,"2022-08-01",2022
"22-Aug",경기,계,18270,6055827,245309,6319406,"2022-08-01",2022
"22-Aug",강원,강릉시,538,111586,4758,116882,"2022-08-01",2022
"22-Aug",강원,고성군,197,15511,231,15939,"2022-08-01",2022
"22-Aug",강원,동해시,318,46751,1466,48535,"2022-08-01",2022
"22-Aug",강원,삼척시,405,33065,784,34254,"2022-08-01",2022
"22-Aug",강원,속초시,311,39739,1409,41459,"2022-08-01",2022
"22-Aug",강원,양구군,211,12195,150,12556,"2022-08-01",2022
"22-Aug",강원,양양군,197,16437,321,16955,"2022-08-01",2022
"22-Aug",강원,영월군,339,21596,388,22323,"2022-08-01",2022
"22-Aug",강원,원주시,618,183823,5789,190230,"2022-08-01",2022
"22-Aug",강원,인제군,216,19362,301,19879,"2022-08-01",2022
"22-Aug",강원,정선군,351,20889,478,21718,"2022-08-01",2022
"22-Aug",강원,철원군,247,24421,334,25002,"2022-08-01",2022
"22-Aug",강원,춘천시,833,139020,6390,146243,"2022-08-01",2022
"22-Aug",강원,태백시,231,19840,746,20817,"2022-08-01",2022
"22-Aug",강원,평창군,319,26280,552,27151,"2022-08-01",2022
"22-Aug",강원,홍천군,420,39829,1031,41280,"2022-08-01",2022
"22-Aug",강원,화천군,235,13271,180,13686,"2022-08-01",2022
"22-Aug",강원,횡성군,284,27661,864,28809,"2022-08-01",2022
"22-Aug",강원,계,6270,811276,26172,843718,"2022-08-01",2022
"22-Aug",충북,괴산군,223,23524,411,24158,"2022-08-01",2022
"22-Aug",충북,단양군,233,15874,795,16902,"2022-08-01",2022
"22-Aug",충북,보은군,234,18440,969,19643,"2022-08-01",2022
"22-Aug",충북,영동군,255,25464,415,26134,"2022-08-01",2022
"22-Aug",충북,옥천군,213,28031,1175,29419,"2022-08-01",2022
"22-Aug",충북,음성군,264,60658,1987,62909,"2022-08-01",2022
"22-Aug",충북,제천시,339,68609,3442,72390,"2022-08-01",2022
"22-Aug",충북,증평군,92,20176,784,21052,"2022-08-01",2022
"22-Aug",충북,진천군,224,52505,1395,54124,"2022-08-01",2022
"22-Aug",충북,청원군,1,19,0,20,"2022-08-01",2022
"22-Aug",충북,청주시 상당구,502,96146,2650,99298,"2022-08-01",2022
"22-Aug",충북,청주시 서원구,243,101842,4420,106505,"2022-08-01",2022
"22-Aug",충북,청주시 청원구,386,106448,4718,111552,"2022-08-01",2022
"22-Aug",충북,청주시 흥덕구,365,135165,7728,143258,"2022-08-01",2022
"22-Aug",충북,충주시,634,113282,7746,121662,"2022-08-01",2022
"22-Aug",충북,계,4208,866183,38635,909026,"2022-08-01",2022
"22-Aug",충남,계룡시,164,23403,571,24138,"2022-08-01",2022
"22-Aug",충남,공주시,583,55137,2675,58395,"2022-08-01",2022
"22-Aug",충남,금산군,205,28927,2121,31253,"2022-08-01",2022
"22-Aug",충남,논산시,406,61771,2426,64603,"2022-08-01",2022
"22-Aug",충남,당진시,407,99681,4058,104146,"2022-08-01",2022
"22-Aug",충남,보령시,413,53220,1398,55031,"2022-08-01",2022
"22-Aug",충남,부여군,303,34625,1149,36077,"2022-08-01",2022
"22-Aug",충남,서산시,422,98623,3702,102747,"2022-08-01",2022
"22-Aug",충남,서천군,236,27389,811,28436,"2022-08-01",2022
"22-Aug",충남,아산시,536,181449,7112,189097,"2022-08-01",2022
"22-Aug",충남,예산군,422,44295,1404,46121,"2022-08-01",2022
"22-Aug",충남,천안시 동남구,294,135319,5394,141007,"2022-08-01",2022
"22-Aug",충남,천안시 서북구,543,201981,5622,208146,"2022-08-01",2022
"22-Aug",충남,청양군,256,17209,788,18253,"2022-08-01",2022
"22-Aug",충남,태안군,311,35182,559,36052,"2022-08-01",2022
"22-Aug",충남,홍성군,403,53897,1437,55737,"2022-08-01",2022
"22-Aug",충남,계,5904,1152108,41227,1199239,"2022-08-01",2022
"22-Aug",전북,고창군,323,31144,588,32055,"2022-08-01",2022
"22-Aug",전북,군산시,547,133953,6477,140977,"2022-08-01",2022
"22-Aug",전북,김제시,315,46654,2062,49031,"2022-08-01",2022
"22-Aug",전북,남원시,412,41732,2717,44861,"2022-08-01",2022
"22-Aug",전북,무주군,193,13266,398,13857,"2022-08-01",2022
"22-Aug",전북,부안군,267,27828,620,28715,"2022-08-01",2022
"22-Aug",전북,순창군,229,14952,161,15342,"2022-08-01",2022
"22-Aug",전북,완주군,422,53368,3131,56921,"2022-08-01",2022
"22-Aug",전북,익산시,543,138546,5895,144984,"2022-08-01",2022
"22-Aug",전북,임실군,219,14574,427,15220,"2022-08-01",2022
"22-Aug",전북,장수군,252,12440,180,12872,"2022-08-01",2022
"22-Aug",전북,전주시 덕진구,337,175035,6908,182280,"2022-08-01",2022
"22-Aug",전북,전주시 완산구,782,154427,4233,159442,"2022-08-01",2022
"22-Aug",전북,정읍시,359,55850,3693,59902,"2022-08-01",2022
"22-Aug",전북,진안군,267,14491,237,14995,"2022-08-01",2022
"22-Aug",전북,계,5467,928260,37727,971454,"2022-08-01",2022
"22-Aug",전남,강진군,255,18852,1041,20148,"2022-08-01",2022
"22-Aug",전남,고흥군,311,33056,594,33961,"2022-08-01",2022
"22-Aug",전남,곡성군,161,15249,694,16104,"2022-08-01",2022
"22-Aug",전남,광양시,261,87434,6111,93806,"2022-08-01",2022
"22-Aug",전남,구례군,147,13321,749,14217,"2022-08-01",2022
"22-Aug",전남,나주시,477,66765,3214,70456,"2022-08-01",2022
"22-Aug",전남,담양군,227,27935,1695,29857,"2022-08-01",2022
"22-Aug",전남,목포시,414,95670,5546,101630,"2022-08-01",2022
"22-Aug",전남,무안군,569,50634,1102,52305,"2022-08-01",2022
"22-Aug",전남,보성군,230,21826,2330,24386,"2022-08-01",2022
"22-Aug",전남,순천시,511,143813,5384,149708,"2022-08-01",2022
"22-Aug",전남,신안군,344,22247,95551,118142,"2022-08-01",2022
"22-Aug",전남,여수시,548,134182,7405,142135,"2022-08-01",2022
"22-Aug",전남,영광군,211,28819,775,29805,"2022-08-01",2022
"22-Aug",전남,영암군,284,34595,1444,36323,"2022-08-01",2022
"22-Aug",전남,완도군,284,25818,551,26653,"2022-08-01",2022
"22-Aug",전남,장성군,209,27336,1243,28788,"2022-08-01",2022
"22-Aug",전남,장흥군,266,20386,445,21097,"2022-08-01",2022
"22-Aug",전남,진도군,212,17270,299,17781,"2022-08-01",2022
"22-Aug",전남,함평군,213,18448,28287,46948,"2022-08-01",2022
"22-Aug",전남,해남군,329,40157,52485,92971,"2022-08-01",2022
"22-Aug",전남,화순군,240,33773,2030,36043,"2022-08-01",2022
"22-Aug",전남,계,6703,977586,218975,1203264,"2022-08-01",2022
"22-Aug",경북,경산시,341,141513,4366,146220,"2022-08-01",2022
"22-Aug",경북,경주시,596,144314,4593,149503,"2022-08-01",2022
"22-Aug",경북,고령군,177,20636,749,21562,"2022-08-01",2022
"22-Aug",경북,구미시,549,216096,7234,223879,"2022-08-01",2022
"22-Aug",경북,군위군,122,15520,310,15952,"2022-08-01",2022
"22-Aug",경북,김천시,395,76715,2016,79126,"2022-08-01",2022
"22-Aug",경북,문경시,280,38133,882,39295,"2022-08-01",2022
"22-Aug",경북,봉화군,234,18290,201,18725,"2022-08-01",2022
"22-Aug",경북,상주시,388,54089,1883,56360,"2022-08-01",2022
"22-Aug",경북,성주군,202,31447,1314,32963,"2022-08-01",2022
"22-Aug",경북,안동시,729,83694,2691,87114,"2022-08-01",2022
"22-Aug",경북,영덕군,253,19190,296,19739,"2022-08-01",2022
"22-Aug",경북,영양군,148,9942,111,10201,"2022-08-01",2022
"22-Aug",경북,영주시,358,56479,1521,58358,"2022-08-01",2022
"22-Aug",경북,영천시,348,61342,2593,64283,"2022-08-01",2022
"22-Aug",경북,예천군,293,31093,488,31874,"2022-08-01",2022
"22-Aug",경북,울릉군,161,5575,628,6364,"2022-08-01",2022
"22-Aug",경북,울진군,317,26708,334,27359,"2022-08-01",2022
"22-Aug",경북,의성군,325,31581,1078,32984,"2022-08-01",2022
"22-Aug",경북,청도군,216,25624,944,26784,"2022-08-01",2022
"22-Aug",경북,청송군,224,16025,213,16462,"2022-08-01",2022
"22-Aug",경북,칠곡군,303,70092,2463,72858,"2022-08-01",2022
"22-Aug",경북,포항시 남구,438,123980,8368,132786,"2022-08-01",2022
"22-Aug",경북,포항시 북구,364,142782,3585,146731,"2022-08-01",2022
"22-Aug",경북,계,7761,1460860,48861,1517482,"2022-08-01",2022
"22-Aug",경남,거제시,365,107201,2103,109669,"2022-08-01",2022
"22-Aug",경남,거창군,273,33125,761,34159,"2022-08-01",2022
"22-Aug",경남,고성군,229,26993,556,27778,"2022-08-01",2022
"22-Aug",경남,김해시,674,281193,7515,289382,"2022-08-01",2022
"22-Aug",경남,남해군,278,20452,448,21178,"2022-08-01",2022
"22-Aug",경남,밀양시,317,56951,3925,61193,"2022-08-01",2022
"22-Aug",경남,사천시,321,57752,1516,59589,"2022-08-01",2022
"22-Aug",경남,산청군,244,20672,737,21653,"2022-08-01",2022
"22-Aug",경남,양산시,425,171152,10590,182167,"2022-08-01",2022
"22-Aug",경남,의령군,206,15044,759,16009,"2022-08-01",2022
"22-Aug",경남,진주시,652,169190,6447,176289,"2022-08-01",2022
"22-Aug",경남,창녕군,228,36022,759,37009,"2022-08-01",2022
"22-Aug",경남,창원시 마산합포구,355,94507,2907,97769,"2022-08-01",2022
"22-Aug",경남,창원시 마산회원구,155,100191,5669,106015,"2022-08-01",2022
"22-Aug",경남,창원시 성산구,642,157418,53347,211407,"2022-08-01",2022
"22-Aug",경남,창원시 의창구,468,117801,3475,121744,"2022-08-01",2022
"22-Aug",경남,창원시 진해구,217,95260,2030,97507,"2022-08-01",2022
"22-Aug",경남,통영시,309,52805,1389,54503,"2022-08-01",2022
"22-Aug",경남,하동군,228,24218,383,24829,"2022-08-01",2022
"22-Aug",경남,함안군,203,43533,31408,75144,"2022-08-01",2022
"22-Aug",경남,함양군,229,19975,422,20626,"2022-08-01",2022
"22-Aug",경남,합천군,285,23807,623,24715,"2022-08-01",2022
"22-Aug",경남,계,7303,1725262,137769,1870334,"2022-08-01",2022
"22-Aug",제주,서귀포시,780,106576,1872,109228,"2022-08-01",2022
"22-Aug",제주,제주시,1635,300672,271041,573348,"2022-08-01",2022
"22-Aug",제주,계,2415,407248,272913,682576,"2022-08-01",2022
"22-Sep",서울,강남구,415,224766,22492,247673,"2022-09-01",2022
"22-Sep",서울,강동구,311,143920,8596,152827,"2022-09-01",2022
"22-Sep",서울,강북구,314,70760,4204,75278,"2022-09-01",2022
"22-Sep",서울,강서구,352,189548,17161,207061,"2022-09-01",2022
"22-Sep",서울,관악구,306,112432,5730,118468,"2022-09-01",2022
"22-Sep",서울,광진구,300,92635,5905,98840,"2022-09-01",2022
"22-Sep",서울,구로구,292,132258,13852,146402,"2022-09-01",2022
"22-Sep",서울,금천구,167,84850,6368,91385,"2022-09-01",2022
"22-Sep",서울,노원구,325,143453,8778,152556,"2022-09-01",2022
"22-Sep",서울,도봉구,285,87932,7491,95708,"2022-09-01",2022
"22-Sep",서울,동대문구,313,94094,4667,99074,"2022-09-01",2022
"22-Sep",서울,동작구,304,103334,2755,106393,"2022-09-01",2022
"22-Sep",서울,마포구,338,113647,7786,121771,"2022-09-01",2022
"22-Sep",서울,서대문구,452,84003,5531,89986,"2022-09-01",2022
"22-Sep",서울,서초구,522,165113,10825,176460,"2022-09-01",2022
"22-Sep",서울,성동구,374,93811,11531,105716,"2022-09-01",2022
"22-Sep",서울,성북구,303,117329,5104,122736,"2022-09-01",2022
"22-Sep",서울,송파구,399,235298,14581,250278,"2022-09-01",2022
"22-Sep",서울,양천구,327,142833,8579,151739,"2022-09-01",2022
"22-Sep",서울,영등포구,375,136033,8327,144735,"2022-09-01",2022
"22-Sep",서울,용산구,528,72860,2134,75522,"2022-09-01",2022
"22-Sep",서울,은평구,305,127017,7046,134368,"2022-09-01",2022
"22-Sep",서울,종로구,3660,44325,2098,50083,"2022-09-01",2022
"22-Sep",서울,중구,1245,53142,5241,59628,"2022-09-01",2022
"22-Sep",서울,중랑구,256,105992,9590,115838,"2022-09-01",2022
"22-Sep",서울,계,12768,2971385,206372,3190525,"2022-09-01",2022
"22-Sep",부산,강서구,321,83676,4551,88548,"2022-09-01",2022
"22-Sep",부산,금정구,271,79481,7267,87019,"2022-09-01",2022
"22-Sep",부산,기장군,264,82756,2672,85692,"2022-09-01",2022
"22-Sep",부산,남구,226,91157,9907,101290,"2022-09-01",2022
"22-Sep",부산,동구,183,56087,5898,62168,"2022-09-01",2022
"22-Sep",부산,동래구,172,97045,3555,100772,"2022-09-01",2022
"22-Sep",부산,부산진구,369,123443,22265,146077,"2022-09-01",2022
"22-Sep",부산,북구,231,102466,3724,106421,"2022-09-01",2022
"22-Sep",부산,사상구,282,83134,5620,89036,"2022-09-01",2022
"22-Sep",부산,사하구,266,107914,6166,114346,"2022-09-01",2022
"22-Sep",부산,서구,139,30109,1456,31704,"2022-09-01",2022
"22-Sep",부산,수영구,167,65549,48603,114319,"2022-09-01",2022
"22-Sep",부산,연제구,959,95403,13537,109899,"2022-09-01",2022
"22-Sep",부산,영도구,227,31617,1979,33823,"2022-09-01",2022
"22-Sep",부산,중구,309,30993,7022,38324,"2022-09-01",2022
"22-Sep",부산,해운대구,323,165809,16342,182474,"2022-09-01",2022
"22-Sep",부산,계,4709,1326639,160564,1491912,"2022-09-01",2022
"22-Sep",대구,남구,354,55608,1625,57587,"2022-09-01",2022
"22-Sep",대구,달서구,503,274852,14931,290286,"2022-09-01",2022
"22-Sep",대구,달성군,575,138579,5259,144413,"2022-09-01",2022
"22-Sep",대구,동구,370,157758,11102,169230,"2022-09-01",2022
"22-Sep",대구,북구,487,203659,7893,212039,"2022-09-01",2022
"22-Sep",대구,서구,256,67872,4489,72617,"2022-09-01",2022
"22-Sep",대구,수성구,587,212125,4743,217455,"2022-09-01",2022
"22-Sep",대구,중구,303,58726,2837,61866,"2022-09-01",2022
"22-Sep",대구,계,3435,1169179,52879,1225493,"2022-09-01",2022
"22-Sep",인천,강화군,354,37519,9465,47338,"2022-09-01",2022
"22-Sep",인천,계양구,307,122332,172010,294649,"2022-09-01",2022
"22-Sep",인천,남동구,864,249721,43585,294170,"2022-09-01",2022
"22-Sep",인천,동구,106,23555,2651,26312,"2022-09-01",2022
"22-Sep",인천,미추홀구,435,162327,8990,171752,"2022-09-01",2022
"22-Sep",인천,부평구,349,229835,39439,269623,"2022-09-01",2022
"22-Sep",인천,서구,471,279390,12169,292030,"2022-09-01",2022
"22-Sep",인천,연수구,432,203838,8995,213265,"2022-09-01",2022
"22-Sep",인천,옹진군,222,12776,249,13247,"2022-09-01",2022
"22-Sep",인천,중구,654,71821,12183,84658,"2022-09-01",2022
"22-Sep",인천,계,4194,1393114,309736,1707044,"2022-09-01",2022
"22-Sep",광주,광산구,534,200707,13343,214584,"2022-09-01",2022
"22-Sep",광주,남구,225,93000,2724,95949,"2022-09-01",2022
"22-Sep",광주,동구,232,45151,1057,46440,"2022-09-01",2022
"22-Sep",광주,북구,618,192866,9253,202737,"2022-09-01",2022
"22-Sep",광주,서구,723,144109,6347,151179,"2022-09-01",2022
"22-Sep",광주,계,2332,675833,32724,710889,"2022-09-01",2022
"22-Sep",대전,대덕구,240,87835,7659,95734,"2022-09-01",2022
"22-Sep",대전,동구,243,91943,4830,97016,"2022-09-01",2022
"22-Sep",대전,서구,825,209562,9291,219678,"2022-09-01",2022
"22-Sep",대전,유성구,663,183151,5639,189453,"2022-09-01",2022
"22-Sep",대전,중구,232,96515,5535,102282,"2022-09-01",2022
"22-Sep",대전,계,2203,669006,32954,704163,"2022-09-01",2022
"22-Sep",울산,남구,727,154675,7060,162462,"2022-09-01",2022
"22-Sep",울산,동구,190,62017,1224,63431,"2022-09-01",2022
"22-Sep",울산,북구,226,118984,3550,122760,"2022-09-01",2022
"22-Sep",울산,울주군,421,127047,7082,134550,"2022-09-01",2022
"22-Sep",울산,중구,330,99850,2563,102743,"2022-09-01",2022
"22-Sep",울산,계,1894,562573,21479,585946,"2022-09-01",2022
"22-Sep",세종,세종특별자치시,891,187743,3503,192137,"2022-09-01",2022
"22-Sep",세종,계,891,187743,3503,192137,"2022-09-01",2022
"22-Sep",경기,가평군,395,32079,563,33037,"2022-09-01",2022
"22-Sep",경기,고양시 덕양구,670,188084,4201,192955,"2022-09-01",2022
"22-Sep",경기,고양시 일산동구,275,128320,6551,135146,"2022-09-01",2022
"22-Sep",경기,고양시 일산서구,134,116709,4350,121193,"2022-09-01",2022
"22-Sep",경기,과천시,706,29291,692,30689,"2022-09-01",2022
"22-Sep",경기,광명시,302,101383,4409,106094,"2022-09-01",2022
"22-Sep",경기,광주시,408,200682,8586,209676,"2022-09-01",2022
"22-Sep",경기,구리시,276,70656,2803,73735,"2022-09-01",2022
"22-Sep",경기,군포시,298,99326,5203,104827,"2022-09-01",2022
"22-Sep",경기,김포시,545,232295,8631,241471,"2022-09-01",2022
"22-Sep",경기,남양주시,807,314830,9202,324839,"2022-09-01",2022
"22-Sep",경기,동두천시,213,39115,1517,40845,"2022-09-01",2022
"22-Sep",경기,부천시,735,296791,13017,310543,"2022-09-01",2022
"22-Sep",경기,성남시 분당구,370,189985,7623,197978,"2022-09-01",2022
"22-Sep",경기,성남시 수정구,304,77780,2700,80784,"2022-09-01",2022
"22-Sep",경기,성남시 중원구,394,70642,4001,75037,"2022-09-01",2022
"22-Sep",경기,수원시 권선구,485,202330,9715,212530,"2022-09-01",2022
"22-Sep",경기,수원시 영통구,412,147819,3252,151483,"2022-09-01",2022
"22-Sep",경기,수원시 장안구,478,104352,3783,108613,"2022-09-01",2022
"22-Sep",경기,수원시 팔달구,345,77298,3325,80968,"2022-09-01",2022
"22-Sep",경기,시흥시,468,258371,8524,267363,"2022-09-01",2022
"22-Sep",경기,안산시 단원구,582,161505,7660,169747,"2022-09-01",2022
"22-Sep",경기,안산시 상록구,152,145948,6040,152140,"2022-09-01",2022
"22-Sep",경기,안성시,409,110321,4817,115547,"2022-09-01",2022
"22-Sep",경기,안양시 동안구,400,121513,6680,128593,"2022-09-01",2022
"22-Sep",경기,안양시 만안구,163,84807,3962,88932,"2022-09-01",2022
"22-Sep",경기,양주시,412,115584,3535,119531,"2022-09-01",2022
"22-Sep",경기,양평군,606,63492,1946,66044,"2022-09-01",2022
"22-Sep",경기,여주시,463,66076,7378,73917,"2022-09-01",2022
"22-Sep",경기,연천군,315,24375,5252,29942,"2022-09-01",2022
"22-Sep",경기,오산시,217,110730,4031,114978,"2022-09-01",2022
"22-Sep",경기,용인시 기흥구,123,193153,6968,200244,"2022-09-01",2022
"22-Sep",경기,용인시 수지구,59,148718,2236,151013,"2022-09-01",2022
"22-Sep",경기,용인시 처인구,797,137228,8194,146219,"2022-09-01",2022
"22-Sep",경기,의왕시,304,66163,3009,69476,"2022-09-01",2022
"22-Sep",경기,의정부시,754,170017,5751,176522,"2022-09-01",2022
"22-Sep",경기,이천시,426,119337,6423,126186,"2022-09-01",2022
"22-Sep",경기,파주시,542,233439,11410,245391,"2022-09-01",2022
"22-Sep",경기,평택시,766,311257,13417,325440,"2022-09-01",2022
"22-Sep",경기,포천시,398,89336,9984,99718,"2022-09-01",2022
"22-Sep",경기,하남시,428,136124,3560,140112,"2022-09-01",2022
"22-Sep",경기,화성시,961,480699,13395,495055,"2022-09-01",2022
"22-Sep",경기,계,18297,6067960,248296,6334553,"2022-09-01",2022
"22-Sep",강원,강릉시,545,111909,4794,117248,"2022-09-01",2022
"22-Sep",강원,고성군,197,15635,233,16065,"2022-09-01",2022
"22-Sep",강원,동해시,318,46876,1468,48662,"2022-09-01",2022
"22-Sep",강원,삼척시,406,33093,787,34286,"2022-09-01",2022
"22-Sep",강원,속초시,310,39896,1402,41608,"2022-09-01",2022
"22-Sep",강원,양구군,211,12226,150,12587,"2022-09-01",2022
"22-Sep",강원,양양군,197,16475,318,16990,"2022-09-01",2022
"22-Sep",강원,영월군,340,21600,391,22331,"2022-09-01",2022
"22-Sep",강원,원주시,624,184583,5809,191016,"2022-09-01",2022
"22-Sep",강원,인제군,217,19442,296,19955,"2022-09-01",2022
"22-Sep",강원,정선군,352,20912,475,21739,"2022-09-01",2022
"22-Sep",강원,철원군,249,24430,333,25012,"2022-09-01",2022
"22-Sep",강원,춘천시,835,139413,6393,146641,"2022-09-01",2022
"22-Sep",강원,태백시,233,19869,752,20854,"2022-09-01",2022
"22-Sep",강원,평창군,322,26299,534,27155,"2022-09-01",2022
"22-Sep",강원,홍천군,423,39853,1039,41315,"2022-09-01",2022
"22-Sep",강원,화천군,234,13257,179,13670,"2022-09-01",2022
"22-Sep",강원,횡성군,286,27711,869,28866,"2022-09-01",2022
"22-Sep",강원,계,6299,813479,26222,846000,"2022-09-01",2022
"22-Sep",충북,괴산군,224,23548,402,24174,"2022-09-01",2022
"22-Sep",충북,단양군,235,15891,799,16925,"2022-09-01",2022
"22-Sep",충북,보은군,238,18481,971,19690,"2022-09-01",2022
"22-Sep",충북,영동군,258,25546,413,26217,"2022-09-01",2022
"22-Sep",충북,옥천군,213,28008,1180,29401,"2022-09-01",2022
"22-Sep",충북,음성군,266,60858,1996,63120,"2022-09-01",2022
"22-Sep",충북,제천시,338,68729,3463,72530,"2022-09-01",2022
"22-Sep",충북,증평군,92,20241,785,21118,"2022-09-01",2022
"22-Sep",충북,진천군,225,52744,1390,54359,"2022-09-01",2022
"22-Sep",충북,청원군,1,19,0,20,"2022-09-01",2022
"22-Sep",충북,청주시 상당구,504,96876,2674,100054,"2022-09-01",2022
"22-Sep",충북,청주시 서원구,245,101738,4444,106427,"2022-09-01",2022
"22-Sep",충북,청주시 청원구,387,106487,4723,111597,"2022-09-01",2022
"22-Sep",충북,청주시 흥덕구,365,135307,7759,143431,"2022-09-01",2022
"22-Sep",충북,충주시,627,113588,7776,121991,"2022-09-01",2022
"22-Sep",충북,계,4218,868061,38775,911054,"2022-09-01",2022
"22-Sep",충남,계룡시,163,23659,569,24391,"2022-09-01",2022
"22-Sep",충남,공주시,578,55243,2735,58556,"2022-09-01",2022
"22-Sep",충남,금산군,207,29018,2134,31359,"2022-09-01",2022
"22-Sep",충남,논산시,405,61780,2435,64620,"2022-09-01",2022
"22-Sep",충남,당진시,408,100037,4058,104503,"2022-09-01",2022
"22-Sep",충남,보령시,415,53371,1406,55192,"2022-09-01",2022
"22-Sep",충남,부여군,302,34744,1151,36197,"2022-09-01",2022
"22-Sep",충남,서산시,424,98786,3707,102917,"2022-09-01",2022
"22-Sep",충남,서천군,235,27410,818,28463,"2022-09-01",2022
"22-Sep",충남,아산시,536,182185,7049,189770,"2022-09-01",2022
"22-Sep",충남,예산군,427,44493,1408,46328,"2022-09-01",2022
"22-Sep",충남,천안시 동남구,293,135331,5406,141030,"2022-09-01",2022
"22-Sep",충남,천안시 서북구,544,202547,5658,208749,"2022-09-01",2022
"22-Sep",충남,청양군,256,17267,787,18310,"2022-09-01",2022
"22-Sep",충남,태안군,313,35277,564,36154,"2022-09-01",2022
"22-Sep",충남,홍성군,401,53884,1434,55719,"2022-09-01",2022
"22-Sep",충남,계,5907,1155032,41319,1202258,"2022-09-01",2022
"22-Sep",전북,고창군,328,31118,588,32034,"2022-09-01",2022
"22-Sep",전북,군산시,547,134442,6455,141444,"2022-09-01",2022
"22-Sep",전북,김제시,316,46807,2061,49184,"2022-09-01",2022
"22-Sep",전북,남원시,417,41858,2626,44901,"2022-09-01",2022
"22-Sep",전북,무주군,194,13291,401,13886,"2022-09-01",2022
"22-Sep",전북,부안군,264,27843,619,28726,"2022-09-01",2022
"22-Sep",전북,순창군,229,15009,160,15398,"2022-09-01",2022
"22-Sep",전북,완주군,418,53511,3130,57059,"2022-09-01",2022
"22-Sep",전북,익산시,549,138744,5838,145131,"2022-09-01",2022
"22-Sep",전북,임실군,219,14587,427,15233,"2022-09-01",2022
"22-Sep",전북,장수군,255,12465,179,12899,"2022-09-01",2022
"22-Sep",전북,전주시 덕진구,334,175106,6939,182379,"2022-09-01",2022
"22-Sep",전북,전주시 완산구,795,154692,4189,159676,"2022-09-01",2022
"22-Sep",전북,정읍시,358,55965,3741,60064,"2022-09-01",2022
"22-Sep",전북,진안군,268,14467,238,14973,"2022-09-01",2022
"22-Sep",전북,계,5491,929905,37591,972987,"2022-09-01",2022
"22-Sep",전남,강진군,256,18911,1044,20211,"2022-09-01",2022
"22-Sep",전남,고흥군,310,33168,590,34068,"2022-09-01",2022
"22-Sep",전남,곡성군,160,15286,684,16130,"2022-09-01",2022
"22-Sep",전남,광양시,263,87798,6140,94201,"2022-09-01",2022
"22-Sep",전남,구례군,147,13335,764,14246,"2022-09-01",2022
"22-Sep",전남,나주시,476,67009,3218,70703,"2022-09-01",2022
"22-Sep",전남,담양군,227,27952,1691,29870,"2022-09-01",2022
"22-Sep",전남,목포시,412,95850,5556,101818,"2022-09-01",2022
"22-Sep",전남,무안군,570,50648,1110,52328,"2022-09-01",2022
"22-Sep",전남,보성군,230,21900,2135,24265,"2022-09-01",2022
"22-Sep",전남,순천시,513,143976,5367,149856,"2022-09-01",2022
"22-Sep",전남,신안군,345,22329,96831,119505,"2022-09-01",2022
"22-Sep",전남,여수시,547,134490,7375,142412,"2022-09-01",2022
"22-Sep",전남,영광군,212,28902,779,29893,"2022-09-01",2022
"22-Sep",전남,영암군,286,34699,1373,36358,"2022-09-01",2022
"22-Sep",전남,완도군,283,25823,548,26654,"2022-09-01",2022
"22-Sep",전남,장성군,210,27396,1259,28865,"2022-09-01",2022
"22-Sep",전남,장흥군,265,20390,448,21103,"2022-09-01",2022
"22-Sep",전남,진도군,213,17316,298,17827,"2022-09-01",2022
"22-Sep",전남,함평군,212,18507,27623,46342,"2022-09-01",2022
"22-Sep",전남,해남군,326,40162,54350,94838,"2022-09-01",2022
"22-Sep",전남,화순군,244,33845,2072,36161,"2022-09-01",2022
"22-Sep",전남,계,6707,979692,221255,1207654,"2022-09-01",2022
"22-Sep",경북,경산시,342,141595,4363,146300,"2022-09-01",2022
"22-Sep",경북,경주시,608,144404,4549,149561,"2022-09-01",2022
"22-Sep",경북,고령군,176,20658,747,21581,"2022-09-01",2022
"22-Sep",경북,구미시,549,216305,7168,224022,"2022-09-01",2022
"22-Sep",경북,군위군,122,15569,310,16001,"2022-09-01",2022
"22-Sep",경북,김천시,393,76811,2019,79223,"2022-09-01",2022
"22-Sep",경북,문경시,280,38145,883,39308,"2022-09-01",2022
"22-Sep",경북,봉화군,233,18309,200,18742,"2022-09-01",2022
"22-Sep",경북,상주시,389,54192,1881,56462,"2022-09-01",2022
"22-Sep",경북,성주군,205,31502,1339,33046,"2022-09-01",2022
"22-Sep",경북,안동시,729,83826,2684,87239,"2022-09-01",2022
"22-Sep",경북,영덕군,254,19192,296,19742,"2022-09-01",2022
"22-Sep",경북,영양군,148,9953,111,10212,"2022-09-01",2022
"22-Sep",경북,영주시,359,56593,1521,58473,"2022-09-01",2022
"22-Sep",경북,영천시,350,61541,2574,64465,"2022-09-01",2022
"22-Sep",경북,예천군,294,31197,491,31982,"2022-09-01",2022
"22-Sep",경북,울릉군,158,5594,632,6384,"2022-09-01",2022
"22-Sep",경북,울진군,317,26709,338,27364,"2022-09-01",2022
"22-Sep",경북,의성군,324,31629,1081,33034,"2022-09-01",2022
"22-Sep",경북,청도군,217,25654,945,26816,"2022-09-01",2022
"22-Sep",경북,청송군,226,16003,213,16442,"2022-09-01",2022
"22-Sep",경북,칠곡군,305,70227,2466,72998,"2022-09-01",2022
"22-Sep",경북,포항시 남구,435,120864,8351,129650,"2022-09-01",2022
"22-Sep",경북,포항시 북구,363,142162,3589,146114,"2022-09-01",2022
"22-Sep",경북,계,7776,1458634,48751,1515161,"2022-09-01",2022
"22-Sep",경남,거제시,367,107395,2095,109857,"2022-09-01",2022
"22-Sep",경남,거창군,272,33227,761,34260,"2022-09-01",2022
"22-Sep",경남,고성군,230,27085,561,27876,"2022-09-01",2022
"22-Sep",경남,김해시,665,281578,7536,289779,"2022-09-01",2022
"22-Sep",경남,남해군,279,20461,448,21188,"2022-09-01",2022
"22-Sep",경남,밀양시,317,57075,3927,61319,"2022-09-01",2022
"22-Sep",경남,사천시,321,57797,1508,59626,"2022-09-01",2022
"22-Sep",경남,산청군,245,20746,735,21726,"2022-09-01",2022
"22-Sep",경남,양산시,427,171457,10657,182541,"2022-09-01",2022
"22-Sep",경남,의령군,207,15043,759,16009,"2022-09-01",2022
"22-Sep",경남,진주시,645,169593,6450,176688,"2022-09-01",2022
"22-Sep",경남,창녕군,229,36069,754,37052,"2022-09-01",2022
"22-Sep",경남,창원시 마산합포구,362,94569,2907,97838,"2022-09-01",2022
"22-Sep",경남,창원시 마산회원구,156,100572,5660,106388,"2022-09-01",2022
"22-Sep",경남,창원시 성산구,642,158239,53552,212433,"2022-09-01",2022
"22-Sep",경남,창원시 의창구,467,117826,3484,121777,"2022-09-01",2022
"22-Sep",경남,창원시 진해구,217,95489,2008,97714,"2022-09-01",2022
"22-Sep",경남,통영시,310,52904,1382,54596,"2022-09-01",2022
"22-Sep",경남,하동군,228,24258,379,24865,"2022-09-01",2022
"22-Sep",경남,함안군,204,43474,31071,74749,"2022-09-01",2022
"22-Sep",경남,함양군,231,19977,421,20629,"2022-09-01",2022
"22-Sep",경남,합천군,286,23876,623,24785,"2022-09-01",2022
"22-Sep",경남,계,7307,1728710,137678,1873695,"2022-09-01",2022
"22-Sep",제주,서귀포시,775,106852,1870,109497,"2022-09-01",2022
"22-Sep",제주,제주시,1632,302080,271258,574970,"2022-09-01",2022
"22-Sep",제주,계,2407,408932,273128,684467,"2022-09-01",2022
"22-Oct",서울,강남구,410,224576,22370,247356,"2022-10-01",2022
"22-Oct",서울,강동구,311,143931,8623,152865,"2022-10-01",2022
"22-Oct",서울,강북구,319,70745,4188,75252,"2022-10-01",2022
"22-Oct",서울,강서구,360,189409,17199,206968,"2022-10-01",2022
"22-Oct",서울,관악구,303,112652,5739,118694,"2022-10-01",2022
"22-Oct",서울,광진구,306,92462,5876,98644,"2022-10-01",2022
"22-Oct",서울,구로구,296,132820,14332,147448,"2022-10-01",2022
"22-Oct",서울,금천구,165,84939,6294,91398,"2022-10-01",2022
"22-Oct",서울,노원구,325,143446,8747,152518,"2022-10-01",2022
"22-Oct",서울,도봉구,283,87936,7515,95734,"2022-10-01",2022
"22-Oct",서울,동대문구,316,94218,4596,99130,"2022-10-01",2022
"22-Oct",서울,동작구,303,103256,2736,106295,"2022-10-01",2022
"22-Oct",서울,마포구,341,113590,7808,121739,"2022-10-01",2022
"22-Oct",서울,서대문구,452,84137,5546,90135,"2022-10-01",2022
"22-Oct",서울,서초구,534,165150,10753,176437,"2022-10-01",2022
"22-Oct",서울,성동구,367,93690,11447,105504,"2022-10-01",2022
"22-Oct",서울,성북구,302,117282,5102,122686,"2022-10-01",2022
"22-Oct",서울,송파구,396,235197,14438,250031,"2022-10-01",2022
"22-Oct",서울,양천구,326,142721,8604,151651,"2022-10-01",2022
"22-Oct",서울,영등포구,380,135991,8291,144662,"2022-10-01",2022
"22-Oct",서울,용산구,531,72821,2160,75512,"2022-10-01",2022
"22-Oct",서울,은평구,303,126915,7027,134245,"2022-10-01",2022
"22-Oct",서울,종로구,3690,44343,2072,50105,"2022-10-01",2022
"22-Oct",서울,중구,1241,52902,5208,59351,"2022-10-01",2022
"22-Oct",서울,중랑구,258,105961,9529,115748,"2022-10-01",2022
"22-Oct",서울,계,12818,2971090,206200,3190108,"2022-10-01",2022
"22-Oct",부산,강서구,328,83726,4552,88606,"2022-10-01",2022
"22-Oct",부산,금정구,274,79303,7253,86830,"2022-10-01",2022
"22-Oct",부산,기장군,271,82983,2685,85939,"2022-10-01",2022
"22-Oct",부산,남구,223,91003,9891,101117,"2022-10-01",2022
"22-Oct",부산,동구,183,56266,5923,62372,"2022-10-01",2022
"22-Oct",부산,동래구,172,97053,3605,100830,"2022-10-01",2022
"22-Oct",부산,부산진구,373,124660,22232,147265,"2022-10-01",2022
"22-Oct",부산,북구,232,102507,3720,106459,"2022-10-01",2022
"22-Oct",부산,사상구,284,82908,5561,88753,"2022-10-01",2022
"22-Oct",부산,사하구,271,108103,6157,114531,"2022-10-01",2022
"22-Oct",부산,서구,140,30189,1507,31836,"2022-10-01",2022
"22-Oct",부산,수영구,171,65594,49766,115531,"2022-10-01",2022
"22-Oct",부산,연제구,970,95281,13692,109943,"2022-10-01",2022
"22-Oct",부산,영도구,228,31599,1988,33815,"2022-10-01",2022
"22-Oct",부산,중구,307,31343,7029,38679,"2022-10-01",2022
"22-Oct",부산,해운대구,326,166064,16465,182855,"2022-10-01",2022
"22-Oct",부산,계,4753,1328582,162026,1495361,"2022-10-01",2022
"22-Oct",대구,남구,354,55877,1611,57842,"2022-10-01",2022
"22-Oct",대구,달서구,507,275267,15018,290792,"2022-10-01",2022
"22-Oct",대구,달성군,575,138861,5250,144686,"2022-10-01",2022
"22-Oct",대구,동구,371,158010,11011,169392,"2022-10-01",2022
"22-Oct",대구,북구,489,203811,7907,212207,"2022-10-01",2022
"22-Oct",대구,서구,259,67924,4467,72650,"2022-10-01",2022
"22-Oct",대구,수성구,592,211960,4745,217297,"2022-10-01",2022
"22-Oct",대구,중구,299,58870,2869,62038,"2022-10-01",2022
"22-Oct",대구,계,3446,1170580,52878,1226904,"2022-10-01",2022
"22-Oct",인천,강화군,348,37571,8923,46842,"2022-10-01",2022
"22-Oct",인천,계양구,309,122480,158592,281381,"2022-10-01",2022
"22-Oct",인천,남동구,896,250707,43220,294823,"2022-10-01",2022
"22-Oct",인천,동구,106,23637,2644,26387,"2022-10-01",2022
"22-Oct",인천,미추홀구,440,162542,8980,171962,"2022-10-01",2022
"22-Oct",인천,부평구,351,230476,39977,270804,"2022-10-01",2022
"22-Oct",인천,서구,475,280699,12217,293391,"2022-10-01",2022
"22-Oct",인천,연수구,433,204450,9048,213931,"2022-10-01",2022
"22-Oct",인천,옹진군,223,12819,247,13289,"2022-10-01",2022
"22-Oct",인천,중구,656,72338,12186,85180,"2022-10-01",2022
"22-Oct",인천,계,4237,1397719,296034,1697990,"2022-10-01",2022
"22-Oct",광주,광산구,535,200895,13354,214784,"2022-10-01",2022
"22-Oct",광주,남구,229,92816,2689,95734,"2022-10-01",2022
"22-Oct",광주,동구,233,45357,1076,46666,"2022-10-01",2022
"22-Oct",광주,북구,619,193689,9322,203630,"2022-10-01",2022
"22-Oct",광주,서구,719,143945,6431,151095,"2022-10-01",2022
"22-Oct",광주,계,2335,676702,32872,711909,"2022-10-01",2022
"22-Oct",대전,대덕구,239,88011,7707,95957,"2022-10-01",2022
"22-Oct",대전,동구,244,92029,4844,97117,"2022-10-01",2022
"22-Oct",대전,서구,825,209908,9365,220098,"2022-10-01",2022
"22-Oct",대전,유성구,664,183372,5673,189709,"2022-10-01",2022
"22-Oct",대전,중구,233,96557,5519,102309,"2022-10-01",2022
"22-Oct",대전,계,2205,669877,33108,705190,"2022-10-01",2022
"22-Oct",울산,남구,735,154844,7080,162659,"2022-10-01",2022
"22-Oct",울산,동구,191,62040,1228,63459,"2022-10-01",2022
"22-Oct",울산,북구,227,119355,3553,123135,"2022-10-01",2022
"22-Oct",울산,울주군,425,127186,7063,134674,"2022-10-01",2022
"22-Oct",울산,중구,331,99868,2566,102765,"2022-10-01",2022
"22-Oct",울산,계,1909,563293,21490,586692,"2022-10-01",2022
"22-Oct",세종,세종특별자치시,876,188199,3502,192577,"2022-10-01",2022
"22-Oct",세종,계,876,188199,3502,192577,"2022-10-01",2022
"22-Oct",경기,가평군,396,32165,564,33125,"2022-10-01",2022
"22-Oct",경기,고양시 덕양구,667,188725,4309,193701,"2022-10-01",2022
"22-Oct",경기,고양시 일산동구,277,128394,6688,135359,"2022-10-01",2022
"22-Oct",경기,고양시 일산서구,131,116655,4468,121254,"2022-10-01",2022
"22-Oct",경기,과천시,708,29198,699,30605,"2022-10-01",2022
"22-Oct",경기,광명시,301,101426,4415,106142,"2022-10-01",2022
"22-Oct",경기,광주시,408,200954,8594,209956,"2022-10-01",2022
"22-Oct",경기,구리시,276,70622,2866,73764,"2022-10-01",2022
"22-Oct",경기,군포시,299,99418,5183,104900,"2022-10-01",2022
"22-Oct",경기,김포시,547,232697,8670,241914,"2022-10-01",2022
"22-Oct",경기,남양주시,803,315269,9312,325384,"2022-10-01",2022
"22-Oct",경기,동두천시,213,39175,1535,40923,"2022-10-01",2022
"22-Oct",경기,부천시,742,296640,13042,310424,"2022-10-01",2022
"22-Oct",경기,성남시 분당구,372,190053,7904,198329,"2022-10-01",2022
"22-Oct",경기,성남시 수정구,306,77652,2691,80649,"2022-10-01",2022
"22-Oct",경기,성남시 중원구,394,71266,4013,75673,"2022-10-01",2022
"22-Oct",경기,수원시 권선구,488,201725,9667,211880,"2022-10-01",2022
"22-Oct",경기,수원시 영통구,415,147978,3329,151722,"2022-10-01",2022
"22-Oct",경기,수원시 장안구,478,104162,3785,108425,"2022-10-01",2022
"22-Oct",경기,수원시 팔달구,345,78466,3329,82140,"2022-10-01",2022
"22-Oct",경기,시흥시,467,258617,8532,267616,"2022-10-01",2022
"22-Oct",경기,안산시 단원구,582,161419,7714,169715,"2022-10-01",2022
"22-Oct",경기,안산시 상록구,151,145908,6084,152143,"2022-10-01",2022
"22-Oct",경기,안성시,406,110403,4788,115597,"2022-10-01",2022
"22-Oct",경기,안양시 동안구,398,121605,6816,128819,"2022-10-01",2022
"22-Oct",경기,안양시 만안구,162,85107,3976,89245,"2022-10-01",2022
"22-Oct",경기,양주시,413,116212,3551,120176,"2022-10-01",2022
"22-Oct",경기,양평군,616,63667,1931,66214,"2022-10-01",2022
"22-Oct",경기,여주시,461,66336,7394,74191,"2022-10-01",2022
"22-Oct",경기,연천군,317,24399,5255,29971,"2022-10-01",2022
"22-Oct",경기,오산시,218,110934,4032,115184,"2022-10-01",2022
"22-Oct",경기,용인시 기흥구,121,193731,6960,200812,"2022-10-01",2022
"22-Oct",경기,용인시 수지구,60,148916,2255,151231,"2022-10-01",2022
"22-Oct",경기,용인시 처인구,798,137303,8207,146308,"2022-10-01",2022
"22-Oct",경기,의왕시,301,66148,3011,69460,"2022-10-01",2022
"22-Oct",경기,의정부시,753,170345,5786,176884,"2022-10-01",2022
"22-Oct",경기,이천시,423,119696,6360,126479,"2022-10-01",2022
"22-Oct",경기,파주시,541,234550,11346,246437,"2022-10-01",2022
"22-Oct",경기,평택시,766,312281,13452,326499,"2022-10-01",2022
"22-Oct",경기,포천시,395,89363,9868,99626,"2022-10-01",2022
"22-Oct",경기,하남시,428,136433,3618,140479,"2022-10-01",2022
"22-Oct",경기,화성시,959,483054,13474,497487,"2022-10-01",2022
"22-Oct",경기,계,18302,6079067,249473,6346842,"2022-10-01",2022
"22-Oct",강원,강릉시,552,112019,4761,117332,"2022-10-01",2022
"22-Oct",강원,고성군,197,15756,230,16183,"2022-10-01",2022
"22-Oct",강원,동해시,319,46906,1478,48703,"2022-10-01",2022
"22-Oct",강원,삼척시,407,33184,793,34384,"2022-10-01",2022
"22-Oct",강원,속초시,311,39913,1399,41623,"2022-10-01",2022
"22-Oct",강원,양구군,215,12267,150,12632,"2022-10-01",2022
"22-Oct",강원,양양군,197,16517,317,17031,"2022-10-01",2022
"22-Oct",강원,영월군,339,21623,389,22351,"2022-10-01",2022
"22-Oct",강원,원주시,630,185209,5817,191656,"2022-10-01",2022
"22-Oct",강원,인제군,217,19454,294,19965,"2022-10-01",2022
"22-Oct",강원,정선군,357,20938,475,21770,"2022-10-01",2022
"22-Oct",강원,철원군,250,24445,333,25028,"2022-10-01",2022
"22-Oct",강원,춘천시,840,139735,6405,146980,"2022-10-01",2022
"22-Oct",강원,태백시,234,19887,736,20857,"2022-10-01",2022
"22-Oct",강원,평창군,320,26353,545,27218,"2022-10-01",2022
"22-Oct",강원,홍천군,423,39927,1033,41383,"2022-10-01",2022
"22-Oct",강원,화천군,235,13244,182,13661,"2022-10-01",2022
"22-Oct",강원,횡성군,284,27824,871,28979,"2022-10-01",2022
"22-Oct",강원,계,6327,815201,26208,847736,"2022-10-01",2022
"22-Oct",충북,괴산군,221,23604,411,24236,"2022-10-01",2022
"22-Oct",충북,단양군,238,15942,808,16988,"2022-10-01",2022
"22-Oct",충북,보은군,238,18535,974,19747,"2022-10-01",2022
"22-Oct",충북,영동군,258,25632,415,26305,"2022-10-01",2022
"22-Oct",충북,옥천군,213,28012,1179,29404,"2022-10-01",2022
"22-Oct",충북,음성군,269,60961,1983,63213,"2022-10-01",2022
"22-Oct",충북,제천시,340,68762,3452,72554,"2022-10-01",2022
"22-Oct",충북,증평군,93,20298,785,21176,"2022-10-01",2022
"22-Oct",충북,진천군,226,52918,1431,54575,"2022-10-01",2022
"22-Oct",충북,청원군,1,19,0,20,"2022-10-01",2022
"22-Oct",충북,청주시 상당구,503,97320,2683,100506,"2022-10-01",2022
"22-Oct",충북,청주시 서원구,244,101696,4415,106355,"2022-10-01",2022
"22-Oct",충북,청주시 청원구,386,106631,4745,111762,"2022-10-01",2022
"22-Oct",충북,청주시 흥덕구,364,135412,7843,143619,"2022-10-01",2022
"22-Oct",충북,충주시,618,113923,7852,122393,"2022-10-01",2022
"22-Oct",충북,계,4212,869665,38976,912853,"2022-10-01",2022
"22-Oct",충남,계룡시,164,23904,574,24642,"2022-10-01",2022
"22-Oct",충남,공주시,580,55384,2700,58664,"2022-10-01",2022
"22-Oct",충남,금산군,205,29075,2128,31408,"2022-10-01",2022
"22-Oct",충남,논산시,405,61970,2454,64829,"2022-10-01",2022
"22-Oct",충남,당진시,410,100317,4071,104798,"2022-10-01",2022
"22-Oct",충남,보령시,415,53426,1410,55251,"2022-10-01",2022
"22-Oct",충남,부여군,303,34812,1149,36264,"2022-10-01",2022
"22-Oct",충남,서산시,430,98998,3631,103059,"2022-10-01",2022
"22-Oct",충남,서천군,235,27402,816,28453,"2022-10-01",2022
"22-Oct",충남,아산시,547,182740,7012,190299,"2022-10-01",2022
"22-Oct",충남,예산군,429,44819,1406,46654,"2022-10-01",2022
"22-Oct",충남,천안시 동남구,294,135574,5401,141269,"2022-10-01",2022
"22-Oct",충남,천안시 서북구,545,203075,5620,209240,"2022-10-01",2022
"22-Oct",충남,청양군,258,17303,783,18344,"2022-10-01",2022
"22-Oct",충남,태안군,313,35359,561,36233,"2022-10-01",2022
"22-Oct",충남,홍성군,403,53870,1441,55714,"2022-10-01",2022
"22-Oct",충남,계,5936,1158028,41157,1205121,"2022-10-01",2022
"22-Oct",전북,고창군,328,31144,590,32062,"2022-10-01",2022
"22-Oct",전북,군산시,549,134645,6456,141650,"2022-10-01",2022
"22-Oct",전북,김제시,318,46959,2056,49333,"2022-10-01",2022
"22-Oct",전북,남원시,426,41925,2567,44918,"2022-10-01",2022
"22-Oct",전북,무주군,195,13293,402,13890,"2022-10-01",2022
"22-Oct",전북,부안군,269,27892,620,28781,"2022-10-01",2022
"22-Oct",전북,순창군,230,15065,161,15456,"2022-10-01",2022
"22-Oct",전북,완주군,419,53611,3120,57150,"2022-10-01",2022
"22-Oct",전북,익산시,551,138826,5841,145218,"2022-10-01",2022
"22-Oct",전북,임실군,221,14613,427,15261,"2022-10-01",2022
"22-Oct",전북,장수군,262,12501,180,12943,"2022-10-01",2022
"22-Oct",전북,전주시 덕진구,338,175582,6977,182897,"2022-10-01",2022
"22-Oct",전북,전주시 완산구,803,154742,4213,159758,"2022-10-01",2022
"22-Oct",전북,정읍시,358,56030,3709,60097,"2022-10-01",2022
"22-Oct",전북,진안군,268,14445,239,14952,"2022-10-01",2022
"22-Oct",전북,계,5535,931273,37558,974366,"2022-10-01",2022
"22-Oct",전남,강진군,256,18921,1041,20218,"2022-10-01",2022
"22-Oct",전남,고흥군,313,33191,588,34092,"2022-10-01",2022
"22-Oct",전남,곡성군,160,15318,682,16160,"2022-10-01",2022
"22-Oct",전남,광양시,264,88161,6202,94627,"2022-10-01",2022
"22-Oct",전남,구례군,147,13317,770,14234,"2022-10-01",2022
"22-Oct",전남,나주시,483,67039,3210,70732,"2022-10-01",2022
"22-Oct",전남,담양군,227,27976,1757,29960,"2022-10-01",2022
"22-Oct",전남,목포시,411,96166,5555,102132,"2022-10-01",2022
"22-Oct",전남,무안군,570,50697,1115,52382,"2022-10-01",2022
"22-Oct",전남,보성군,231,21991,1945,24167,"2022-10-01",2022
"22-Oct",전남,순천시,515,144208,5346,150069,"2022-10-01",2022
"22-Oct",전남,신안군,347,22403,98575,121325,"2022-10-01",2022
"22-Oct",전남,여수시,549,134701,7366,142616,"2022-10-01",2022
"22-Oct",전남,영광군,211,28957,781,29949,"2022-10-01",2022
"22-Oct",전남,영암군,285,34821,1347,36453,"2022-10-01",2022
"22-Oct",전남,완도군,286,25882,549,26717,"2022-10-01",2022
"22-Oct",전남,장성군,208,27446,1260,28914,"2022-10-01",2022
"22-Oct",전남,장흥군,265,20403,449,21117,"2022-10-01",2022
"22-Oct",전남,진도군,211,17337,298,17846,"2022-10-01",2022
"22-Oct",전남,함평군,212,18543,26832,45587,"2022-10-01",2022
"22-Oct",전남,해남군,327,40270,69657,110254,"2022-10-01",2022
"22-Oct",전남,화순군,247,33880,2067,36194,"2022-10-01",2022
"22-Oct",전남,계,6725,981628,237392,1225745,"2022-10-01",2022
"22-Oct",경북,경산시,341,141670,4366,146377,"2022-10-01",2022
"22-Oct",경북,경주시,611,144641,4556,149808,"2022-10-01",2022
"22-Oct",경북,고령군,177,20700,749,21626,"2022-10-01",2022
"22-Oct",경북,구미시,548,216443,7158,224149,"2022-10-01",2022
"22-Oct",경북,군위군,123,15568,309,16000,"2022-10-01",2022
"22-Oct",경북,김천시,398,76902,2014,79314,"2022-10-01",2022
"22-Oct",경북,문경시,280,38181,889,39350,"2022-10-01",2022
"22-Oct",경북,봉화군,235,18330,200,18765,"2022-10-01",2022
"22-Oct",경북,상주시,385,54396,1862,56643,"2022-10-01",2022
"22-Oct",경북,성주군,205,31519,1339,33063,"2022-10-01",2022
"22-Oct",경북,안동시,732,83951,2685,87368,"2022-10-01",2022
"22-Oct",경북,영덕군,250,19239,297,19786,"2022-10-01",2022
"22-Oct",경북,영양군,147,9981,109,10237,"2022-10-01",2022
"22-Oct",경북,영주시,363,56634,1518,58515,"2022-10-01",2022
"22-Oct",경북,영천시,356,61701,2524,64581,"2022-10-01",2022
"22-Oct",경북,예천군,295,31307,492,32094,"2022-10-01",2022
"22-Oct",경북,울릉군,160,5593,633,6386,"2022-10-01",2022
"22-Oct",경북,울진군,316,26764,340,27420,"2022-10-01",2022
"22-Oct",경북,의성군,327,31679,1082,33088,"2022-10-01",2022
"22-Oct",경북,청도군,219,25680,947,26846,"2022-10-01",2022
"22-Oct",경북,청송군,232,16057,213,16502,"2022-10-01",2022
"22-Oct",경북,칠곡군,308,70393,2472,73173,"2022-10-01",2022
"22-Oct",경북,포항시 남구,415,121814,8394,130623,"2022-10-01",2022
"22-Oct",경북,포항시 북구,364,142346,3585,146295,"2022-10-01",2022
"22-Oct",경북,계,7787,1461489,48733,1518009,"2022-10-01",2022
"22-Oct",경남,거제시,369,107461,2102,109932,"2022-10-01",2022
"22-Oct",경남,거창군,270,33322,761,34353,"2022-10-01",2022
"22-Oct",경남,고성군,232,27125,562,27919,"2022-10-01",2022
"22-Oct",경남,김해시,669,282000,7565,290234,"2022-10-01",2022
"22-Oct",경남,남해군,282,20498,446,21226,"2022-10-01",2022
"22-Oct",경남,밀양시,320,57193,3925,61438,"2022-10-01",2022
"22-Oct",경남,사천시,324,57904,1571,59799,"2022-10-01",2022
"22-Oct",경남,산청군,245,20772,738,21755,"2022-10-01",2022
"22-Oct",경남,양산시,428,171567,10663,182658,"2022-10-01",2022
"22-Oct",경남,의령군,209,15072,762,16043,"2022-10-01",2022
"22-Oct",경남,진주시,645,170089,6384,177118,"2022-10-01",2022
"22-Oct",경남,창녕군,231,36119,755,37105,"2022-10-01",2022
"22-Oct",경남,창원시 마산합포구,361,94826,2916,98103,"2022-10-01",2022
"22-Oct",경남,창원시 마산회원구,157,101071,5715,106943,"2022-10-01",2022
"22-Oct",경남,창원시 성산구,647,159212,53797,213656,"2022-10-01",2022
"22-Oct",경남,창원시 의창구,468,118114,3475,122057,"2022-10-01",2022
"22-Oct",경남,창원시 진해구,218,95677,2013,97908,"2022-10-01",2022
"22-Oct",경남,통영시,308,52958,1390,54656,"2022-10-01",2022
"22-Oct",경남,하동군,230,24264,377,24871,"2022-10-01",2022
"22-Oct",경남,함안군,209,43544,31635,75388,"2022-10-01",2022
"22-Oct",경남,함양군,233,20042,423,20698,"2022-10-01",2022
"22-Oct",경남,합천군,283,23898,627,24808,"2022-10-01",2022
"22-Oct",경남,계,7338,1732728,138602,1878668,"2022-10-01",2022
"22-Oct",제주,서귀포시,771,106906,1870,109547,"2022-10-01",2022
"22-Oct",제주,제주시,1638,303262,272116,577016,"2022-10-01",2022
"22-Oct",제주,계,2409,410168,273986,686563,"2022-10-01",2022
"22-Nov",서울,강남구,414,225111,22186,247711,"2022-11-01",2022
"22-Nov",서울,강동구,313,144171,8629,153113,"2022-11-01",2022
"22-Nov",서울,강북구,317,70740,4186,75243,"2022-11-01",2022
"22-Nov",서울,강서구,361,189904,17146,207411,"2022-11-01",2022
"22-Nov",서울,관악구,295,112751,5737,118783,"2022-11-01",2022
"22-Nov",서울,광진구,307,92459,5806,98572,"2022-11-01",2022
"22-Nov",서울,구로구,306,133198,14433,147937,"2022-11-01",2022
"22-Nov",서울,금천구,165,84990,6295,91450,"2022-11-01",2022
"22-Nov",서울,노원구,327,143505,8744,152576,"2022-11-01",2022
"22-Nov",서울,도봉구,284,87938,7496,95718,"2022-11-01",2022
"22-Nov",서울,동대문구,314,94376,4621,99311,"2022-11-01",2022
"22-Nov",서울,동작구,302,103103,2731,106136,"2022-11-01",2022
"22-Nov",서울,마포구,341,113629,7837,121807,"2022-11-01",2022
"22-Nov",서울,서대문구,452,84421,5550,90423,"2022-11-01",2022
"22-Nov",서울,서초구,519,165399,10713,176631,"2022-11-01",2022
"22-Nov",서울,성동구,360,93832,11044,105236,"2022-11-01",2022
"22-Nov",서울,성북구,301,117290,5105,122696,"2022-11-01",2022
"22-Nov",서울,송파구,396,235187,14508,250091,"2022-11-01",2022
"22-Nov",서울,양천구,326,142825,8638,151789,"2022-11-01",2022
"22-Nov",서울,영등포구,377,135857,8274,144508,"2022-11-01",2022
"22-Nov",서울,용산구,530,72810,2219,75559,"2022-11-01",2022
"22-Nov",서울,은평구,299,126835,6994,134128,"2022-11-01",2022
"22-Nov",서울,종로구,3632,44370,2054,50056,"2022-11-01",2022
"22-Nov",서울,중구,1247,52862,5212,59321,"2022-11-01",2022
"22-Nov",서울,중랑구,258,106128,9520,115906,"2022-11-01",2022
"22-Nov",서울,계,12743,2973691,205678,3192112,"2022-11-01",2022
"22-Nov",부산,강서구,325,83865,4551,88741,"2022-11-01",2022
"22-Nov",부산,금정구,278,79128,7256,86662,"2022-11-01",2022
"22-Nov",부산,기장군,273,83220,2690,86183,"2022-11-01",2022
"22-Nov",부산,남구,224,90918,9674,100816,"2022-11-01",2022
"22-Nov",부산,동구,185,56354,5822,62361,"2022-11-01",2022
"22-Nov",부산,동래구,171,97073,3595,100839,"2022-11-01",2022
"22-Nov",부산,부산진구,374,125403,22235,148012,"2022-11-01",2022
"22-Nov",부산,북구,234,102493,3710,106437,"2022-11-01",2022
"22-Nov",부산,사상구,283,83171,5564,89018,"2022-11-01",2022
"22-Nov",부산,사하구,269,108134,6057,114460,"2022-11-01",2022
"22-Nov",부산,서구,139,30267,1510,31916,"2022-11-01",2022
"22-Nov",부산,수영구,169,65584,51317,117070,"2022-11-01",2022
"22-Nov",부산,연제구,981,95265,13790,110036,"2022-11-01",2022
"22-Nov",부산,영도구,227,31605,2059,33891,"2022-11-01",2022
"22-Nov",부산,중구,306,31538,7072,38916,"2022-11-01",2022
"22-Nov",부산,해운대구,325,165803,16506,182634,"2022-11-01",2022
"22-Nov",부산,계,4763,1329821,163408,1497992,"2022-11-01",2022
"22-Nov",대구,남구,364,55960,1598,57922,"2022-11-01",2022
"22-Nov",대구,달서구,504,275742,15220,291466,"2022-11-01",2022
"22-Nov",대구,달성군,577,139194,5252,145023,"2022-11-01",2022
"22-Nov",대구,동구,375,158701,10928,170004,"2022-11-01",2022
"22-Nov",대구,북구,498,204227,7927,212652,"2022-11-01",2022
"22-Nov",대구,서구,273,68283,4542,73098,"2022-11-01",2022
"22-Nov",대구,수성구,591,211863,4751,217205,"2022-11-01",2022
"22-Nov",대구,중구,305,58925,2848,62078,"2022-11-01",2022
"22-Nov",대구,계,3487,1172895,53066,1229448,"2022-11-01",2022
"22-Nov",인천,강화군,347,37712,8482,46541,"2022-11-01",2022
"22-Nov",인천,계양구,308,122445,152439,275192,"2022-11-01",2022
"22-Nov",인천,남동구,903,251232,39905,292040,"2022-11-01",2022
"22-Nov",인천,동구,106,23837,2648,26591,"2022-11-01",2022
"22-Nov",인천,미추홀구,443,162732,8991,172166,"2022-11-01",2022
"22-Nov",인천,부평구,351,230667,40874,271892,"2022-11-01",2022
"22-Nov",인천,서구,477,282109,12280,294866,"2022-11-01",2022
"22-Nov",인천,연수구,428,205437,9134,214999,"2022-11-01",2022
"22-Nov",인천,옹진군,224,12880,248,13352,"2022-11-01",2022
"22-Nov",인천,중구,646,72901,12181,85728,"2022-11-01",2022
"22-Nov",인천,계,4233,1401952,287182,1693367,"2022-11-01",2022
"22-Nov",광주,광산구,545,201162,13388,215095,"2022-11-01",2022
"22-Nov",광주,남구,227,92782,2710,95719,"2022-11-01",2022
"22-Nov",광주,동구,234,45397,1075,46706,"2022-11-01",2022
"22-Nov",광주,북구,615,194182,9302,204099,"2022-11-01",2022
"22-Nov",광주,서구,717,144614,6421,151752,"2022-11-01",2022
"22-Nov",광주,계,2338,678137,32896,713371,"2022-11-01",2022
"22-Nov",대전,대덕구,239,88122,7726,96087,"2022-11-01",2022
"22-Nov",대전,동구,245,92146,4834,97225,"2022-11-01",2022
"22-Nov",대전,서구,820,210317,9394,220531,"2022-11-01",2022
"22-Nov",대전,유성구,661,184365,5668,190694,"2022-11-01",2022
"22-Nov",대전,중구,234,96607,5484,102325,"2022-11-01",2022
"22-Nov",대전,계,2199,671557,33106,706862,"2022-11-01",2022
"22-Nov",울산,남구,746,155054,7035,162835,"2022-11-01",2022
"22-Nov",울산,동구,191,62098,1225,63514,"2022-11-01",2022
"22-Nov",울산,북구,227,119699,3559,123485,"2022-11-01",2022
"22-Nov",울산,울주군,423,127544,7102,135069,"2022-11-01",2022
"22-Nov",울산,중구,330,99929,2565,102824,"2022-11-01",2022
"22-Nov",울산,계,1917,564324,21486,587727,"2022-11-01",2022
"22-Nov",세종,세종특별자치시,883,188772,3580,193235,"2022-11-01",2022
"22-Nov",세종,계,883,188772,3580,193235,"2022-11-01",2022
"22-Nov",경기,가평군,398,32252,559,33209,"2022-11-01",2022
"22-Nov",경기,고양시 덕양구,667,189393,4390,194450,"2022-11-01",2022
"22-Nov",경기,고양시 일산동구,277,128623,6743,135643,"2022-11-01",2022
"22-Nov",경기,고양시 일산서구,131,116782,4453,121366,"2022-11-01",2022
"22-Nov",경기,과천시,723,29293,697,30713,"2022-11-01",2022
"22-Nov",경기,광명시,302,101735,4386,106423,"2022-11-01",2022
"22-Nov",경기,광주시,406,201606,8607,210619,"2022-11-01",2022
"22-Nov",경기,구리시,274,70677,2870,73821,"2022-11-01",2022
"22-Nov",경기,군포시,301,99552,5367,105220,"2022-11-01",2022
"22-Nov",경기,김포시,548,233075,8697,242320,"2022-11-01",2022
"22-Nov",경기,남양주시,799,315861,9323,325983,"2022-11-01",2022
"22-Nov",경기,동두천시,211,39142,1527,40880,"2022-11-01",2022
"22-Nov",경기,부천시,722,296623,13074,310419,"2022-11-01",2022
"22-Nov",경기,성남시 분당구,372,190298,7944,198614,"2022-11-01",2022
"22-Nov",경기,성남시 수정구,303,77635,2708,80646,"2022-11-01",2022
"22-Nov",경기,성남시 중원구,395,71543,3965,75903,"2022-11-01",2022
"22-Nov",경기,수원시 권선구,491,202421,9705,212617,"2022-11-01",2022
"22-Nov",경기,수원시 영통구,407,148080,3470,151957,"2022-11-01",2022
"22-Nov",경기,수원시 장안구,499,104218,3782,108499,"2022-11-01",2022
"22-Nov",경기,수원시 팔달구,356,78981,3317,82654,"2022-11-01",2022
"22-Nov",경기,시흥시,457,259659,8599,268715,"2022-11-01",2022
"22-Nov",경기,안산시 단원구,581,161319,7714,169614,"2022-11-01",2022
"22-Nov",경기,안산시 상록구,155,145827,6028,152010,"2022-11-01",2022
"22-Nov",경기,안성시,404,110394,4766,115564,"2022-11-01",2022
"22-Nov",경기,안양시 동안구,399,121939,6866,129204,"2022-11-01",2022
"22-Nov",경기,안양시 만안구,160,85242,3971,89373,"2022-11-01",2022
"22-Nov",경기,양주시,410,117241,3573,121224,"2022-11-01",2022
"22-Nov",경기,양평군,616,63865,1937,66418,"2022-11-01",2022
"22-Nov",경기,여주시,461,66538,7403,74402,"2022-11-01",2022
"22-Nov",경기,연천군,316,24404,5248,29968,"2022-11-01",2022
"22-Nov",경기,오산시,217,110986,4006,115209,"2022-11-01",2022
"22-Nov",경기,용인시 기흥구,122,194093,7037,201252,"2022-11-01",2022
"22-Nov",경기,용인시 수지구,59,149226,2282,151567,"2022-11-01",2022
"22-Nov",경기,용인시 처인구,799,137685,8170,146654,"2022-11-01",2022
"22-Nov",경기,의왕시,301,66198,2886,69385,"2022-11-01",2022
"22-Nov",경기,의정부시,758,170974,5762,177494,"2022-11-01",2022
"22-Nov",경기,이천시,421,120252,6354,127027,"2022-11-01",2022
"22-Nov",경기,파주시,539,235557,11288,247384,"2022-11-01",2022
"22-Nov",경기,평택시,768,313694,13552,328014,"2022-11-01",2022
"22-Nov",경기,포천시,385,89411,9635,99431,"2022-11-01",2022
"22-Nov",경기,하남시,428,136817,3625,140870,"2022-11-01",2022
"22-Nov",경기,화성시,948,485880,13558,500386,"2022-11-01",2022
"22-Nov",경기,계,18286,6094991,249844,6363121,"2022-11-01",2022
"22-Nov",강원,강릉시,555,112324,4739,117618,"2022-11-01",2022
"22-Nov",강원,고성군,197,15763,231,16191,"2022-11-01",2022
"22-Nov",강원,동해시,321,47020,1492,48833,"2022-11-01",2022
"22-Nov",강원,삼척시,408,33205,797,34410,"2022-11-01",2022
"22-Nov",강원,속초시,307,40067,1391,41765,"2022-11-01",2022
"22-Nov",강원,양구군,213,12226,153,12592,"2022-11-01",2022
"22-Nov",강원,양양군,199,16607,320,17126,"2022-11-01",2022
"22-Nov",강원,영월군,347,21673,394,22414,"2022-11-01",2022
"22-Nov",강원,원주시,628,185641,5808,192077,"2022-11-01",2022
"22-Nov",강원,인제군,224,19517,292,20033,"2022-11-01",2022
"22-Nov",강원,정선군,358,20927,475,21760,"2022-11-01",2022
"22-Nov",강원,철원군,258,24517,333,25108,"2022-11-01",2022
"22-Nov",강원,춘천시,843,140308,6393,147544,"2022-11-01",2022
"22-Nov",강원,태백시,236,19949,749,20934,"2022-11-01",2022
"22-Nov",강원,평창군,315,26492,564,27371,"2022-11-01",2022
"22-Nov",강원,홍천군,432,40110,1030,41572,"2022-11-01",2022
"22-Nov",강원,화천군,234,13249,177,13660,"2022-11-01",2022
"22-Nov",강원,횡성군,285,27817,877,28979,"2022-11-01",2022
"22-Nov",강원,계,6360,817412,26215,849987,"2022-11-01",2022
"22-Nov",충북,괴산군,220,23704,410,24334,"2022-11-01",2022
"22-Nov",충북,단양군,237,15984,819,17040,"2022-11-01",2022
"22-Nov",충북,보은군,239,18611,974,19824,"2022-11-01",2022
"22-Nov",충북,영동군,254,25718,420,26392,"2022-11-01",2022
"22-Nov",충북,옥천군,213,28091,1175,29479,"2022-11-01",2022
"22-Nov",충북,음성군,266,61128,2012,63406,"2022-11-01",2022
"22-Nov",충북,제천시,333,69020,3465,72818,"2022-11-01",2022
"22-Nov",충북,증평군,91,20346,782,21219,"2022-11-01",2022
"22-Nov",충북,진천군,225,53093,1435,54753,"2022-11-01",2022
"22-Nov",충북,청원군,1,19,0,20,"2022-11-01",2022
"22-Nov",충북,청주시 상당구,501,97551,2691,100743,"2022-11-01",2022
"22-Nov",충북,청주시 서원구,244,101621,4389,106254,"2022-11-01",2022
"22-Nov",충북,청주시 청원구,388,107052,4767,112207,"2022-11-01",2022
"22-Nov",충북,청주시 흥덕구,386,135683,7808,143877,"2022-11-01",2022
"22-Nov",충북,충주시,618,114150,7893,122661,"2022-11-01",2022
"22-Nov",충북,계,4216,871771,39040,915027,"2022-11-01",2022
"22-Nov",충남,계룡시,170,24069,574,24813,"2022-11-01",2022
"22-Nov",충남,공주시,594,55495,2684,58773,"2022-11-01",2022
"22-Nov",충남,금산군,207,29218,2150,31575,"2022-11-01",2022
"22-Nov",충남,논산시,408,62148,2440,64996,"2022-11-01",2022
"22-Nov",충남,당진시,416,100742,4054,105212,"2022-11-01",2022
"22-Nov",충남,보령시,415,53541,1407,55363,"2022-11-01",2022
"22-Nov",충남,부여군,303,34812,1164,36279,"2022-11-01",2022
"22-Nov",충남,서산시,438,99321,3631,103390,"2022-11-01",2022
"22-Nov",충남,서천군,236,27458,807,28501,"2022-11-01",2022
"22-Nov",충남,아산시,556,183713,6981,191250,"2022-11-01",2022
"22-Nov",충남,예산군,428,45027,1409,46864,"2022-11-01",2022
"22-Nov",충남,천안시 동남구,298,135954,5381,141633,"2022-11-01",2022
"22-Nov",충남,천안시 서북구,554,203600,5588,209742,"2022-11-01",2022
"22-Nov",충남,청양군,256,17337,778,18371,"2022-11-01",2022
"22-Nov",충남,태안군,316,35466,559,36341,"2022-11-01",2022
"22-Nov",충남,홍성군,403,54000,1454,55857,"2022-11-01",2022
"22-Nov",충남,계,5998,1161901,41061,1208960,"2022-11-01",2022
"22-Nov",전북,고창군,327,31175,593,32095,"2022-11-01",2022
"22-Nov",전북,군산시,541,134892,6460,141893,"2022-11-01",2022
"22-Nov",전북,김제시,328,47129,2052,49509,"2022-11-01",2022
"22-Nov",전북,남원시,429,42038,2463,44930,"2022-11-01",2022
"22-Nov",전북,무주군,196,13327,407,13930,"2022-11-01",2022
"22-Nov",전북,부안군,280,27976,619,28875,"2022-11-01",2022
"22-Nov",전북,순창군,230,15115,162,15507,"2022-11-01",2022
"22-Nov",전북,완주군,420,53815,3139,57374,"2022-11-01",2022
"22-Nov",전북,익산시,549,139150,5833,145532,"2022-11-01",2022
"22-Nov",전북,임실군,219,14638,424,15281,"2022-11-01",2022
"22-Nov",전북,장수군,261,12529,149,12939,"2022-11-01",2022
"22-Nov",전북,전주시 덕진구,386,176321,6980,183687,"2022-11-01",2022
"22-Nov",전북,전주시 완산구,772,154691,4193,159656,"2022-11-01",2022
"22-Nov",전북,정읍시,357,56174,3662,60193,"2022-11-01",2022
"22-Nov",전북,진안군,268,14409,240,14917,"2022-11-01",2022
"22-Nov",전북,계,5563,933379,37376,976318,"2022-11-01",2022
"22-Nov",전남,강진군,254,18974,1043,20271,"2022-11-01",2022
"22-Nov",전남,고흥군,312,33258,593,34163,"2022-11-01",2022
"22-Nov",전남,곡성군,161,15361,675,16197,"2022-11-01",2022
"22-Nov",전남,광양시,259,88524,6254,95037,"2022-11-01",2022
"22-Nov",전남,구례군,150,13346,783,14279,"2022-11-01",2022
"22-Nov",전남,나주시,484,67438,3210,71132,"2022-11-01",2022
"22-Nov",전남,담양군,228,28060,1779,30067,"2022-11-01",2022
"22-Nov",전남,목포시,412,96481,5578,102471,"2022-11-01",2022
"22-Nov",전남,무안군,572,50778,1127,52477,"2022-11-01",2022
"22-Nov",전남,보성군,231,22052,1733,24016,"2022-11-01",2022
"22-Nov",전남,순천시,522,144489,5383,150394,"2022-11-01",2022
"22-Nov",전남,신안군,345,22442,100195,122982,"2022-11-01",2022
"22-Nov",전남,여수시,557,134984,7340,142881,"2022-11-01",2022
"22-Nov",전남,영광군,212,29026,781,30019,"2022-11-01",2022
"22-Nov",전남,영암군,282,34946,1344,36572,"2022-11-01",2022
"22-Nov",전남,완도군,286,25891,544,26721,"2022-11-01",2022
"22-Nov",전남,장성군,207,27475,1253,28935,"2022-11-01",2022
"22-Nov",전남,장흥군,265,20421,454,21140,"2022-11-01",2022
"22-Nov",전남,진도군,209,17401,301,17911,"2022-11-01",2022
"22-Nov",전남,함평군,209,18628,25694,44531,"2022-11-01",2022
"22-Nov",전남,해남군,326,40420,76263,117009,"2022-11-01",2022
"22-Nov",전남,화순군,248,33944,2068,36260,"2022-11-01",2022
"22-Nov",전남,계,6731,984339,244395,1235465,"2022-11-01",2022
"22-Nov",경북,경산시,340,141795,4363,146498,"2022-11-01",2022
"22-Nov",경북,경주시,616,145084,4550,150250,"2022-11-01",2022
"22-Nov",경북,고령군,178,20851,733,21762,"2022-11-01",2022
"22-Nov",경북,구미시,555,216841,7160,224556,"2022-11-01",2022
"22-Nov",경북,군위군,123,15592,308,16023,"2022-11-01",2022
"22-Nov",경북,김천시,397,77079,2014,79490,"2022-11-01",2022
"22-Nov",경북,문경시,283,38244,891,39418,"2022-11-01",2022
"22-Nov",경북,봉화군,238,18361,200,18799,"2022-11-01",2022
"22-Nov",경북,상주시,385,54459,1858,56702,"2022-11-01",2022
"22-Nov",경북,성주군,206,31570,1334,33110,"2022-11-01",2022
"22-Nov",경북,안동시,745,84076,2672,87493,"2022-11-01",2022
"22-Nov",경북,영덕군,252,19268,298,19818,"2022-11-01",2022
"22-Nov",경북,영양군,147,10006,108,10261,"2022-11-01",2022
"22-Nov",경북,영주시,363,56786,1514,58663,"2022-11-01",2022
"22-Nov",경북,영천시,351,61827,2518,64696,"2022-11-01",2022
"22-Nov",경북,예천군,294,31419,495,32208,"2022-11-01",2022
"22-Nov",경북,울릉군,162,5585,587,6334,"2022-11-01",2022
"22-Nov",경북,울진군,318,26826,338,27482,"2022-11-01",2022
"22-Nov",경북,의성군,329,31718,1084,33131,"2022-11-01",2022
"22-Nov",경북,청도군,218,25777,949,26944,"2022-11-01",2022
"22-Nov",경북,청송군,232,16081,216,16529,"2022-11-01",2022
"22-Nov",경북,칠곡군,297,70549,2471,73317,"2022-11-01",2022
"22-Nov",경북,포항시 남구,416,122555,8391,131362,"2022-11-01",2022
"22-Nov",경북,포항시 북구,363,142724,3581,146668,"2022-11-01",2022
"22-Nov",경북,계,7808,1465073,48633,1521514,"2022-11-01",2022
"22-Nov",경남,거제시,370,107639,2087,110096,"2022-11-01",2022
"22-Nov",경남,거창군,272,33445,764,34481,"2022-11-01",2022
"22-Nov",경남,고성군,229,27188,565,27982,"2022-11-01",2022
"22-Nov",경남,김해시,665,282429,7563,290657,"2022-11-01",2022
"22-Nov",경남,남해군,286,20553,445,21284,"2022-11-01",2022
"22-Nov",경남,밀양시,313,57414,3925,61652,"2022-11-01",2022
"22-Nov",경남,사천시,323,58044,1571,59938,"2022-11-01",2022
"22-Nov",경남,산청군,245,20856,739,21840,"2022-11-01",2022
"22-Nov",경남,양산시,429,172272,10643,183344,"2022-11-01",2022
"22-Nov",경남,의령군,210,15121,762,16093,"2022-11-01",2022
"22-Nov",경남,진주시,648,170548,6449,177645,"2022-11-01",2022
"22-Nov",경남,창녕군,231,36084,752,37067,"2022-11-01",2022
"22-Nov",경남,창원시 마산합포구,369,95559,2909,98837,"2022-11-01",2022
"22-Nov",경남,창원시 마산회원구,160,101603,5713,107476,"2022-11-01",2022
"22-Nov",경남,창원시 성산구,646,159920,57050,217616,"2022-11-01",2022
"22-Nov",경남,창원시 의창구,478,118508,3464,122450,"2022-11-01",2022
"22-Nov",경남,창원시 진해구,221,95903,2017,98141,"2022-11-01",2022
"22-Nov",경남,통영시,308,53034,1368,54710,"2022-11-01",2022
"22-Nov",경남,하동군,231,24268,378,24877,"2022-11-01",2022
"22-Nov",경남,함안군,208,44099,31465,75772,"2022-11-01",2022
"22-Nov",경남,함양군,234,20089,423,20746,"2022-11-01",2022
"22-Nov",경남,합천군,274,23969,630,24873,"2022-11-01",2022
"22-Nov",경남,계,7350,1738545,141682,1887577,"2022-11-01",2022
"22-Nov",제주,서귀포시,759,107253,1869,109881,"2022-11-01",2022
"22-Nov",제주,제주시,1639,304736,273022,579397,"2022-11-01",2022
"22-Nov",제주,계,2398,411989,274891,689278,"2022-11-01",2022
"22-Dec",서울,강남구,402,225502,22416,248320,"2022-12-01",2022
"22-Dec",서울,강동구,311,144289,8586,153186,"2022-12-01",2022
"22-Dec",서울,강북구,320,70698,4162,75180,"2022-12-01",2022
"22-Dec",서울,강서구,356,190069,17111,207536,"2022-12-01",2022
"22-Dec",서울,관악구,297,112595,5723,118615,"2022-12-01",2022
"22-Dec",서울,광진구,307,92466,5762,98535,"2022-12-01",2022
"22-Dec",서울,구로구,314,133556,14789,148659,"2022-12-01",2022
"22-Dec",서울,금천구,166,85119,6391,91676,"2022-12-01",2022
"22-Dec",서울,노원구,325,143452,8752,152529,"2022-12-01",2022
"22-Dec",서울,도봉구,284,87949,7457,95690,"2022-12-01",2022
"22-Dec",서울,동대문구,313,94338,4796,99447,"2022-12-01",2022
"22-Dec",서울,동작구,300,102989,2748,106037,"2022-12-01",2022
"22-Dec",서울,마포구,332,113820,7866,122018,"2022-12-01",2022
"22-Dec",서울,서대문구,468,84859,5605,90932,"2022-12-01",2022
"22-Dec",서울,서초구,533,165624,10642,176799,"2022-12-01",2022
"22-Dec",서울,성동구,368,93808,10258,104434,"2022-12-01",2022
"22-Dec",서울,성북구,299,117249,5096,122644,"2022-12-01",2022
"22-Dec",서울,송파구,397,235233,14512,250142,"2022-12-01",2022
"22-Dec",서울,양천구,324,142874,8648,151846,"2022-12-01",2022
"22-Dec",서울,영등포구,382,135938,8276,144596,"2022-12-01",2022
"22-Dec",서울,용산구,520,72788,2197,75505,"2022-12-01",2022
"22-Dec",서울,은평구,296,126481,6981,133758,"2022-12-01",2022
"22-Dec",서울,종로구,3811,44388,2138,50337,"2022-12-01",2022
"22-Dec",서울,중구,1275,52526,5035,58836,"2022-12-01",2022
"22-Dec",서울,중랑구,254,106244,9596,116094,"2022-12-01",2022
"22-Dec",서울,계,12954,2974854,205543,3193351,"2022-12-01",2022
"22-Dec",부산,강서구,324,83971,4669,88964,"2022-12-01",2022
"22-Dec",부산,금정구,273,79073,7250,86596,"2022-12-01",2022
"22-Dec",부산,기장군,261,83356,2705,86322,"2022-12-01",2022
"22-Dec",부산,남구,223,90906,9561,100690,"2022-12-01",2022
"22-Dec",부산,동구,195,41593,5661,47449,"2022-12-01",2022
"22-Dec",부산,동래구,175,97040,3568,100783,"2022-12-01",2022
"22-Dec",부산,부산진구,370,125735,21933,148038,"2022-12-01",2022
"22-Dec",부산,북구,238,102366,3705,106309,"2022-12-01",2022
"22-Dec",부산,사상구,285,83332,5540,89157,"2022-12-01",2022
"22-Dec",부산,사하구,266,108093,6041,114400,"2022-12-01",2022
"22-Dec",부산,서구,138,30291,1515,31944,"2022-12-01",2022
"22-Dec",부산,수영구,167,65476,52864,118507,"2022-12-01",2022
"22-Dec",부산,연제구,978,109627,13829,124434,"2022-12-01",2022
"22-Dec",부산,영도구,229,31577,2050,33856,"2022-12-01",2022
"22-Dec",부산,중구,310,31610,7088,39008,"2022-12-01",2022
"22-Dec",부산,해운대구,328,165990,16728,183046,"2022-12-01",2022
"22-Dec",부산,계,4760,1330036,164707,1499503,"2022-12-01",2022
"22-Dec",대구,남구,369,55922,1588,57879,"2022-12-01",2022
"22-Dec",대구,달서구,504,276070,15611,292185,"2022-12-01",2022
"22-Dec",대구,달성군,579,139335,5249,145163,"2022-12-01",2022
"22-Dec",대구,동구,373,158768,10777,169918,"2022-12-01",2022
"22-Dec",대구,북구,500,204232,7918,212650,"2022-12-01",2022
"22-Dec",대구,서구,277,68141,4430,72848,"2022-12-01",2022
"22-Dec",대구,수성구,590,212316,4759,217665,"2022-12-01",2022
"22-Dec",대구,중구,306,58759,2810,61875,"2022-12-01",2022
"22-Dec",대구,계,3498,1173543,53142,1230183,"2022-12-01",2022
"22-Dec",인천,강화군,346,37754,8148,46248,"2022-12-01",2022
"22-Dec",인천,계양구,311,122518,152225,275054,"2022-12-01",2022
"22-Dec",인천,남동구,904,252188,35810,288902,"2022-12-01",2022
"22-Dec",인천,동구,102,23952,2639,26693,"2022-12-01",2022
"22-Dec",인천,미추홀구,450,162604,9024,172078,"2022-12-01",2022
"22-Dec",인천,부평구,355,230311,41037,271703,"2022-12-01",2022
"22-Dec",인천,서구,479,283895,12305,296679,"2022-12-01",2022
"22-Dec",인천,연수구,431,206292,9221,215944,"2022-12-01",2022
"22-Dec",인천,옹진군,221,12875,254,13350,"2022-12-01",2022
"22-Dec",인천,중구,655,73270,12184,86109,"2022-12-01",2022
"22-Dec",인천,계,4254,1405659,282847,1692760,"2022-12-01",2022
"22-Dec",광주,광산구,547,201557,13310,215414,"2022-12-01",2022
"22-Dec",광주,남구,231,92740,2681,95652,"2022-12-01",2022
"22-Dec",광주,동구,235,45539,1068,46842,"2022-12-01",2022
"22-Dec",광주,북구,611,194405,9343,204359,"2022-12-01",2022
"22-Dec",광주,서구,732,144993,6409,152134,"2022-12-01",2022
"22-Dec",광주,계,2356,679234,32811,714401,"2022-12-01",2022
"22-Dec",대전,대덕구,241,88231,7765,96237,"2022-12-01",2022
"22-Dec",대전,동구,251,92114,4847,97212,"2022-12-01",2022
"22-Dec",대전,서구,822,210200,9337,220359,"2022-12-01",2022
"22-Dec",대전,유성구,654,185537,5656,191847,"2022-12-01",2022
"22-Dec",대전,중구,231,96581,5461,102273,"2022-12-01",2022
"22-Dec",대전,계,2199,672663,33066,707928,"2022-12-01",2022
"22-Dec",울산,남구,735,155227,7013,162975,"2022-12-01",2022
"22-Dec",울산,동구,185,62139,1226,63550,"2022-12-01",2022
"22-Dec",울산,북구,226,119670,3573,123469,"2022-12-01",2022
"22-Dec",울산,울주군,426,127830,7064,135320,"2022-12-01",2022
"22-Dec",울산,중구,330,99861,2574,102765,"2022-12-01",2022
"22-Dec",울산,계,1902,564727,21450,588079,"2022-12-01",2022
"22-Dec",세종,세종특별자치시,877,189232,3602,193711,"2022-12-01",2022
"22-Dec",세종,계,877,189232,3602,193711,"2022-12-01",2022
"22-Dec",경기,가평군,396,32343,554,33293,"2022-12-01",2022
"22-Dec",경기,고양시 덕양구,680,190718,4381,195779,"2022-12-01",2022
"22-Dec",경기,고양시 일산동구,278,128683,6737,135698,"2022-12-01",2022
"22-Dec",경기,고양시 일산서구,133,116802,4434,121369,"2022-12-01",2022
"22-Dec",경기,과천시,720,29538,705,30963,"2022-12-01",2022
"22-Dec",경기,광명시,306,101828,4383,106517,"2022-12-01",2022
"22-Dec",경기,광주시,409,202024,8611,211044,"2022-12-01",2022
"22-Dec",경기,구리시,276,70758,2895,73929,"2022-12-01",2022
"22-Dec",경기,군포시,306,99640,5380,105326,"2022-12-01",2022
"22-Dec",경기,김포시,552,233449,8643,242644,"2022-12-01",2022
"22-Dec",경기,남양주시,800,316376,9474,326650,"2022-12-01",2022
"22-Dec",경기,동두천시,216,39143,1516,40875,"2022-12-01",2022
"22-Dec",경기,부천시,727,296626,13088,310441,"2022-12-01",2022
"22-Dec",경기,성남시 분당구,375,190322,8006,198703,"2022-12-01",2022
"22-Dec",경기,성남시 수정구,316,77152,2671,80139,"2022-12-01",2022
"22-Dec",경기,성남시 중원구,393,73329,3990,77712,"2022-12-01",2022
"22-Dec",경기,수원시 권선구,499,202627,9797,212923,"2022-12-01",2022
"22-Dec",경기,수원시 영통구,415,148300,3452,152167,"2022-12-01",2022
"22-Dec",경기,수원시 장안구,496,104228,3795,108519,"2022-12-01",2022
"22-Dec",경기,수원시 팔달구,355,79301,3285,82941,"2022-12-01",2022
"22-Dec",경기,시흥시,464,260419,8601,269484,"2022-12-01",2022
"22-Dec",경기,안산시 단원구,587,161661,7728,169976,"2022-12-01",2022
"22-Dec",경기,안산시 상록구,157,145864,6025,152046,"2022-12-01",2022
"22-Dec",경기,안성시,402,110600,4870,115872,"2022-12-01",2022
"22-Dec",경기,안양시 동안구,402,122187,6874,129463,"2022-12-01",2022
"22-Dec",경기,안양시 만안구,159,85415,3988,89562,"2022-12-01",2022
"22-Dec",경기,양주시,418,118400,3589,122407,"2022-12-01",2022
"22-Dec",경기,양평군,616,64020,1938,66574,"2022-12-01",2022
"22-Dec",경기,여주시,466,66711,7407,74584,"2022-12-01",2022
"22-Dec",경기,연천군,320,24410,5236,29966,"2022-12-01",2022
"22-Dec",경기,오산시,216,111108,4021,115345,"2022-12-01",2022
"22-Dec",경기,용인시 기흥구,121,194481,7045,201647,"2022-12-01",2022
"22-Dec",경기,용인시 수지구,59,149527,2299,151885,"2022-12-01",2022
"22-Dec",경기,용인시 처인구,813,137990,8204,147007,"2022-12-01",2022
"22-Dec",경기,의왕시,306,66243,2890,69439,"2022-12-01",2022
"22-Dec",경기,의정부시,746,171228,5781,177755,"2022-12-01",2022
"22-Dec",경기,이천시,422,120508,6317,127247,"2022-12-01",2022
"22-Dec",경기,파주시,543,236159,11272,247974,"2022-12-01",2022
"22-Dec",경기,평택시,781,314976,13548,329305,"2022-12-01",2022
"22-Dec",경기,포천시,386,89473,9411,99270,"2022-12-01",2022
"22-Dec",경기,하남시,436,137294,3632,141362,"2022-12-01",2022
"22-Dec",경기,화성시,954,488260,13616,502830,"2022-12-01",2022
"22-Dec",경기,계,18422,6110121,250089,6378632,"2022-12-01",2022
"22-Dec",강원,강릉시,554,112443,4795,117792,"2022-12-01",2022
"22-Dec",강원,고성군,196,15765,226,16187,"2022-12-01",2022
"22-Dec",강원,동해시,323,47121,1491,48935,"2022-12-01",2022
"22-Dec",강원,삼척시,409,33262,811,34482,"2022-12-01",2022
"22-Dec",강원,속초시,308,40177,1385,41870,"2022-12-01",2022
"22-Dec",강원,양구군,215,12311,151,12677,"2022-12-01",2022
"22-Dec",강원,양양군,203,16650,319,17172,"2022-12-01",2022
"22-Dec",강원,영월군,345,21705,391,22441,"2022-12-01",2022
"22-Dec",강원,원주시,636,186005,5796,192437,"2022-12-01",2022
"22-Dec",강원,인제군,225,19564,305,20094,"2022-12-01",2022
"22-Dec",강원,정선군,353,20958,474,21785,"2022-12-01",2022
"22-Dec",강원,철원군,257,24487,335,25079,"2022-12-01",2022
"22-Dec",강원,춘천시,847,140651,6406,147904,"2022-12-01",2022
"22-Dec",강원,태백시,236,19967,729,20932,"2022-12-01",2022
"22-Dec",강원,평창군,320,26555,582,27457,"2022-12-01",2022
"22-Dec",강원,홍천군,438,40211,1027,41676,"2022-12-01",2022
"22-Dec",강원,화천군,235,13156,177,13568,"2022-12-01",2022
"22-Dec",강원,횡성군,288,27885,892,29065,"2022-12-01",2022
"22-Dec",강원,계,6388,818873,26292,851553,"2022-12-01",2022
"22-Dec",충북,괴산군,221,23798,429,24448,"2022-12-01",2022
"22-Dec",충북,단양군,238,15981,814,17033,"2022-12-01",2022
"22-Dec",충북,보은군,235,18667,971,19873,"2022-12-01",2022
"22-Dec",충북,영동군,252,25755,424,26431,"2022-12-01",2022
"22-Dec",충북,옥천군,213,28234,1172,29619,"2022-12-01",2022
"22-Dec",충북,음성군,268,61272,2018,63558,"2022-12-01",2022
"22-Dec",충북,제천시,333,69156,3471,72960,"2022-12-01",2022
"22-Dec",충북,증평군,91,20358,782,21231,"2022-12-01",2022
"22-Dec",충북,진천군,226,53198,1434,54858,"2022-12-01",2022
"22-Dec",충북,청원군,1,19,0,20,"2022-12-01",2022
"22-Dec",충북,청주시 상당구,504,98084,2703,101291,"2022-12-01",2022
"22-Dec",충북,청주시 서원구,241,101393,4394,106028,"2022-12-01",2022
"22-Dec",충북,청주시 청원구,396,107166,4758,112320,"2022-12-01",2022
"22-Dec",충북,청주시 흥덕구,371,135894,7756,144021,"2022-12-01",2022
"22-Dec",충북,충주시,619,114351,7794,122764,"2022-12-01",2022
"22-Dec",충북,계,4209,873326,38920,916455,"2022-12-01",2022
"22-Dec",충남,계룡시,168,24215,574,24957,"2022-12-01",2022
"22-Dec",충남,공주시,593,55489,2720,58802,"2022-12-01",2022
"22-Dec",충남,금산군,210,29289,2178,31677,"2022-12-01",2022
"22-Dec",충남,논산시,409,62199,2433,65041,"2022-12-01",2022
"22-Dec",충남,당진시,419,101041,4017,105477,"2022-12-01",2022
"22-Dec",충남,보령시,417,53663,1405,55485,"2022-12-01",2022
"22-Dec",충남,부여군,305,34900,1134,36339,"2022-12-01",2022
"22-Dec",충남,서산시,445,99530,3675,103650,"2022-12-01",2022
"22-Dec",충남,서천군,238,27474,811,28523,"2022-12-01",2022
"22-Dec",충남,아산시,546,184502,6938,191986,"2022-12-01",2022
"22-Dec",충남,예산군,424,45203,1397,47024,"2022-12-01",2022
"22-Dec",충남,천안시 동남구,302,136294,5416,142012,"2022-12-01",2022
"22-Dec",충남,천안시 서북구,552,203716,5516,209784,"2022-12-01",2022
"22-Dec",충남,청양군,261,17407,774,18442,"2022-12-01",2022
"22-Dec",충남,태안군,316,35483,555,36354,"2022-12-01",2022
"22-Dec",충남,홍성군,403,54055,1466,55924,"2022-12-01",2022
"22-Dec",충남,계,6008,1164460,41009,1211477,"2022-12-01",2022
"22-Dec",전북,고창군,326,31126,573,32025,"2022-12-01",2022
"22-Dec",전북,군산시,555,135159,6459,142173,"2022-12-01",2022
"22-Dec",전북,김제시,330,47271,2118,49719,"2022-12-01",2022
"22-Dec",전북,남원시,428,42096,2357,44881,"2022-12-01",2022
"22-Dec",전북,무주군,198,13341,409,13948,"2022-12-01",2022
"22-Dec",전북,부안군,272,28019,620,28911,"2022-12-01",2022
"22-Dec",전북,순창군,232,15155,162,15549,"2022-12-01",2022
"22-Dec",전북,완주군,430,54282,3144,57856,"2022-12-01",2022
"22-Dec",전북,익산시,555,139303,5808,145666,"2022-12-01",2022
"22-Dec",전북,임실군,221,14698,424,15343,"2022-12-01",2022
"22-Dec",전북,장수군,264,12508,149,12921,"2022-12-01",2022
"22-Dec",전북,전주시 덕진구,392,176565,7005,183962,"2022-12-01",2022
"22-Dec",전북,전주시 완산구,772,154623,4197,159592,"2022-12-01",2022
"22-Dec",전북,정읍시,362,56259,3734,60355,"2022-12-01",2022
"22-Dec",전북,진안군,270,14420,243,14933,"2022-12-01",2022
"22-Dec",전북,계,5607,934825,37402,977834,"2022-12-01",2022
"22-Dec",전남,강진군,257,19022,1065,20344,"2022-12-01",2022
"22-Dec",전남,고흥군,313,33254,586,34153,"2022-12-01",2022
"22-Dec",전남,곡성군,165,15363,671,16199,"2022-12-01",2022
"22-Dec",전남,광양시,266,88833,6268,95367,"2022-12-01",2022
"22-Dec",전남,구례군,149,13363,774,14286,"2022-12-01",2022
"22-Dec",전남,나주시,479,67786,3196,71461,"2022-12-01",2022
"22-Dec",전남,담양군,229,28212,1767,30208,"2022-12-01",2022
"22-Dec",전남,목포시,417,96731,5557,102705,"2022-12-01",2022
"22-Dec",전남,무안군,574,50868,1132,52574,"2022-12-01",2022
"22-Dec",전남,보성군,233,22076,1549,23858,"2022-12-01",2022
"22-Dec",전남,순천시,529,144735,5345,150609,"2022-12-01",2022
"22-Dec",전남,신안군,344,22555,101271,124170,"2022-12-01",2022
"22-Dec",전남,여수시,563,135278,7332,143173,"2022-12-01",2022
"22-Dec",전남,영광군,213,29123,780,30116,"2022-12-01",2022
"22-Dec",전남,영암군,282,35054,1331,36667,"2022-12-01",2022
"22-Dec",전남,완도군,292,25973,540,26805,"2022-12-01",2022
"22-Dec",전남,장성군,213,27583,1254,29050,"2022-12-01",2022
"22-Dec",전남,장흥군,266,20438,453,21157,"2022-12-01",2022
"22-Dec",전남,진도군,206,17433,301,17940,"2022-12-01",2022
"22-Dec",전남,함평군,211,18633,24866,43710,"2022-12-01",2022
"22-Dec",전남,해남군,327,40557,75127,116011,"2022-12-01",2022
"22-Dec",전남,화순군,250,33980,2065,36295,"2022-12-01",2022
"22-Dec",전남,계,6778,986850,243230,1236858,"2022-12-01",2022
"22-Dec",경북,경산시,333,141901,4314,146548,"2022-12-01",2022
"22-Dec",경북,경주시,607,145390,4535,150532,"2022-12-01",2022
"22-Dec",경북,고령군,181,20896,732,21809,"2022-12-01",2022
"22-Dec",경북,구미시,563,217091,7145,224799,"2022-12-01",2022
"22-Dec",경북,군위군,123,15611,306,16040,"2022-12-01",2022
"22-Dec",경북,김천시,396,77268,2032,79696,"2022-12-01",2022
"22-Dec",경북,문경시,287,38242,889,39418,"2022-12-01",2022
"22-Dec",경북,봉화군,239,18389,200,18828,"2022-12-01",2022
"22-Dec",경북,상주시,391,54542,1864,56797,"2022-12-01",2022
"22-Dec",경북,성주군,206,31598,1335,33139,"2022-12-01",2022
"22-Dec",경북,안동시,755,84156,2695,87606,"2022-12-01",2022
"22-Dec",경북,영덕군,248,19299,303,19850,"2022-12-01",2022
"22-Dec",경북,영양군,147,10015,109,10271,"2022-12-01",2022
"22-Dec",경북,영주시,357,56868,1510,58735,"2022-12-01",2022
"22-Dec",경북,영천시,353,61985,2509,64847,"2022-12-01",2022
"22-Dec",경북,예천군,288,31459,490,32237,"2022-12-01",2022
"22-Dec",경북,울릉군,163,5620,586,6369,"2022-12-01",2022
"22-Dec",경북,울진군,322,26891,338,27551,"2022-12-01",2022
"22-Dec",경북,의성군,329,31849,1082,33260,"2022-12-01",2022
"22-Dec",경북,청도군,219,25817,954,26990,"2022-12-01",2022
"22-Dec",경북,청송군,234,16066,215,16515,"2022-12-01",2022
"22-Dec",경북,칠곡군,293,70613,2474,73380,"2022-12-01",2022
"22-Dec",경북,포항시 남구,423,122964,8358,131745,"2022-12-01",2022
"22-Dec",경북,포항시 북구,364,143012,3576,146952,"2022-12-01",2022
"22-Dec",경북,계,7821,1467542,48551,1523914,"2022-12-01",2022
"22-Dec",경남,거제시,364,107879,2079,110322,"2022-12-01",2022
"22-Dec",경남,거창군,275,33545,763,34583,"2022-12-01",2022
"22-Dec",경남,고성군,236,27631,563,28430,"2022-12-01",2022
"22-Dec",경남,김해시,670,282976,7718,291364,"2022-12-01",2022
"22-Dec",경남,남해군,294,20628,447,21369,"2022-12-01",2022
"22-Dec",경남,밀양시,316,57547,3933,61796,"2022-12-01",2022
"22-Dec",경남,사천시,326,58123,1562,60011,"2022-12-01",2022
"22-Dec",경남,산청군,242,20888,742,21872,"2022-12-01",2022
"22-Dec",경남,양산시,434,172424,10633,183491,"2022-12-01",2022
"22-Dec",경남,의령군,211,15134,760,16105,"2022-12-01",2022
"22-Dec",경남,진주시,654,170855,6657,178166,"2022-12-01",2022
"22-Dec",경남,창녕군,233,36158,757,37148,"2022-12-01",2022
"22-Dec",경남,창원시 마산합포구,370,97181,2899,100450,"2022-12-01",2022
"22-Dec",경남,창원시 마산회원구,166,101833,5777,107776,"2022-12-01",2022
"22-Dec",경남,창원시 성산구,646,160512,60485,221643,"2022-12-01",2022
"22-Dec",경남,창원시 의창구,485,118588,3473,122546,"2022-12-01",2022
"22-Dec",경남,창원시 진해구,221,95956,2022,98199,"2022-12-01",2022
"22-Dec",경남,통영시,312,53024,1362,54698,"2022-12-01",2022
"22-Dec",경남,하동군,231,24261,379,24871,"2022-12-01",2022
"22-Dec",경남,함안군,209,44136,31643,75988,"2022-12-01",2022
"22-Dec",경남,함양군,237,20101,419,20757,"2022-12-01",2022
"22-Dec",경남,합천군,285,24017,628,24930,"2022-12-01",2022
"22-Dec",경남,계,7417,1743397,145701,1896515,"2022-12-01",2022
"22-Dec",제주,서귀포시,759,107302,1875,109936,"2022-12-01",2022
"22-Dec",제주,제주시,1645,305700,272643,579988,"2022-12-01",2022
"22-Dec",제주,계,2404,413002,274518,689924,"2022-12-01",2022
"23-Jan",서울,강남구,401,225798,22238,248437,"2023-01-01",2023
"23-Jan",서울,강동구,310,144516,8620,153446,"2023-01-01",2023
"23-Jan",서울,강북구,315,70727,4166,75208,"2023-01-01",2023
"23-Jan",서울,강서구,357,189415,17039,206811,"2023-01-01",2023
"23-Jan",서울,관악구,296,112736,5710,118742,"2023-01-01",2023
"23-Jan",서울,광진구,311,91956,5746,98013,"2023-01-01",2023
"23-Jan",서울,구로구,303,133862,14660,148825,"2023-01-01",2023
"23-Jan",서울,금천구,166,85368,6414,91948,"2023-01-01",2023
"23-Jan",서울,노원구,324,143611,8726,152661,"2023-01-01",2023
"23-Jan",서울,도봉구,282,87976,7428,95686,"2023-01-01",2023
"23-Jan",서울,동대문구,315,94547,4805,99667,"2023-01-01",2023
"23-Jan",서울,동작구,301,103080,2740,106121,"2023-01-01",2023
"23-Jan",서울,마포구,330,113993,7845,122168,"2023-01-01",2023
"23-Jan",서울,서대문구,457,85306,5636,91399,"2023-01-01",2023
"23-Jan",서울,서초구,516,165739,10655,176910,"2023-01-01",2023
"23-Jan",서울,성동구,368,93793,10071,104232,"2023-01-01",2023
"23-Jan",서울,성북구,299,117361,5096,122756,"2023-01-01",2023
"23-Jan",서울,송파구,398,235260,14548,250206,"2023-01-01",2023
"23-Jan",서울,양천구,324,142928,8648,151900,"2023-01-01",2023
"23-Jan",서울,영등포구,383,136083,8270,144736,"2023-01-01",2023
"23-Jan",서울,용산구,518,72835,2209,75562,"2023-01-01",2023
"23-Jan",서울,은평구,292,126498,6966,133756,"2023-01-01",2023
"23-Jan",서울,종로구,3842,44405,2719,50966,"2023-01-01",2023
"23-Jan",서울,중구,1262,52249,4365,57876,"2023-01-01",2023
"23-Jan",서울,중랑구,252,106448,9619,116319,"2023-01-01",2023
"23-Jan",서울,계,12922,2976490,204939,3194351,"2023-01-01",2023
"23-Jan",부산,강서구,324,84156,4709,89189,"2023-01-01",2023
"23-Jan",부산,금정구,274,79024,7217,86515,"2023-01-01",2023
"23-Jan",부산,기장군,262,83657,2683,86602,"2023-01-01",2023
"23-Jan",부산,남구,223,91034,9517,100774,"2023-01-01",2023
"23-Jan",부산,동구,195,41421,5690,47306,"2023-01-01",2023
"23-Jan",부산,동래구,176,97206,3580,100962,"2023-01-01",2023
"23-Jan",부산,부산진구,370,126136,21806,148312,"2023-01-01",2023
"23-Jan",부산,북구,237,102604,3699,106540,"2023-01-01",2023
"23-Jan",부산,사상구,286,83376,5536,89198,"2023-01-01",2023
"23-Jan",부산,사하구,266,108368,6066,114700,"2023-01-01",2023
"23-Jan",부산,서구,139,30286,1508,31933,"2023-01-01",2023
"23-Jan",부산,수영구,168,65359,54139,119666,"2023-01-01",2023
"23-Jan",부산,연제구,981,109235,13786,124002,"2023-01-01",2023
"23-Jan",부산,영도구,229,31595,2055,33879,"2023-01-01",2023
"23-Jan",부산,중구,310,31705,7076,39091,"2023-01-01",2023
"23-Jan",부산,해운대구,328,165938,16795,183061,"2023-01-01",2023
"23-Jan",부산,계,4768,1331100,165862,1501730,"2023-01-01",2023
"23-Jan",대구,남구,370,56128,1588,58086,"2023-01-01",2023
"23-Jan",대구,달서구,497,276714,15978,293189,"2023-01-01",2023
"23-Jan",대구,달성군,573,139637,5257,145467,"2023-01-01",2023
"23-Jan",대구,동구,375,158704,10716,169795,"2023-01-01",2023
"23-Jan",대구,북구,493,204475,7964,212932,"2023-01-01",2023
"23-Jan",대구,서구,285,67935,4443,72663,"2023-01-01",2023
"23-Jan",대구,수성구,589,212621,5153,218363,"2023-01-01",2023
"23-Jan",대구,중구,293,58827,2377,61497,"2023-01-01",2023
"23-Jan",대구,계,3475,1175041,53476,1231992,"2023-01-01",2023
"23-Jan",인천,강화군,345,37862,7507,45714,"2023-01-01",2023
"23-Jan",인천,계양구,310,122634,151904,274848,"2023-01-01",2023
"23-Jan",인천,남동구,900,252679,35608,289187,"2023-01-01",2023
"23-Jan",인천,동구,102,24044,2642,26788,"2023-01-01",2023
"23-Jan",인천,미추홀구,452,162512,9043,172007,"2023-01-01",2023
"23-Jan",인천,부평구,355,230962,41292,272609,"2023-01-01",2023
"23-Jan",인천,서구,475,285699,12408,298582,"2023-01-01",2023
"23-Jan",인천,연수구,433,206972,9300,216705,"2023-01-01",2023
"23-Jan",인천,옹진군,225,12912,263,13400,"2023-01-01",2023
"23-Jan",인천,중구,634,73537,12160,86331,"2023-01-01",2023
"23-Jan",인천,계,4231,1409813,282127,1696171,"2023-01-01",2023
"23-Jan",광주,광산구,548,201852,13327,215727,"2023-01-01",2023
"23-Jan",광주,남구,229,92920,2668,95817,"2023-01-01",2023
"23-Jan",광주,동구,236,45754,1061,47051,"2023-01-01",2023
"23-Jan",광주,북구,608,194724,9340,204672,"2023-01-01",2023
"23-Jan",광주,서구,735,144920,6377,152032,"2023-01-01",2023
"23-Jan",광주,계,2356,680170,32773,715299,"2023-01-01",2023
"23-Jan",대전,대덕구,239,88159,7746,96144,"2023-01-01",2023
"23-Jan",대전,동구,251,92414,4909,97574,"2023-01-01",2023
"23-Jan",대전,서구,818,210701,9385,220904,"2023-01-01",2023
"23-Jan",대전,유성구,662,186126,5634,192422,"2023-01-01",2023
"23-Jan",대전,중구,228,96690,5486,102404,"2023-01-01",2023
"23-Jan",대전,계,2198,674090,33160,709448,"2023-01-01",2023
"23-Jan",울산,남구,734,155680,7003,163417,"2023-01-01",2023
"23-Jan",울산,동구,186,62255,1222,63663,"2023-01-01",2023
"23-Jan",울산,북구,227,120092,3594,123913,"2023-01-01",2023
"23-Jan",울산,울주군,428,128355,7051,135834,"2023-01-01",2023
"23-Jan",울산,중구,330,100042,2573,102945,"2023-01-01",2023
"23-Jan",울산,계,1905,566424,21443,589772,"2023-01-01",2023
"23-Jan",세종,세종특별자치시,878,190033,3623,194534,"2023-01-01",2023
"23-Jan",세종,계,878,190033,3623,194534,"2023-01-01",2023
"23-Jan",경기,가평군,396,32428,557,33381,"2023-01-01",2023
"23-Jan",경기,고양시 덕양구,669,192090,4355,197114,"2023-01-01",2023
"23-Jan",경기,고양시 일산동구,281,128705,6666,135652,"2023-01-01",2023
"23-Jan",경기,고양시 일산서구,134,116881,4369,121384,"2023-01-01",2023
"23-Jan",경기,과천시,723,29704,706,31133,"2023-01-01",2023
"23-Jan",경기,광명시,308,101837,4439,106584,"2023-01-01",2023
"23-Jan",경기,광주시,410,202391,8624,211425,"2023-01-01",2023
"23-Jan",경기,구리시,275,70915,2921,74111,"2023-01-01",2023
"23-Jan",경기,군포시,303,99874,5377,105554,"2023-01-01",2023
"23-Jan",경기,김포시,554,233722,8673,242949,"2023-01-01",2023
"23-Jan",경기,남양주시,807,317116,9501,327424,"2023-01-01",2023
"23-Jan",경기,동두천시,216,39164,1525,40905,"2023-01-01",2023
"23-Jan",경기,부천시,726,296232,13108,310066,"2023-01-01",2023
"23-Jan",경기,성남시 분당구,370,190540,7894,198804,"2023-01-01",2023
"23-Jan",경기,성남시 수정구,315,77063,2696,80074,"2023-01-01",2023
"23-Jan",경기,성남시 중원구,392,74315,4009,78716,"2023-01-01",2023
"23-Jan",경기,수원시 권선구,491,200357,9699,210547,"2023-01-01",2023
"23-Jan",경기,수원시 영통구,414,148690,3441,152545,"2023-01-01",2023
"23-Jan",경기,수원시 장안구,494,104453,3714,108661,"2023-01-01",2023
"23-Jan",경기,수원시 팔달구,355,79625,3294,83274,"2023-01-01",2023
"23-Jan",경기,시흥시,468,261322,8644,270434,"2023-01-01",2023
"23-Jan",경기,안산시 단원구,590,161590,7718,169898,"2023-01-01",2023
"23-Jan",경기,안산시 상록구,151,146141,6027,152319,"2023-01-01",2023
"23-Jan",경기,안성시,404,110855,4908,116167,"2023-01-01",2023
"23-Jan",경기,안양시 동안구,404,122814,6862,130080,"2023-01-01",2023
"23-Jan",경기,안양시 만안구,158,85636,3978,89772,"2023-01-01",2023
"23-Jan",경기,양주시,418,119539,3620,123577,"2023-01-01",2023
"23-Jan",경기,양평군,618,64209,1975,66802,"2023-01-01",2023
"23-Jan",경기,여주시,468,67041,7385,74894,"2023-01-01",2023
"23-Jan",경기,연천군,321,24488,5197,30006,"2023-01-01",2023
"23-Jan",경기,오산시,219,111308,4027,115554,"2023-01-01",2023
"23-Jan",경기,용인시 기흥구,121,194284,7121,201526,"2023-01-01",2023
"23-Jan",경기,용인시 수지구,62,149825,2313,152200,"2023-01-01",2023
"23-Jan",경기,용인시 처인구,809,138455,8200,147464,"2023-01-01",2023
"23-Jan",경기,의왕시,305,66381,2898,69584,"2023-01-01",2023
"23-Jan",경기,의정부시,744,171662,5729,178135,"2023-01-01",2023
"23-Jan",경기,이천시,424,121020,6347,127791,"2023-01-01",2023
"23-Jan",경기,파주시,541,237021,11274,248836,"2023-01-01",2023
"23-Jan",경기,평택시,779,316810,13598,331187,"2023-01-01",2023
"23-Jan",경기,포천시,389,89539,9231,99159,"2023-01-01",2023
"23-Jan",경기,하남시,436,137865,3638,141939,"2023-01-01",2023
"23-Jan",경기,화성시,954,491374,13644,505972,"2023-01-01",2023
"23-Jan",경기,계,18416,6125281,249902,6393599,"2023-01-01",2023
"23-Jan",강원,강릉시,559,112787,4791,118137,"2023-01-01",2023
"23-Jan",강원,고성군,197,15785,233,16215,"2023-01-01",2023
"23-Jan",강원,동해시,325,47242,1491,49058,"2023-01-01",2023
"23-Jan",강원,삼척시,405,33335,812,34552,"2023-01-01",2023
"23-Jan",강원,속초시,308,40316,1404,42028,"2023-01-01",2023
"23-Jan",강원,양구군,216,12362,150,12728,"2023-01-01",2023
"23-Jan",강원,양양군,202,16689,319,17210,"2023-01-01",2023
"23-Jan",강원,영월군,339,21753,398,22490,"2023-01-01",2023
"23-Jan",강원,원주시,638,186426,5779,192843,"2023-01-01",2023
"23-Jan",강원,인제군,226,19668,304,20198,"2023-01-01",2023
"23-Jan",강원,정선군,358,21039,472,21869,"2023-01-01",2023
"23-Jan",강원,철원군,257,24527,335,25119,"2023-01-01",2023
"23-Jan",강원,춘천시,847,141013,6418,148278,"2023-01-01",2023
"23-Jan",강원,태백시,237,19986,726,20949,"2023-01-01",2023
"23-Jan",강원,평창군,320,26602,618,27540,"2023-01-01",2023
"23-Jan",강원,홍천군,435,40354,1022,41811,"2023-01-01",2023
"23-Jan",강원,화천군,235,13196,177,13608,"2023-01-01",2023
"23-Jan",강원,횡성군,285,28068,914,29267,"2023-01-01",2023
"23-Jan",강원,계,6389,821148,26363,853900,"2023-01-01",2023
"23-Jan",충북,괴산군,220,23853,417,24490,"2023-01-01",2023
"23-Jan",충북,단양군,238,16036,820,17094,"2023-01-01",2023
"23-Jan",충북,보은군,234,18770,968,19972,"2023-01-01",2023
"23-Jan",충북,영동군,256,25880,426,26562,"2023-01-01",2023
"23-Jan",충북,옥천군,218,28359,1172,29749,"2023-01-01",2023
"23-Jan",충북,음성군,268,61493,2013,63774,"2023-01-01",2023
"23-Jan",충북,제천시,335,69271,3467,73073,"2023-01-01",2023
"23-Jan",충북,증평군,91,20436,783,21310,"2023-01-01",2023
"23-Jan",충북,진천군,227,53386,1431,55044,"2023-01-01",2023
"23-Jan",충북,청원군,1,19,0,20,"2023-01-01",2023
"23-Jan",충북,청주시 상당구,512,98764,2709,101985,"2023-01-01",2023
"23-Jan",충북,청주시 서원구,241,101337,4674,106252,"2023-01-01",2023
"23-Jan",충북,청주시 청원구,396,107389,4788,112573,"2023-01-01",2023
"23-Jan",충북,청주시 흥덕구,366,136243,7526,144135,"2023-01-01",2023
"23-Jan",충북,충주시,620,114779,8218,123617,"2023-01-01",2023
"23-Jan",충북,계,4223,876015,39412,919650,"2023-01-01",2023
"23-Jan",충남,계룡시,168,24187,574,24929,"2023-01-01",2023
"23-Jan",충남,공주시,593,55637,2686,58916,"2023-01-01",2023
"23-Jan",충남,금산군,210,29448,2205,31863,"2023-01-01",2023
"23-Jan",충남,논산시,413,62387,2422,65222,"2023-01-01",2023
"23-Jan",충남,당진시,411,101551,4027,105989,"2023-01-01",2023
"23-Jan",충남,보령시,419,53764,1407,55590,"2023-01-01",2023
"23-Jan",충남,부여군,309,35036,1133,36478,"2023-01-01",2023
"23-Jan",충남,서산시,442,99955,3673,104070,"2023-01-01",2023
"23-Jan",충남,서천군,237,27571,804,28612,"2023-01-01",2023
"23-Jan",충남,아산시,551,185864,6904,193319,"2023-01-01",2023
"23-Jan",충남,예산군,424,45446,1413,47283,"2023-01-01",2023
"23-Jan",충남,천안시 동남구,303,136749,5680,142732,"2023-01-01",2023
"23-Jan",충남,천안시 서북구,551,203815,5334,209700,"2023-01-01",2023
"23-Jan",충남,청양군,262,17449,781,18492,"2023-01-01",2023
"23-Jan",충남,태안군,319,35539,553,36411,"2023-01-01",2023
"23-Jan",충남,홍성군,405,54277,1466,56148,"2023-01-01",2023
"23-Jan",충남,계,6017,1168675,41062,1215754,"2023-01-01",2023
"23-Jan",전북,고창군,329,31259,573,32161,"2023-01-01",2023
"23-Jan",전북,군산시,552,135481,6456,142489,"2023-01-01",2023
"23-Jan",전북,김제시,331,47541,2111,49983,"2023-01-01",2023
"23-Jan",전북,남원시,428,42210,2236,44874,"2023-01-01",2023
"23-Jan",전북,무주군,200,13395,410,14005,"2023-01-01",2023
"23-Jan",전북,부안군,276,28144,620,29040,"2023-01-01",2023
"23-Jan",전북,순창군,232,15181,163,15576,"2023-01-01",2023
"23-Jan",전북,완주군,433,54825,3160,58418,"2023-01-01",2023
"23-Jan",전북,익산시,548,139602,5830,145980,"2023-01-01",2023
"23-Jan",전북,임실군,221,14742,425,15388,"2023-01-01",2023
"23-Jan",전북,장수군,264,12566,149,12979,"2023-01-01",2023
"23-Jan",전북,전주시 덕진구,391,176708,7012,184111,"2023-01-01",2023
"23-Jan",전북,전주시 완산구,778,154902,4190,159870,"2023-01-01",2023
"23-Jan",전북,정읍시,389,56395,3670,60454,"2023-01-01",2023
"23-Jan",전북,진안군,269,14473,245,14987,"2023-01-01",2023
"23-Jan",전북,계,5641,937424,37250,980315,"2023-01-01",2023
"23-Jan",전남,강진군,257,19151,1042,20450,"2023-01-01",2023
"23-Jan",전남,고흥군,310,33399,588,34297,"2023-01-01",2023
"23-Jan",전남,곡성군,167,15448,667,16282,"2023-01-01",2023
"23-Jan",전남,광양시,267,89178,6278,95723,"2023-01-01",2023
"23-Jan",전남,구례군,149,13399,779,14327,"2023-01-01",2023
"23-Jan",전남,나주시,475,68049,3224,71748,"2023-01-01",2023
"23-Jan",전남,담양군,232,28345,1768,30345,"2023-01-01",2023
"23-Jan",전남,목포시,420,97088,5555,103063,"2023-01-01",2023
"23-Jan",전남,무안군,574,51149,1138,52861,"2023-01-01",2023
"23-Jan",전남,보성군,232,22231,597,23060,"2023-01-01",2023
"23-Jan",전남,순천시,535,145064,5337,150936,"2023-01-01",2023
"23-Jan",전남,신안군,343,22634,102089,125066,"2023-01-01",2023
"23-Jan",전남,여수시,561,135734,7315,143610,"2023-01-01",2023
"23-Jan",전남,영광군,209,29218,783,30210,"2023-01-01",2023
"23-Jan",전남,영암군,278,35238,1326,36842,"2023-01-01",2023
"23-Jan",전남,완도군,293,26052,543,26888,"2023-01-01",2023
"23-Jan",전남,장성군,213,27650,1252,29115,"2023-01-01",2023
"23-Jan",전남,장흥군,266,20537,453,21256,"2023-01-01",2023
"23-Jan",전남,진도군,207,17545,299,18051,"2023-01-01",2023
"23-Jan",전남,함평군,211,18776,24679,43666,"2023-01-01",2023
"23-Jan",전남,해남군,327,40757,73401,114485,"2023-01-01",2023
"23-Jan",전남,화순군,249,34116,2065,36430,"2023-01-01",2023
"23-Jan",전남,계,6775,990758,241178,1238711,"2023-01-01",2023
"23-Jan",경북,경산시,348,142134,4325,146807,"2023-01-01",2023
"23-Jan",경북,경주시,604,145798,4515,150917,"2023-01-01",2023
"23-Jan",경북,고령군,181,20951,732,21864,"2023-01-01",2023
"23-Jan",경북,구미시,564,217807,7131,225502,"2023-01-01",2023
"23-Jan",경북,군위군,123,15665,306,16094,"2023-01-01",2023
"23-Jan",경북,김천시,396,77512,2035,79943,"2023-01-01",2023
"23-Jan",경북,문경시,288,38293,892,39473,"2023-01-01",2023
"23-Jan",경북,봉화군,255,18401,199,18855,"2023-01-01",2023
"23-Jan",경북,상주시,392,54817,1865,57074,"2023-01-01",2023
"23-Jan",경북,성주군,207,31741,1348,33296,"2023-01-01",2023
"23-Jan",경북,안동시,746,84377,2711,87834,"2023-01-01",2023
"23-Jan",경북,영덕군,250,19359,307,19916,"2023-01-01",2023
"23-Jan",경북,영양군,148,10024,110,10282,"2023-01-01",2023
"23-Jan",경북,영주시,363,57024,1504,58891,"2023-01-01",2023
"23-Jan",경북,영천시,353,62232,2512,65097,"2023-01-01",2023
"23-Jan",경북,예천군,286,31530,490,32306,"2023-01-01",2023
"23-Jan",경북,울릉군,157,5618,588,6363,"2023-01-01",2023
"23-Jan",경북,울진군,328,27009,337,27674,"2023-01-01",2023
"23-Jan",경북,의성군,330,31934,1087,33351,"2023-01-01",2023
"23-Jan",경북,청도군,219,25874,953,27046,"2023-01-01",2023
"23-Jan",경북,청송군,232,16117,213,16562,"2023-01-01",2023
"23-Jan",경북,칠곡군,293,70728,2462,73483,"2023-01-01",2023
"23-Jan",경북,포항시 남구,428,123508,8357,132293,"2023-01-01",2023
"23-Jan",경북,포항시 북구,364,143462,3582,147408,"2023-01-01",2023
"23-Jan",경북,계,7855,1471915,48561,1528331,"2023-01-01",2023
"23-Jan",경남,거제시,364,108063,2081,110508,"2023-01-01",2023
"23-Jan",경남,거창군,274,33679,772,34725,"2023-01-01",2023
"23-Jan",경남,고성군,236,27734,562,28532,"2023-01-01",2023
"23-Jan",경남,김해시,669,283815,7688,292172,"2023-01-01",2023
"23-Jan",경남,남해군,294,20682,447,21423,"2023-01-01",2023
"23-Jan",경남,밀양시,319,57712,3943,61974,"2023-01-01",2023
"23-Jan",경남,사천시,327,58347,1522,60196,"2023-01-01",2023
"23-Jan",경남,산청군,242,21023,743,22008,"2023-01-01",2023
"23-Jan",경남,양산시,435,172652,10661,183748,"2023-01-01",2023
"23-Jan",경남,의령군,214,15204,763,16181,"2023-01-01",2023
"23-Jan",경남,진주시,657,171229,6704,178590,"2023-01-01",2023
"23-Jan",경남,창녕군,235,36234,758,37227,"2023-01-01",2023
"23-Jan",경남,창원시 마산합포구,358,97395,2895,100648,"2023-01-01",2023
"23-Jan",경남,창원시 마산회원구,163,102073,5788,108024,"2023-01-01",2023
"23-Jan",경남,창원시 성산구,633,161256,59998,221887,"2023-01-01",2023
"23-Jan",경남,창원시 의창구,490,118775,3469,122734,"2023-01-01",2023
"23-Jan",경남,창원시 진해구,227,96215,2029,98471,"2023-01-01",2023
"23-Jan",경남,통영시,312,53104,1362,54778,"2023-01-01",2023
"23-Jan",경남,하동군,230,24352,378,24960,"2023-01-01",2023
"23-Jan",경남,함안군,209,44130,31917,76256,"2023-01-01",2023
"23-Jan",경남,함양군,236,20161,422,20819,"2023-01-01",2023
"23-Jan",경남,합천군,286,24096,628,25010,"2023-01-01",2023
"23-Jan",경남,계,7410,1747931,145530,1900871,"2023-01-01",2023
"23-Jan",제주,서귀포시,756,107462,1871,110089,"2023-01-01",2023
"23-Jan",제주,제주시,1643,306417,273489,581549,"2023-01-01",2023
"23-Jan",제주,계,2399,413879,275360,691638,"2023-01-01",2023
"23-Feb",서울,강남구,402,226074,22457,248933,"2023-02-01",2023
"23-Feb",서울,강동구,306,144666,8637,153609,"2023-02-01",2023
"23-Feb",서울,강북구,314,70657,4163,75134,"2023-02-01",2023
"23-Feb",서울,강서구,354,188778,16950,206082,"2023-02-01",2023
"23-Feb",서울,관악구,295,112734,5718,118747,"2023-02-01",2023
"23-Feb",서울,광진구,310,91900,5740,97950,"2023-02-01",2023
"23-Feb",서울,구로구,298,133943,14150,148391,"2023-02-01",2023
"23-Feb",서울,금천구,164,85505,6430,92099,"2023-02-01",2023
"23-Feb",서울,노원구,323,143522,8718,152563,"2023-02-01",2023
"23-Feb",서울,도봉구,280,87946,7413,95639,"2023-02-01",2023
"23-Feb",서울,동대문구,312,94617,4830,99759,"2023-02-01",2023
"23-Feb",서울,동작구,300,102878,2738,105916,"2023-02-01",2023
"23-Feb",서울,마포구,330,114069,7784,122183,"2023-02-01",2023
"23-Feb",서울,서대문구,454,85621,5630,91705,"2023-02-01",2023
"23-Feb",서울,서초구,495,165167,10506,176168,"2023-02-01",2023
"23-Feb",서울,성동구,365,93358,9984,103707,"2023-02-01",2023
"23-Feb",서울,성북구,298,117409,5097,122804,"2023-02-01",2023
"23-Feb",서울,송파구,397,234467,14508,249372,"2023-02-01",2023
"23-Feb",서울,양천구,323,142945,8637,151905,"2023-02-01",2023
"23-Feb",서울,영등포구,377,136045,8272,144694,"2023-02-01",2023
"23-Feb",서울,용산구,516,72844,2193,75553,"2023-02-01",2023
"23-Feb",서울,은평구,287,126303,6968,133558,"2023-02-01",2023
"23-Feb",서울,종로구,3848,44445,2678,50971,"2023-02-01",2023
"23-Feb",서울,중구,1266,52206,4350,57822,"2023-02-01",2023
"23-Feb",서울,중랑구,249,106529,9639,116417,"2023-02-01",2023
"23-Feb",서울,계,12863,2974628,204190,3191681,"2023-02-01",2023
"23-Feb",부산,강서구,324,84248,4703,89275,"2023-02-01",2023
"23-Feb",부산,금정구,274,78931,7233,86438,"2023-02-01",2023
"23-Feb",부산,기장군,262,84055,2681,86998,"2023-02-01",2023
"23-Feb",부산,남구,223,90990,9456,100669,"2023-02-01",2023
"23-Feb",부산,동구,195,41721,5684,47600,"2023-02-01",2023
"23-Feb",부산,동래구,177,97389,3595,101161,"2023-02-01",2023
"23-Feb",부산,부산진구,368,127106,21968,149442,"2023-02-01",2023
"23-Feb",부산,북구,238,102571,3699,106508,"2023-02-01",2023
"23-Feb",부산,사상구,284,83280,5501,89065,"2023-02-01",2023
"23-Feb",부산,사하구,266,108440,6062,114768,"2023-02-01",2023
"23-Feb",부산,서구,140,30294,1507,31941,"2023-02-01",2023
"23-Feb",부산,수영구,167,65408,55004,120579,"2023-02-01",2023
"23-Feb",부산,연제구,980,109140,14098,124218,"2023-02-01",2023
"23-Feb",부산,영도구,228,31572,2042,33842,"2023-02-01",2023
"23-Feb",부산,중구,312,31817,7080,39209,"2023-02-01",2023
"23-Feb",부산,해운대구,327,166008,16483,182818,"2023-02-01",2023
"23-Feb",부산,계,4765,1332970,166796,1504531,"2023-02-01",2023
"23-Feb",대구,남구,370,56398,1585,58353,"2023-02-01",2023
"23-Feb",대구,달서구,493,277332,16226,294051,"2023-02-01",2023
"23-Feb",대구,달성군,574,139789,5258,145621,"2023-02-01",2023
"23-Feb",대구,동구,369,158375,10671,169415,"2023-02-01",2023
"23-Feb",대구,북구,490,204479,7949,212918,"2023-02-01",2023
"23-Feb",대구,서구,286,67600,4494,72380,"2023-02-01",2023
"23-Feb",대구,수성구,588,213044,5128,218760,"2023-02-01",2023
"23-Feb",대구,중구,296,58874,2385,61555,"2023-02-01",2023
"23-Feb",대구,계,3466,1175891,53696,1233053,"2023-02-01",2023
"23-Feb",인천,강화군,343,38012,6843,45198,"2023-02-01",2023
"23-Feb",인천,계양구,308,122758,152236,275302,"2023-02-01",2023
"23-Feb",인천,남동구,903,253349,35329,289581,"2023-02-01",2023
"23-Feb",인천,동구,102,24143,2606,26851,"2023-02-01",2023
"23-Feb",인천,미추홀구,433,162278,9075,171786,"2023-02-01",2023
"23-Feb",인천,부평구,352,230463,41146,271961,"2023-02-01",2023
"23-Feb",인천,서구,490,287000,12524,300014,"2023-02-01",2023
"23-Feb",인천,연수구,438,208008,8997,217443,"2023-02-01",2023
"23-Feb",인천,옹진군,227,13014,263,13504,"2023-02-01",2023
"23-Feb",인천,중구,672,73783,12073,86528,"2023-02-01",2023
"23-Feb",인천,계,4268,1412808,281092,1698168,"2023-02-01",2023
"23-Feb",광주,광산구,545,202355,13343,216243,"2023-02-01",2023
"23-Feb",광주,남구,228,93048,2656,95932,"2023-02-01",2023
"23-Feb",광주,동구,236,46000,1061,47297,"2023-02-01",2023
"23-Feb",광주,북구,610,195094,9332,205036,"2023-02-01",2023
"23-Feb",광주,서구,736,144483,6381,151600,"2023-02-01",2023
"23-Feb",광주,계,2355,680980,32773,716108,"2023-02-01",2023
"23-Feb",대전,대덕구,239,88241,7817,96297,"2023-02-01",2023
"23-Feb",대전,동구,250,92649,4884,97783,"2023-02-01",2023
"23-Feb",대전,서구,813,210703,9437,220953,"2023-02-01",2023
"23-Feb",대전,유성구,661,186428,5861,192950,"2023-02-01",2023
"23-Feb",대전,중구,227,96723,5470,102420,"2023-02-01",2023
"23-Feb",대전,계,2190,674744,33469,710403,"2023-02-01",2023
"23-Feb",울산,남구,737,156178,7005,163920,"2023-02-01",2023
"23-Feb",울산,동구,186,62306,1219,63711,"2023-02-01",2023
"23-Feb",울산,북구,227,120529,3592,124348,"2023-02-01",2023
"23-Feb",울산,울주군,427,128839,7068,136334,"2023-02-01",2023
"23-Feb",울산,중구,325,100193,2564,103082,"2023-02-01",2023
"23-Feb",울산,계,1902,568045,21448,591395,"2023-02-01",2023
"23-Feb",세종,세종특별자치시,885,190753,3616,195254,"2023-02-01",2023
"23-Feb",세종,계,885,190753,3616,195254,"2023-02-01",2023
"23-Feb",경기,가평군,398,32498,556,33452,"2023-02-01",2023
"23-Feb",경기,고양시 덕양구,669,193148,4374,198191,"2023-02-01",2023
"23-Feb",경기,고양시 일산동구,279,128711,6544,135534,"2023-02-01",2023
"23-Feb",경기,고양시 일산서구,131,116937,4396,121464,"2023-02-01",2023
"23-Feb",경기,과천시,728,29792,706,31226,"2023-02-01",2023
"23-Feb",경기,광명시,308,101504,4427,106239,"2023-02-01",2023
"23-Feb",경기,광주시,409,202411,8727,211547,"2023-02-01",2023
"23-Feb",경기,구리시,276,70986,2901,74163,"2023-02-01",2023
"23-Feb",경기,군포시,302,99942,5384,105628,"2023-02-01",2023
"23-Feb",경기,김포시,554,233698,8693,242945,"2023-02-01",2023
"23-Feb",경기,남양주시,808,317234,9503,327545,"2023-02-01",2023
"23-Feb",경기,동두천시,218,39104,1525,40847,"2023-02-01",2023
"23-Feb",경기,부천시,718,295553,13073,309344,"2023-02-01",2023
"23-Feb",경기,성남시 분당구,367,190608,7747,198722,"2023-02-01",2023
"23-Feb",경기,성남시 수정구,315,77073,2682,80070,"2023-02-01",2023
"23-Feb",경기,성남시 중원구,388,74952,4029,79369,"2023-02-01",2023
"23-Feb",경기,수원시 권선구,475,197525,9708,207708,"2023-02-01",2023
"23-Feb",경기,수원시 영통구,406,149342,3575,153323,"2023-02-01",2023
"23-Feb",경기,수원시 장안구,488,104523,3703,108714,"2023-02-01",2023
"23-Feb",경기,수원시 팔달구,355,79994,3254,83603,"2023-02-01",2023
"23-Feb",경기,시흥시,464,262454,8653,271571,"2023-02-01",2023
"23-Feb",경기,안산시 단원구,580,161067,7738,169385,"2023-02-01",2023
"23-Feb",경기,안산시 상록구,145,146039,6015,152199,"2023-02-01",2023
"23-Feb",경기,안성시,404,110968,4706,116078,"2023-02-01",2023
"23-Feb",경기,안양시 동안구,404,122956,6971,130331,"2023-02-01",2023
"23-Feb",경기,안양시 만안구,158,85654,3973,89785,"2023-02-01",2023
"23-Feb",경기,양주시,416,121086,3782,125284,"2023-02-01",2023
"23-Feb",경기,양평군,617,64456,1974,67047,"2023-02-01",2023
"23-Feb",경기,여주시,469,67271,7396,75136,"2023-02-01",2023
"23-Feb",경기,연천군,317,24485,5208,30010,"2023-02-01",2023
"23-Feb",경기,오산시,217,111644,4030,115891,"2023-02-01",2023
"23-Feb",경기,용인시 기흥구,120,193988,7129,201237,"2023-02-01",2023
"23-Feb",경기,용인시 수지구,59,150108,2324,152491,"2023-02-01",2023
"23-Feb",경기,용인시 처인구,823,138580,8177,147580,"2023-02-01",2023
"23-Feb",경기,의왕시,304,66338,2919,69561,"2023-02-01",2023
"23-Feb",경기,의정부시,747,171741,5786,178274,"2023-02-01",2023
"23-Feb",경기,이천시,425,121597,6413,128435,"2023-02-01",2023
"23-Feb",경기,파주시,539,237953,11274,249766,"2023-02-01",2023
"23-Feb",경기,평택시,778,318256,13630,332664,"2023-02-01",2023
"23-Feb",경기,포천시,388,89592,9086,99066,"2023-02-01",2023
"23-Feb",경기,하남시,436,138157,3713,142306,"2023-02-01",2023
"23-Feb",경기,화성시,958,494396,13671,509025,"2023-02-01",2023
"23-Feb",경기,계,18360,6134321,250075,6402756,"2023-02-01",2023
"23-Feb",강원,강릉시,568,113038,4690,118296,"2023-02-01",2023
"23-Feb",강원,고성군,198,15833,237,16268,"2023-02-01",2023
"23-Feb",강원,동해시,325,47328,1491,49144,"2023-02-01",2023
"23-Feb",강원,삼척시,403,33459,811,34673,"2023-02-01",2023
"23-Feb",강원,속초시,308,40368,1402,42078,"2023-02-01",2023
"23-Feb",강원,양구군,216,12405,149,12770,"2023-02-01",2023
"23-Feb",강원,양양군,202,16782,322,17306,"2023-02-01",2023
"23-Feb",강원,영월군,337,21796,398,22531,"2023-02-01",2023
"23-Feb",강원,원주시,636,186987,5793,193416,"2023-02-01",2023
"23-Feb",강원,인제군,226,19699,298,20223,"2023-02-01",2023
"23-Feb",강원,정선군,359,21100,475,21934,"2023-02-01",2023
"23-Feb",강원,철원군,259,24646,335,25240,"2023-02-01",2023
"23-Feb",강원,춘천시,850,141286,6412,148548,"2023-02-01",2023
"23-Feb",강원,태백시,238,20046,723,21007,"2023-02-01",2023
"23-Feb",강원,평창군,320,26683,560,27563,"2023-02-01",2023
"23-Feb",강원,홍천군,437,40526,1024,41987,"2023-02-01",2023
"23-Feb",강원,화천군,236,13232,186,13654,"2023-02-01",2023
"23-Feb",강원,횡성군,281,28179,908,29368,"2023-02-01",2023
"23-Feb",강원,계,6399,823393,26214,856006,"2023-02-01",2023
"23-Feb",충북,괴산군,219,23980,432,24631,"2023-02-01",2023
"23-Feb",충북,단양군,238,16041,831,17110,"2023-02-01",2023
"23-Feb",충북,보은군,235,18814,963,20012,"2023-02-01",2023
"23-Feb",충북,영동군,257,25963,426,26646,"2023-02-01",2023
"23-Feb",충북,옥천군,217,28438,1173,29828,"2023-02-01",2023
"23-Feb",충북,음성군,266,61784,2014,64064,"2023-02-01",2023
"23-Feb",충북,제천시,335,69480,3463,73278,"2023-02-01",2023
"23-Feb",충북,증평군,92,20548,782,21422,"2023-02-01",2023
"23-Feb",충북,진천군,225,53512,1451,55188,"2023-02-01",2023
"23-Feb",충북,청원군,1,19,0,20,"2023-02-01",2023
"23-Feb",충북,청주시 상당구,509,99322,2677,102508,"2023-02-01",2023
"23-Feb",충북,청주시 서원구,245,101176,4695,106116,"2023-02-01",2023
"23-Feb",충북,청주시 청원구,391,107600,4785,112776,"2023-02-01",2023
"23-Feb",충북,청주시 흥덕구,367,136697,7593,144657,"2023-02-01",2023
"23-Feb",충북,충주시,625,115107,8518,124250,"2023-02-01",2023
"23-Feb",충북,계,4222,878481,39803,922506,"2023-02-01",2023
"23-Feb",충남,계룡시,168,24287,579,25034,"2023-02-01",2023
"23-Feb",충남,공주시,596,55774,2664,59034,"2023-02-01",2023
"23-Feb",충남,금산군,211,29624,2213,32048,"2023-02-01",2023
"23-Feb",충남,논산시,416,62476,2424,65316,"2023-02-01",2023
"23-Feb",충남,당진시,410,102102,4027,106539,"2023-02-01",2023
"23-Feb",충남,보령시,419,53865,1421,55705,"2023-02-01",2023
"23-Feb",충남,부여군,310,35149,1135,36594,"2023-02-01",2023
"23-Feb",충남,서산시,443,100306,3669,104418,"2023-02-01",2023
"23-Feb",충남,서천군,235,27662,806,28703,"2023-02-01",2023
"23-Feb",충남,아산시,552,186713,7386,194651,"2023-02-01",2023
"23-Feb",충남,예산군,430,45916,1421,47767,"2023-02-01",2023
"23-Feb",충남,천안시 동남구,303,137294,5571,143168,"2023-02-01",2023
"23-Feb",충남,천안시 서북구,553,203935,5426,209914,"2023-02-01",2023
"23-Feb",충남,청양군,262,17512,724,18498,"2023-02-01",2023
"23-Feb",충남,태안군,322,35580,556,36458,"2023-02-01",2023
"23-Feb",충남,홍성군,407,54257,1463,56127,"2023-02-01",2023
"23-Feb",충남,계,6037,1172452,41485,1219974,"2023-02-01",2023
"23-Feb",전북,고창군,331,31306,573,32210,"2023-02-01",2023
"23-Feb",전북,군산시,548,135743,6459,142750,"2023-02-01",2023
"23-Feb",전북,김제시,331,47845,1986,50162,"2023-02-01",2023
"23-Feb",전북,남원시,425,42361,2107,44893,"2023-02-01",2023
"23-Feb",전북,무주군,201,13434,409,14044,"2023-02-01",2023
"23-Feb",전북,부안군,275,28278,620,29173,"2023-02-01",2023
"23-Feb",전북,순창군,232,15300,164,15696,"2023-02-01",2023
"23-Feb",전북,완주군,430,55235,3167,58832,"2023-02-01",2023
"23-Feb",전북,익산시,546,139960,5828,146334,"2023-02-01",2023
"23-Feb",전북,임실군,219,14793,427,15439,"2023-02-01",2023
"23-Feb",전북,장수군,265,12582,148,12995,"2023-02-01",2023
"23-Feb",전북,전주시 덕진구,390,176469,7089,183948,"2023-02-01",2023
"23-Feb",전북,전주시 완산구,784,155199,4195,160178,"2023-02-01",2023
"23-Feb",전북,정읍시,388,56590,3610,60588,"2023-02-01",2023
"23-Feb",전북,진안군,276,14611,249,15136,"2023-02-01",2023
"23-Feb",전북,계,5641,939706,37031,982378,"2023-02-01",2023
"23-Feb",전남,강진군,258,19239,1045,20542,"2023-02-01",2023
"23-Feb",전남,고흥군,311,33529,589,34429,"2023-02-01",2023
"23-Feb",전남,곡성군,167,15487,664,16318,"2023-02-01",2023
"23-Feb",전남,광양시,268,89474,6253,95995,"2023-02-01",2023
"23-Feb",전남,구례군,149,13412,764,14325,"2023-02-01",2023
"23-Feb",전남,나주시,480,68338,3220,72038,"2023-02-01",2023
"23-Feb",전남,담양군,231,28437,1762,30430,"2023-02-01",2023
"23-Feb",전남,목포시,415,97369,5516,103300,"2023-02-01",2023
"23-Feb",전남,무안군,581,51250,1138,52969,"2023-02-01",2023
"23-Feb",전남,보성군,234,22254,655,23143,"2023-02-01",2023
"23-Feb",전남,순천시,536,145503,5342,151381,"2023-02-01",2023
"23-Feb",전남,신안군,344,22829,103133,126306,"2023-02-01",2023
"23-Feb",전남,여수시,560,136134,7360,144054,"2023-02-01",2023
"23-Feb",전남,영광군,210,29384,787,30381,"2023-02-01",2023
"23-Feb",전남,영암군,278,35456,1302,37036,"2023-02-01",2023
"23-Feb",전남,완도군,294,26171,539,27004,"2023-02-01",2023
"23-Feb",전남,장성군,213,27781,1297,29291,"2023-02-01",2023
"23-Feb",전남,장흥군,265,20550,452,21267,"2023-02-01",2023
"23-Feb",전남,진도군,208,17584,301,18093,"2023-02-01",2023
"23-Feb",전남,함평군,212,18888,23229,42329,"2023-02-01",2023
"23-Feb",전남,해남군,327,40889,72433,113649,"2023-02-01",2023
"23-Feb",전남,화순군,252,34235,2070,36557,"2023-02-01",2023
"23-Feb",전남,계,6793,994193,239851,1240837,"2023-02-01",2023
"23-Feb",경북,경산시,347,142527,4336,147210,"2023-02-01",2023
"23-Feb",경북,경주시,601,146074,4508,151183,"2023-02-01",2023
"23-Feb",경북,고령군,180,21034,735,21949,"2023-02-01",2023
"23-Feb",경북,구미시,559,218313,7153,226025,"2023-02-01",2023
"23-Feb",경북,군위군,124,15720,309,16153,"2023-02-01",2023
"23-Feb",경북,김천시,393,77725,2055,80173,"2023-02-01",2023
"23-Feb",경북,문경시,292,38392,898,39582,"2023-02-01",2023
"23-Feb",경북,봉화군,256,18480,200,18936,"2023-02-01",2023
"23-Feb",경북,상주시,392,54923,1869,57184,"2023-02-01",2023
"23-Feb",경북,성주군,206,31833,1340,33379,"2023-02-01",2023
"23-Feb",경북,안동시,746,84647,2702,88095,"2023-02-01",2023
"23-Feb",경북,영덕군,247,19430,308,19985,"2023-02-01",2023
"23-Feb",경북,영양군,147,10009,110,10266,"2023-02-01",2023
"23-Feb",경북,영주시,361,57166,1505,59032,"2023-02-01",2023
"23-Feb",경북,영천시,355,62339,2512,65206,"2023-02-01",2023
"23-Feb",경북,예천군,286,31628,489,32403,"2023-02-01",2023
"23-Feb",경북,울릉군,157,5709,590,6456,"2023-02-01",2023
"23-Feb",경북,울진군,325,27056,332,27713,"2023-02-01",2023
"23-Feb",경북,의성군,330,32107,1087,33524,"2023-02-01",2023
"23-Feb",경북,청도군,219,26036,959,27214,"2023-02-01",2023
"23-Feb",경북,청송군,230,16184,210,16624,"2023-02-01",2023
"23-Feb",경북,칠곡군,294,70884,2492,73670,"2023-02-01",2023
"23-Feb",경북,포항시 남구,426,123940,8361,132727,"2023-02-01",2023
"23-Feb",경북,포항시 북구,365,143907,3586,147858,"2023-02-01",2023
"23-Feb",경북,계,7838,1476063,48646,1532547,"2023-02-01",2023
"23-Feb",경남,거제시,365,108181,2095,110641,"2023-02-01",2023
"23-Feb",경남,거창군,272,33860,778,34910,"2023-02-01",2023
"23-Feb",경남,고성군,236,27781,561,28578,"2023-02-01",2023
"23-Feb",경남,김해시,668,284340,7683,292691,"2023-02-01",2023
"23-Feb",경남,남해군,292,20776,448,21516,"2023-02-01",2023
"23-Feb",경남,밀양시,318,57872,3953,62143,"2023-02-01",2023
"23-Feb",경남,사천시,322,58555,1521,60398,"2023-02-01",2023
"23-Feb",경남,산청군,243,21090,747,22080,"2023-02-01",2023
"23-Feb",경남,양산시,435,173176,10647,184258,"2023-02-01",2023
"23-Feb",경남,의령군,213,15267,769,16249,"2023-02-01",2023
"23-Feb",경남,진주시,653,171767,6690,179110,"2023-02-01",2023
"23-Feb",경남,창녕군,236,36365,762,37363,"2023-02-01",2023
"23-Feb",경남,창원시 마산합포구,355,98257,2892,101504,"2023-02-01",2023
"23-Feb",경남,창원시 마산회원구,164,102311,5811,108286,"2023-02-01",2023
"23-Feb",경남,창원시 성산구,625,161973,59696,222294,"2023-02-01",2023
"23-Feb",경남,창원시 의창구,494,118881,3456,122831,"2023-02-01",2023
"23-Feb",경남,창원시 진해구,227,96339,2033,98599,"2023-02-01",2023
"23-Feb",경남,통영시,315,53158,1357,54830,"2023-02-01",2023
"23-Feb",경남,하동군,230,24386,381,24997,"2023-02-01",2023
"23-Feb",경남,함안군,209,44095,31713,76017,"2023-02-01",2023
"23-Feb",경남,함양군,233,20206,426,20865,"2023-02-01",2023
"23-Feb",경남,합천군,289,24143,631,25063,"2023-02-01",2023
"23-Feb",경남,계,7394,1752779,145050,1905223,"2023-02-01",2023
"23-Feb",제주,서귀포시,764,107785,1867,110416,"2023-02-01",2023
"23-Feb",제주,제주시,1645,307613,274042,583300,"2023-02-01",2023
"23-Feb",제주,계,2409,415398,275909,693716,"2023-02-01",2023
"23-Mar",서울,강남구,404,227399,22642,250445,"2023-03-01",2023
"23-Mar",서울,강동구,311,144735,8632,153678,"2023-03-01",2023
"23-Mar",서울,강북구,312,70686,4168,75166,"2023-03-01",2023
"23-Mar",서울,강서구,355,188990,16759,206104,"2023-03-01",2023
"23-Mar",서울,관악구,295,112793,5798,118886,"2023-03-01",2023
"23-Mar",서울,광진구,313,91917,5706,97936,"2023-03-01",2023
"23-Mar",서울,구로구,300,134232,14187,148719,"2023-03-01",2023
"23-Mar",서울,금천구,167,85629,6427,92223,"2023-03-01",2023
"23-Mar",서울,노원구,324,143548,8761,152633,"2023-03-01",2023
"23-Mar",서울,도봉구,279,87951,7393,95623,"2023-03-01",2023
"23-Mar",서울,동대문구,306,94783,4858,99947,"2023-03-01",2023
"23-Mar",서울,동작구,300,103147,2703,106150,"2023-03-01",2023
"23-Mar",서울,마포구,332,114311,7772,122415,"2023-03-01",2023
"23-Mar",서울,서대문구,454,85757,5651,91862,"2023-03-01",2023
"23-Mar",서울,서초구,476,165221,10440,176137,"2023-03-01",2023
"23-Mar",서울,성동구,362,93219,11201,104782,"2023-03-01",2023
"23-Mar",서울,성북구,299,117403,5109,122811,"2023-03-01",2023
"23-Mar",서울,송파구,400,230805,14392,245597,"2023-03-01",2023
"23-Mar",서울,양천구,323,142700,8645,151668,"2023-03-01",2023
"23-Mar",서울,영등포구,362,136050,8250,144662,"2023-03-01",2023
"23-Mar",서울,용산구,512,72751,2173,75436,"2023-03-01",2023
"23-Mar",서울,은평구,288,126226,6955,133469,"2023-03-01",2023
"23-Mar",서울,종로구,3876,44451,2673,51000,"2023-03-01",2023
"23-Mar",서울,중구,1274,52111,4281,57666,"2023-03-01",2023
"23-Mar",서울,중랑구,250,106642,9631,116523,"2023-03-01",2023
"23-Mar",서울,계,12874,2973457,205207,3191538,"2023-03-01",2023
"23-Mar",부산,강서구,324,84373,4962,89659,"2023-03-01",2023
"23-Mar",부산,금정구,275,78841,7227,86343,"2023-03-01",2023
"23-Mar",부산,기장군,264,84397,2815,87476,"2023-03-01",2023
"23-Mar",부산,남구,224,91007,9408,100639,"2023-03-01",2023
"23-Mar",부산,동구,193,41697,5692,47582,"2023-03-01",2023
"23-Mar",부산,동래구,173,97542,3565,101280,"2023-03-01",2023
"23-Mar",부산,부산진구,367,127507,21823,149697,"2023-03-01",2023
"23-Mar",부산,북구,261,102699,3714,106674,"2023-03-01",2023
"23-Mar",부산,사상구,279,83189,5516,88984,"2023-03-01",2023
"23-Mar",부산,사하구,267,108624,6031,114922,"2023-03-01",2023
"23-Mar",부산,서구,139,30302,1504,31945,"2023-03-01",2023
"23-Mar",부산,수영구,166,65489,56337,121992,"2023-03-01",2023
"23-Mar",부산,연제구,981,109277,14107,124365,"2023-03-01",2023
"23-Mar",부산,영도구,228,31575,2035,33838,"2023-03-01",2023
"23-Mar",부산,중구,311,32033,7067,39411,"2023-03-01",2023
"23-Mar",부산,해운대구,327,165944,16285,182556,"2023-03-01",2023
"23-Mar",부산,계,4779,1334496,168088,1507363,"2023-03-01",2023
"23-Mar",대구,남구,371,56350,1595,58316,"2023-03-01",2023
"23-Mar",대구,달서구,499,277365,16548,294412,"2023-03-01",2023
"23-Mar",대구,달성군,574,140019,5272,145865,"2023-03-01",2023
"23-Mar",대구,동구,371,158596,10643,169610,"2023-03-01",2023
"23-Mar",대구,북구,489,204101,7934,212524,"2023-03-01",2023
"23-Mar",대구,서구,288,67476,4813,72577,"2023-03-01",2023
"23-Mar",대구,수성구,586,212936,4967,218489,"2023-03-01",2023
"23-Mar",대구,중구,298,59144,2386,61828,"2023-03-01",2023
"23-Mar",대구,계,3476,1175987,54158,1233621,"2023-03-01",2023
"23-Mar",인천,강화군,335,38038,6447,44820,"2023-03-01",2023
"23-Mar",인천,계양구,303,122668,150818,273789,"2023-03-01",2023
"23-Mar",인천,남동구,898,253564,35034,289496,"2023-03-01",2023
"23-Mar",인천,동구,102,24242,2982,27326,"2023-03-01",2023
"23-Mar",인천,미추홀구,434,162400,9193,172027,"2023-03-01",2023
"23-Mar",인천,부평구,352,230490,41204,272046,"2023-03-01",2023
"23-Mar",인천,서구,490,288827,12326,301643,"2023-03-01",2023
"23-Mar",인천,연수구,435,209110,9069,218614,"2023-03-01",2023
"23-Mar",인천,옹진군,232,13026,259,13517,"2023-03-01",2023
"23-Mar",인천,중구,670,73920,12053,86643,"2023-03-01",2023
"23-Mar",인천,계,4251,1416285,279385,1699921,"2023-03-01",2023
"23-Mar",광주,광산구,544,202762,13342,216648,"2023-03-01",2023
"23-Mar",광주,남구,227,93204,2646,96077,"2023-03-01",2023
"23-Mar",광주,동구,235,46103,1066,47404,"2023-03-01",2023
"23-Mar",광주,북구,651,195463,9303,205417,"2023-03-01",2023
"23-Mar",광주,서구,736,145142,6583,152461,"2023-03-01",2023
"23-Mar",광주,계,2393,682674,32940,718007,"2023-03-01",2023
"23-Mar",대전,대덕구,240,88207,7884,96331,"2023-03-01",2023
"23-Mar",대전,동구,248,92637,4945,97830,"2023-03-01",2023
"23-Mar",대전,서구,808,210647,9487,220942,"2023-03-01",2023
"23-Mar",대전,유성구,661,187048,5843,193552,"2023-03-01",2023
"23-Mar",대전,중구,225,96653,5389,102267,"2023-03-01",2023
"23-Mar",대전,계,2182,675192,33548,710922,"2023-03-01",2023
"23-Mar",울산,남구,740,156365,7010,164115,"2023-03-01",2023
"23-Mar",울산,동구,186,62335,1220,63741,"2023-03-01",2023
"23-Mar",울산,북구,227,121015,3796,125038,"2023-03-01",2023
"23-Mar",울산,울주군,431,129044,7043,136518,"2023-03-01",2023
"23-Mar",울산,중구,327,100290,2549,103166,"2023-03-01",2023
"23-Mar",울산,계,1911,569049,21618,592578,"2023-03-01",2023
"23-Mar",세종,세종특별자치시,907,191503,3559,195969,"2023-03-01",2023
"23-Mar",세종,계,907,191503,3559,195969,"2023-03-01",2023
"23-Mar",경기,가평군,398,32527,558,33483,"2023-03-01",2023
"23-Mar",경기,고양시 덕양구,668,194121,4396,199185,"2023-03-01",2023
"23-Mar",경기,고양시 일산동구,278,128562,6563,135403,"2023-03-01",2023
"23-Mar",경기,고양시 일산서구,129,117120,4380,121629,"2023-03-01",2023
"23-Mar",경기,과천시,737,29943,709,31389,"2023-03-01",2023
"23-Mar",경기,광명시,311,101332,4446,106089,"2023-03-01",2023
"23-Mar",경기,광주시,412,202936,8841,212189,"2023-03-01",2023
"23-Mar",경기,구리시,276,71219,2967,74462,"2023-03-01",2023
"23-Mar",경기,군포시,301,100012,5627,105940,"2023-03-01",2023
"23-Mar",경기,김포시,552,234125,8681,243358,"2023-03-01",2023
"23-Mar",경기,남양주시,807,317621,9505,327933,"2023-03-01",2023
"23-Mar",경기,동두천시,217,39037,1506,40760,"2023-03-01",2023
"23-Mar",경기,부천시,719,296122,13098,309939,"2023-03-01",2023
"23-Mar",경기,성남시 분당구,368,190577,7662,198607,"2023-03-01",2023
"23-Mar",경기,성남시 수정구,317,77275,2691,80283,"2023-03-01",2023
"23-Mar",경기,성남시 중원구,387,75314,4028,79729,"2023-03-01",2023
"23-Mar",경기,수원시 권선구,473,197894,9702,208069,"2023-03-01",2023
"23-Mar",경기,수원시 영통구,405,149611,3569,153585,"2023-03-01",2023
"23-Mar",경기,수원시 장안구,490,104729,3689,108908,"2023-03-01",2023
"23-Mar",경기,수원시 팔달구,356,80050,3232,83638,"2023-03-01",2023
"23-Mar",경기,시흥시,460,263906,8694,273060,"2023-03-01",2023
"23-Mar",경기,안산시 단원구,583,161482,7739,169804,"2023-03-01",2023
"23-Mar",경기,안산시 상록구,144,145991,6020,152155,"2023-03-01",2023
"23-Mar",경기,안성시,409,111314,4717,116440,"2023-03-01",2023
"23-Mar",경기,안양시 동안구,402,123163,6958,130523,"2023-03-01",2023
"23-Mar",경기,안양시 만안구,163,85801,3969,89933,"2023-03-01",2023
"23-Mar",경기,양주시,414,122269,4053,126736,"2023-03-01",2023
"23-Mar",경기,양평군,610,64786,1917,67313,"2023-03-01",2023
"23-Mar",경기,여주시,471,67407,7439,75317,"2023-03-01",2023
"23-Mar",경기,연천군,319,24554,5262,30135,"2023-03-01",2023
"23-Mar",경기,오산시,222,111728,4032,115982,"2023-03-01",2023
"23-Mar",경기,용인시 기흥구,121,194045,7276,201442,"2023-03-01",2023
"23-Mar",경기,용인시 수지구,59,150369,2351,152779,"2023-03-01",2023
"23-Mar",경기,용인시 처인구,816,139001,8167,147984,"2023-03-01",2023
"23-Mar",경기,의왕시,304,66342,2923,69569,"2023-03-01",2023
"23-Mar",경기,의정부시,748,171878,5773,178399,"2023-03-01",2023
"23-Mar",경기,이천시,423,121741,6406,128570,"2023-03-01",2023
"23-Mar",경기,파주시,539,238871,11631,251041,"2023-03-01",2023
"23-Mar",경기,평택시,772,320111,13714,334597,"2023-03-01",2023
"23-Mar",경기,포천시,392,89561,8859,98812,"2023-03-01",2023
"23-Mar",경기,하남시,434,138312,3718,142464,"2023-03-01",2023
"23-Mar",경기,화성시,959,497288,13704,511951,"2023-03-01",2023
"23-Mar",경기,계,18365,6150047,251172,6419584,"2023-03-01",2023
"23-Mar",강원,강릉시,578,113437,4765,118780,"2023-03-01",2023
"23-Mar",강원,고성군,196,15837,240,16273,"2023-03-01",2023
"23-Mar",강원,동해시,325,47468,1501,49294,"2023-03-01",2023
"23-Mar",강원,삼척시,405,33584,814,34803,"2023-03-01",2023
"23-Mar",강원,속초시,309,40447,1402,42158,"2023-03-01",2023
"23-Mar",강원,양구군,214,12391,152,12757,"2023-03-01",2023
"23-Mar",강원,양양군,202,16837,322,17361,"2023-03-01",2023
"23-Mar",강원,영월군,338,21806,396,22540,"2023-03-01",2023
"23-Mar",강원,원주시,635,187805,5820,194260,"2023-03-01",2023
"23-Mar",강원,인제군,229,19727,291,20247,"2023-03-01",2023
"23-Mar",강원,정선군,359,21156,473,21988,"2023-03-01",2023
"23-Mar",강원,철원군,256,24756,335,25347,"2023-03-01",2023
"23-Mar",강원,춘천시,850,141538,6423,148811,"2023-03-01",2023
"23-Mar",강원,태백시,236,20088,699,21023,"2023-03-01",2023
"23-Mar",강원,평창군,320,26669,597,27586,"2023-03-01",2023
"23-Mar",강원,홍천군,429,40648,1028,42105,"2023-03-01",2023
"23-Mar",강원,화천군,237,13218,184,13639,"2023-03-01",2023
"23-Mar",강원,횡성군,282,28284,918,29484,"2023-03-01",2023
"23-Mar",강원,계,6400,825696,26360,858456,"2023-03-01",2023
"23-Mar",충북,괴산군,219,23990,429,24638,"2023-03-01",2023
"23-Mar",충북,단양군,236,16058,835,17129,"2023-03-01",2023
"23-Mar",충북,보은군,241,18835,965,20041,"2023-03-01",2023
"23-Mar",충북,영동군,260,25982,428,26670,"2023-03-01",2023
"23-Mar",충북,옥천군,214,28631,1156,30001,"2023-03-01",2023
"23-Mar",충북,음성군,265,61996,2019,64280,"2023-03-01",2023
"23-Mar",충북,제천시,335,69604,3472,73411,"2023-03-01",2023
"23-Mar",충북,증평군,92,20623,783,21498,"2023-03-01",2023
"23-Mar",충북,진천군,222,53736,1452,55410,"2023-03-01",2023
"23-Mar",충북,청원군,1,19,0,20,"2023-03-01",2023
"23-Mar",충북,청주시 상당구,506,99732,2651,102889,"2023-03-01",2023
"23-Mar",충북,청주시 서원구,246,100865,4693,105804,"2023-03-01",2023
"23-Mar",충북,청주시 청원구,386,107914,4784,113084,"2023-03-01",2023
"23-Mar",충북,청주시 흥덕구,377,137840,7822,146039,"2023-03-01",2023
"23-Mar",충북,충주시,633,115488,8446,124567,"2023-03-01",2023
"23-Mar",충북,계,4233,881313,39935,925481,"2023-03-01",2023
"23-Mar",충남,계룡시,168,24613,582,25363,"2023-03-01",2023
"23-Mar",충남,공주시,597,55978,2695,59270,"2023-03-01",2023
"23-Mar",충남,금산군,210,29773,2214,32197,"2023-03-01",2023
"23-Mar",충남,논산시,416,62574,2420,65410,"2023-03-01",2023
"23-Mar",충남,당진시,409,102495,4012,106916,"2023-03-01",2023
"23-Mar",충남,보령시,420,54109,1409,55938,"2023-03-01",2023
"23-Mar",충남,부여군,307,35310,1133,36750,"2023-03-01",2023
"23-Mar",충남,서산시,441,100810,3669,104920,"2023-03-01",2023
"23-Mar",충남,서천군,235,27769,815,28819,"2023-03-01",2023
"23-Mar",충남,아산시,555,187510,7413,195478,"2023-03-01",2023
"23-Mar",충남,예산군,434,46396,1416,48246,"2023-03-01",2023
"23-Mar",충남,천안시 동남구,302,137983,5577,143862,"2023-03-01",2023
"23-Mar",충남,천안시 서북구,552,204370,5396,210318,"2023-03-01",2023
"23-Mar",충남,청양군,263,17571,726,18560,"2023-03-01",2023
"23-Mar",충남,태안군,328,35778,549,36655,"2023-03-01",2023
"23-Mar",충남,홍성군,406,54256,1462,56124,"2023-03-01",2023
"23-Mar",충남,계,6043,1177295,41488,1224826,"2023-03-01",2023
"23-Mar",전북,고창군,328,31492,571,32391,"2023-03-01",2023
"23-Mar",전북,군산시,548,136215,6441,143204,"2023-03-01",2023
"23-Mar",전북,김제시,331,48093,1976,50400,"2023-03-01",2023
"23-Mar",전북,남원시,426,42589,1915,44930,"2023-03-01",2023
"23-Mar",전북,무주군,200,13508,408,14116,"2023-03-01",2023
"23-Mar",전북,부안군,275,28364,619,29258,"2023-03-01",2023
"23-Mar",전북,순창군,232,15336,162,15730,"2023-03-01",2023
"23-Mar",전북,완주군,431,55978,3154,59563,"2023-03-01",2023
"23-Mar",전북,익산시,544,140255,5819,146618,"2023-03-01",2023
"23-Mar",전북,임실군,221,14864,428,15513,"2023-03-01",2023
"23-Mar",전북,장수군,266,12645,161,13072,"2023-03-01",2023
"23-Mar",전북,전주시 덕진구,396,176420,7167,183983,"2023-03-01",2023
"23-Mar",전북,전주시 완산구,776,155630,4196,160602,"2023-03-01",2023
"23-Mar",전북,정읍시,389,56754,3683,60826,"2023-03-01",2023
"23-Mar",전북,진안군,273,14724,251,15248,"2023-03-01",2023
"23-Mar",전북,계,5636,942867,36951,985454,"2023-03-01",2023
"23-Mar",전남,강진군,257,19191,1046,20494,"2023-03-01",2023
"23-Mar",전남,고흥군,311,33614,592,34517,"2023-03-01",2023
"23-Mar",전남,곡성군,166,15592,664,16422,"2023-03-01",2023
"23-Mar",전남,광양시,263,89910,6237,96410,"2023-03-01",2023
"23-Mar",전남,구례군,148,13451,759,14358,"2023-03-01",2023
"23-Mar",전남,나주시,483,68691,3243,72417,"2023-03-01",2023
"23-Mar",전남,담양군,231,28562,1703,30496,"2023-03-01",2023
"23-Mar",전남,목포시,428,97551,5484,103463,"2023-03-01",2023
"23-Mar",전남,무안군,582,51498,1143,53223,"2023-03-01",2023
"23-Mar",전남,보성군,236,22332,636,23204,"2023-03-01",2023
"23-Mar",전남,순천시,529,146193,5340,152062,"2023-03-01",2023
"23-Mar",전남,신안군,343,22915,103528,126786,"2023-03-01",2023
"23-Mar",전남,여수시,550,136630,7339,144519,"2023-03-01",2023
"23-Mar",전남,영광군,211,29565,788,30564,"2023-03-01",2023
"23-Mar",전남,영암군,278,35798,1276,37352,"2023-03-01",2023
"23-Mar",전남,완도군,293,26228,527,27048,"2023-03-01",2023
"23-Mar",전남,장성군,209,27812,1332,29353,"2023-03-01",2023
"23-Mar",전남,장흥군,267,20622,452,21341,"2023-03-01",2023
"23-Mar",전남,진도군,208,17587,299,18094,"2023-03-01",2023
"23-Mar",전남,함평군,210,18997,21014,40221,"2023-03-01",2023
"23-Mar",전남,해남군,329,41051,72509,113889,"2023-03-01",2023
"23-Mar",전남,화순군,247,34336,2074,36657,"2023-03-01",2023
"23-Mar",전남,계,6779,998126,237985,1242890,"2023-03-01",2023
"23-Mar",경북,경산시,347,142749,4334,147430,"2023-03-01",2023
"23-Mar",경북,경주시,607,146614,4495,151716,"2023-03-01",2023
"23-Mar",경북,고령군,181,21190,740,22111,"2023-03-01",2023
"23-Mar",경북,구미시,560,218978,7218,226756,"2023-03-01",2023
"23-Mar",경북,군위군,126,15734,309,16169,"2023-03-01",2023
"23-Mar",경북,김천시,396,77977,2058,80431,"2023-03-01",2023
"23-Mar",경북,문경시,292,38545,898,39735,"2023-03-01",2023
"23-Mar",경북,봉화군,246,18501,200,18947,"2023-03-01",2023
"23-Mar",경북,상주시,394,55226,1878,57498,"2023-03-01",2023
"23-Mar",경북,성주군,206,32059,1340,33605,"2023-03-01",2023
"23-Mar",경북,안동시,746,84634,2710,88090,"2023-03-01",2023
"23-Mar",경북,영덕군,243,19504,308,20055,"2023-03-01",2023
"23-Mar",경북,영양군,146,10040,112,10298,"2023-03-01",2023
"23-Mar",경북,영주시,362,57173,1501,59036,"2023-03-01",2023
"23-Mar",경북,영천시,355,62559,2517,65431,"2023-03-01",2023
"23-Mar",경북,예천군,286,31778,491,32555,"2023-03-01",2023
"23-Mar",경북,울릉군,157,5791,605,6553,"2023-03-01",2023
"23-Mar",경북,울진군,323,27086,333,27742,"2023-03-01",2023
"23-Mar",경북,의성군,331,32313,1087,33731,"2023-03-01",2023
"23-Mar",경북,청도군,219,26125,964,27308,"2023-03-01",2023
"23-Mar",경북,청송군,230,16248,210,16688,"2023-03-01",2023
"23-Mar",경북,칠곡군,298,71033,2505,73836,"2023-03-01",2023
"23-Mar",경북,포항시 남구,432,124259,8356,133047,"2023-03-01",2023
"23-Mar",경북,포항시 북구,369,143825,3592,147786,"2023-03-01",2023
"23-Mar",경북,계,7852,1479941,48761,1536554,"2023-03-01",2023
"23-Mar",경남,거제시,358,108414,2096,110868,"2023-03-01",2023
"23-Mar",경남,거창군,268,33875,787,34930,"2023-03-01",2023
"23-Mar",경남,고성군,231,27868,563,28662,"2023-03-01",2023
"23-Mar",경남,김해시,674,284748,7970,293392,"2023-03-01",2023
"23-Mar",경남,남해군,294,20812,455,21561,"2023-03-01",2023
"23-Mar",경남,밀양시,317,58078,3953,62348,"2023-03-01",2023
"23-Mar",경남,사천시,322,58532,1540,60394,"2023-03-01",2023
"23-Mar",경남,산청군,245,21198,751,22194,"2023-03-01",2023
"23-Mar",경남,양산시,435,173553,10655,184643,"2023-03-01",2023
"23-Mar",경남,의령군,215,15259,767,16241,"2023-03-01",2023
"23-Mar",경남,진주시,657,172140,6742,179539,"2023-03-01",2023
"23-Mar",경남,창녕군,235,36504,756,37495,"2023-03-01",2023
"23-Mar",경남,창원시 마산합포구,355,98445,2902,101702,"2023-03-01",2023
"23-Mar",경남,창원시 마산회원구,164,102631,5853,108648,"2023-03-01",2023
"23-Mar",경남,창원시 성산구,618,163175,59513,223306,"2023-03-01",2023
"23-Mar",경남,창원시 의창구,487,119098,3515,123100,"2023-03-01",2023
"23-Mar",경남,창원시 진해구,229,96460,2028,98717,"2023-03-01",2023
"23-Mar",경남,통영시,315,53211,1363,54889,"2023-03-01",2023
"23-Mar",경남,하동군,229,24468,380,25077,"2023-03-01",2023
"23-Mar",경남,함안군,210,44206,29962,74378,"2023-03-01",2023
"23-Mar",경남,함양군,232,20300,428,20960,"2023-03-01",2023
"23-Mar",경남,합천군,282,24233,633,25148,"2023-03-01",2023
"23-Mar",경남,계,7372,1757208,143612,1908192,"2023-03-01",2023
"23-Mar",제주,서귀포시,763,107955,1871,110589,"2023-03-01",2023
"23-Mar",제주,제주시,1642,308706,274321,584669,"2023-03-01",2023
"23-Mar",제주,계,2405,416661,276192,695258,"2023-03-01",2023
"23-Apr",서울,강남구,402,228224,22420,251046,"2023-04-01",2023
"23-Apr",서울,강동구,312,144781,8604,153697,"2023-04-01",2023
"23-Apr",서울,강북구,311,70682,4182,75175,"2023-04-01",2023
"23-Apr",서울,강서구,355,189004,16649,206008,"2023-04-01",2023
"23-Apr",서울,관악구,294,112791,5739,118824,"2023-04-01",2023
"23-Apr",서울,광진구,319,91942,5666,97927,"2023-04-01",2023
"23-Apr",서울,구로구,301,134387,13741,148429,"2023-04-01",2023
"23-Apr",서울,금천구,167,85697,6427,92291,"2023-04-01",2023
"23-Apr",서울,노원구,323,143520,8752,152595,"2023-04-01",2023
"23-Apr",서울,도봉구,279,87874,7384,95537,"2023-04-01",2023
"23-Apr",서울,동대문구,305,94918,4880,100103,"2023-04-01",2023
"23-Apr",서울,동작구,301,103387,2702,106390,"2023-04-01",2023
"23-Apr",서울,마포구,333,114393,7751,122477,"2023-04-01",2023
"23-Apr",서울,서대문구,453,85864,5654,91971,"2023-04-01",2023
"23-Apr",서울,서초구,510,165089,10384,175983,"2023-04-01",2023
"23-Apr",서울,성동구,362,93163,11172,104697,"2023-04-01",2023
"23-Apr",서울,성북구,292,117479,5114,122885,"2023-04-01",2023
"23-Apr",서울,송파구,400,230641,14271,245312,"2023-04-01",2023
"23-Apr",서울,양천구,327,142763,8580,151670,"2023-04-01",2023
"23-Apr",서울,영등포구,363,135951,8224,144538,"2023-04-01",2023
"23-Apr",서울,용산구,514,72759,2178,75451,"2023-04-01",2023
"23-Apr",서울,은평구,288,126189,6971,133448,"2023-04-01",2023
"23-Apr",서울,종로구,3766,44447,2653,50866,"2023-04-01",2023
"23-Apr",서울,중구,1302,52095,4191,57588,"2023-04-01",2023
"23-Apr",서울,중랑구,247,106687,9674,116608,"2023-04-01",2023
"23-Apr",서울,계,12826,2974727,203963,3191516,"2023-04-01",2023
"23-Apr",부산,강서구,326,84520,5200,90046,"2023-04-01",2023
"23-Apr",부산,금정구,277,78765,7186,86228,"2023-04-01",2023
"23-Apr",부산,기장군,261,84684,2831,87776,"2023-04-01",2023
"23-Apr",부산,남구,225,91146,9334,100705,"2023-04-01",2023
"23-Apr",부산,동구,193,41643,5646,47482,"2023-04-01",2023
"23-Apr",부산,동래구,173,97703,3539,101415,"2023-04-01",2023
"23-Apr",부산,부산진구,365,127847,21586,149798,"2023-04-01",2023
"23-Apr",부산,북구,256,102696,3743,106695,"2023-04-01",2023
"23-Apr",부산,사상구,280,83317,5436,89033,"2023-04-01",2023
"23-Apr",부산,사하구,268,108670,6081,115019,"2023-04-01",2023
"23-Apr",부산,서구,138,30282,1489,31909,"2023-04-01",2023
"23-Apr",부산,수영구,166,65369,57411,122946,"2023-04-01",2023
"23-Apr",부산,연제구,974,109780,14385,125139,"2023-04-01",2023
"23-Apr",부산,영도구,229,31617,2090,33936,"2023-04-01",2023
"23-Apr",부산,중구,311,32284,7025,39620,"2023-04-01",2023
"23-Apr",부산,해운대구,328,165744,16049,182121,"2023-04-01",2023
"23-Apr",부산,계,4770,1336067,169031,1509868,"2023-04-01",2023
"23-Apr",대구,남구,369,56458,1596,58423,"2023-04-01",2023
"23-Apr",대구,달서구,515,277247,16718,294480,"2023-04-01",2023
"23-Apr",대구,달성군,574,140444,5289,146307,"2023-04-01",2023
"23-Apr",대구,동구,370,158908,10642,169920,"2023-04-01",2023
"23-Apr",대구,북구,486,203837,7938,212261,"2023-04-01",2023
"23-Apr",대구,서구,285,67629,4863,72777,"2023-04-01",2023
"23-Apr",대구,수성구,587,212726,5037,218350,"2023-04-01",2023
"23-Apr",대구,중구,301,59102,2394,61797,"2023-04-01",2023
"23-Apr",대구,계,3487,1176351,54477,1234315,"2023-04-01",2023
"23-Apr",인천,강화군,334,38169,8004,46507,"2023-04-01",2023
"23-Apr",인천,계양구,303,122445,149683,272431,"2023-04-01",2023
"23-Apr",인천,남동구,900,253434,34606,288940,"2023-04-01",2023
"23-Apr",인천,동구,104,24343,2985,27432,"2023-04-01",2023
"23-Apr",인천,미추홀구,436,162496,9248,172180,"2023-04-01",2023
"23-Apr",인천,부평구,352,230442,41442,272236,"2023-04-01",2023
"23-Apr",인천,서구,496,290628,12352,303476,"2023-04-01",2023
"23-Apr",인천,연수구,441,209926,9221,219588,"2023-04-01",2023
"23-Apr",인천,옹진군,236,13038,261,13535,"2023-04-01",2023
"23-Apr",인천,중구,654,74589,12042,87285,"2023-04-01",2023
"23-Apr",인천,계,4256,1419510,279844,1703610,"2023-04-01",2023
"23-Apr",광주,광산구,540,202911,13383,216834,"2023-04-01",2023
"23-Apr",광주,남구,229,93116,2643,95988,"2023-04-01",2023
"23-Apr",광주,동구,234,46320,1075,47629,"2023-04-01",2023
"23-Apr",광주,북구,618,195541,9287,205446,"2023-04-01",2023
"23-Apr",광주,서구,734,144830,6564,152128,"2023-04-01",2023
"23-Apr",광주,계,2355,682718,32952,718025,"2023-04-01",2023
"23-Apr",대전,대덕구,241,88079,7906,96226,"2023-04-01",2023
"23-Apr",대전,동구,248,92660,4915,97823,"2023-04-01",2023
"23-Apr",대전,서구,804,210373,9632,220809,"2023-04-01",2023
"23-Apr",대전,유성구,662,188052,5882,194596,"2023-04-01",2023
"23-Apr",대전,중구,225,96619,5395,102239,"2023-04-01",2023
"23-Apr",대전,계,2180,675783,33730,711693,"2023-04-01",2023
"23-Apr",울산,남구,741,156544,7102,164387,"2023-04-01",2023
"23-Apr",울산,동구,186,62412,1274,63872,"2023-04-01",2023
"23-Apr",울산,북구,228,121330,3804,125362,"2023-04-01",2023
"23-Apr",울산,울주군,430,129365,7034,136829,"2023-04-01",2023
"23-Apr",울산,중구,326,100369,2550,103245,"2023-04-01",2023
"23-Apr",울산,계,1911,570020,21764,593695,"2023-04-01",2023
"23-Apr",세종,세종특별자치시,895,191847,3574,196316,"2023-04-01",2023
"23-Apr",세종,계,895,191847,3574,196316,"2023-04-01",2023
"23-Apr",경기,가평군,399,32538,556,33493,"2023-04-01",2023
"23-Apr",경기,고양시 덕양구,669,194815,4400,199884,"2023-04-01",2023
"23-Apr",경기,고양시 일산동구,279,128626,6555,135460,"2023-04-01",2023
"23-Apr",경기,고양시 일산서구,129,117154,4515,121798,"2023-04-01",2023
"23-Apr",경기,과천시,697,30251,690,31638,"2023-04-01",2023
"23-Apr",경기,광명시,311,100954,4492,105757,"2023-04-01",2023
"23-Apr",경기,광주시,411,202963,8839,212213,"2023-04-01",2023
"23-Apr",경기,구리시,282,71306,3008,74596,"2023-04-01",2023
"23-Apr",경기,군포시,302,100014,5633,105949,"2023-04-01",2023
"23-Apr",경기,김포시,555,234485,9133,244173,"2023-04-01",2023
"23-Apr",경기,남양주시,802,317938,9526,328266,"2023-04-01",2023
"23-Apr",경기,동두천시,220,38960,1547,40727,"2023-04-01",2023
"23-Apr",경기,부천시,722,297005,13214,310941,"2023-04-01",2023
"23-Apr",경기,성남시 분당구,367,190604,7661,198632,"2023-04-01",2023
"23-Apr",경기,성남시 수정구,318,77746,2732,80796,"2023-04-01",2023
"23-Apr",경기,성남시 중원구,387,75301,4048,79736,"2023-04-01",2023
"23-Apr",경기,수원시 권선구,474,198587,9784,208845,"2023-04-01",2023
"23-Apr",경기,수원시 영통구,406,149919,3627,153952,"2023-04-01",2023
"23-Apr",경기,수원시 장안구,500,104741,3703,108944,"2023-04-01",2023
"23-Apr",경기,수원시 팔달구,366,80289,3248,83903,"2023-04-01",2023
"23-Apr",경기,시흥시,457,264899,8799,274155,"2023-04-01",2023
"23-Apr",경기,안산시 단원구,584,161956,7819,170359,"2023-04-01",2023
"23-Apr",경기,안산시 상록구,145,145793,6016,151954,"2023-04-01",2023
"23-Apr",경기,안성시,407,111888,4726,117021,"2023-04-01",2023
"23-Apr",경기,안양시 동안구,403,123218,7083,130704,"2023-04-01",2023
"23-Apr",경기,안양시 만안구,162,85821,3950,89933,"2023-04-01",2023
"23-Apr",경기,양주시,419,123153,4089,127661,"2023-04-01",2023
"23-Apr",경기,양평군,603,64900,1906,67409,"2023-04-01",2023
"23-Apr",경기,여주시,480,67597,7443,75520,"2023-04-01",2023
"23-Apr",경기,연천군,318,24517,5263,30098,"2023-04-01",2023
"23-Apr",경기,오산시,223,111939,4079,116241,"2023-04-01",2023
"23-Apr",경기,용인시 기흥구,121,194170,7249,201540,"2023-04-01",2023
"23-Apr",경기,용인시 수지구,59,150568,2354,152981,"2023-04-01",2023
"23-Apr",경기,용인시 처인구,818,139759,8177,148754,"2023-04-01",2023
"23-Apr",경기,의왕시,304,66328,2924,69556,"2023-04-01",2023
"23-Apr",경기,의정부시,754,171921,5806,178481,"2023-04-01",2023
"23-Apr",경기,이천시,422,121971,6461,128854,"2023-04-01",2023
"23-Apr",경기,파주시,548,239472,11636,251656,"2023-04-01",2023
"23-Apr",경기,평택시,776,321233,13867,335876,"2023-04-01",2023
"23-Apr",경기,포천시,420,89624,8661,98705,"2023-04-01",2023
"23-Apr",경기,하남시,442,138561,3729,142732,"2023-04-01",2023
"23-Apr",경기,화성시,962,499549,13830,514341,"2023-04-01",2023
"23-Apr",경기,계,18423,6163033,252778,6434234,"2023-04-01",2023
"23-Apr",강원,강릉시,581,113419,4794,118794,"2023-04-01",2023
"23-Apr",강원,고성군,196,15853,238,16287,"2023-04-01",2023
"23-Apr",강원,동해시,322,47519,1502,49343,"2023-04-01",2023
"23-Apr",강원,삼척시,406,33562,809,34777,"2023-04-01",2023
"23-Apr",강원,속초시,307,40520,1418,42245,"2023-04-01",2023
"23-Apr",강원,양구군,215,12474,152,12841,"2023-04-01",2023
"23-Apr",강원,양양군,202,16868,321,17391,"2023-04-01",2023
"23-Apr",강원,영월군,341,21823,398,22562,"2023-04-01",2023
"23-Apr",강원,원주시,633,187646,5842,194121,"2023-04-01",2023
"23-Apr",강원,인제군,228,19753,285,20266,"2023-04-01",2023
"23-Apr",강원,정선군,361,21189,492,22042,"2023-04-01",2023
"23-Apr",강원,철원군,257,24818,334,25409,"2023-04-01",2023
"23-Apr",강원,춘천시,854,141670,6448,148972,"2023-04-01",2023
"23-Apr",강원,태백시,237,20065,700,21002,"2023-04-01",2023
"23-Apr",강원,평창군,319,26676,608,27603,"2023-04-01",2023
"23-Apr",강원,홍천군,428,40621,1032,42081,"2023-04-01",2023
"23-Apr",강원,화천군,237,13223,184,13644,"2023-04-01",2023
"23-Apr",강원,횡성군,283,28338,904,29525,"2023-04-01",2023
"23-Apr",강원,계,6407,826037,26461,858905,"2023-04-01",2023
"23-Apr",충북,괴산군,218,24007,444,24669,"2023-04-01",2023
"23-Apr",충북,단양군,237,16124,843,17204,"2023-04-01",2023
"23-Apr",충북,보은군,242,18838,965,20045,"2023-04-01",2023
"23-Apr",충북,영동군,261,25986,430,26677,"2023-04-01",2023
"23-Apr",충북,옥천군,212,28633,1150,29995,"2023-04-01",2023
"23-Apr",충북,음성군,266,62206,2029,64501,"2023-04-01",2023
"23-Apr",충북,제천시,336,69566,3480,73382,"2023-04-01",2023
"23-Apr",충북,증평군,92,20654,786,21532,"2023-04-01",2023
"23-Apr",충북,진천군,222,53828,1461,55511,"2023-04-01",2023
"23-Apr",충북,청원군,1,19,0,20,"2023-04-01",2023
"23-Apr",충북,청주시 상당구,505,99733,2661,102899,"2023-04-01",2023
"23-Apr",충북,청주시 서원구,246,100642,4678,105566,"2023-04-01",2023
"23-Apr",충북,청주시 청원구,384,108145,4793,113322,"2023-04-01",2023
"23-Apr",충북,청주시 흥덕구,366,138542,7925,146833,"2023-04-01",2023
"23-Apr",충북,충주시,628,115539,8631,124798,"2023-04-01",2023
"23-Apr",충북,계,4216,882462,40276,926954,"2023-04-01",2023
"23-Apr",충남,계룡시,168,24909,584,25661,"2023-04-01",2023
"23-Apr",충남,공주시,597,56065,2753,59415,"2023-04-01",2023
"23-Apr",충남,금산군,211,29790,2250,32251,"2023-04-01",2023
"23-Apr",충남,논산시,416,62585,2422,65423,"2023-04-01",2023
"23-Apr",충남,당진시,411,102874,4016,107301,"2023-04-01",2023
"23-Apr",충남,보령시,419,54157,1416,55992,"2023-04-01",2023
"23-Apr",충남,부여군,306,35264,1127,36697,"2023-04-01",2023
"23-Apr",충남,서산시,437,100845,3694,104976,"2023-04-01",2023
"23-Apr",충남,서천군,234,27818,803,28855,"2023-04-01",2023
"23-Apr",충남,아산시,552,187788,7452,195792,"2023-04-01",2023
"23-Apr",충남,예산군,438,46485,1427,48350,"2023-04-01",2023
"23-Apr",충남,천안시 동남구,303,138506,5593,144402,"2023-04-01",2023
"23-Apr",충남,천안시 서북구,554,204652,5453,210659,"2023-04-01",2023
"23-Apr",충남,청양군,265,17546,722,18533,"2023-04-01",2023
"23-Apr",충남,태안군,327,35810,558,36695,"2023-04-01",2023
"23-Apr",충남,홍성군,405,54235,1458,56098,"2023-04-01",2023
"23-Apr",충남,계,6043,1179329,41728,1227100,"2023-04-01",2023
"23-Apr",전북,고창군,326,31558,568,32452,"2023-04-01",2023
"23-Apr",전북,군산시,538,136194,6457,143189,"2023-04-01",2023
"23-Apr",전북,김제시,320,48151,1979,50450,"2023-04-01",2023
"23-Apr",전북,남원시,422,42650,1789,44861,"2023-04-01",2023
"23-Apr",전북,무주군,195,13598,411,14204,"2023-04-01",2023
"23-Apr",전북,부안군,268,28380,622,29270,"2023-04-01",2023
"23-Apr",전북,순창군,229,15354,161,15744,"2023-04-01",2023
"23-Apr",전북,완주군,426,56470,3152,60048,"2023-04-01",2023
"23-Apr",전북,익산시,538,140625,5838,147001,"2023-04-01",2023
"23-Apr",전북,임실군,220,14895,426,15541,"2023-04-01",2023
"23-Apr",전북,장수군,267,12622,162,13051,"2023-04-01",2023
"23-Apr",전북,전주시 덕진구,463,176226,7144,183833,"2023-04-01",2023
"23-Apr",전북,전주시 완산구,760,155561,4240,160561,"2023-04-01",2023
"23-Apr",전북,정읍시,383,56958,3631,60972,"2023-04-01",2023
"23-Apr",전북,진안군,275,14732,252,15259,"2023-04-01",2023
"23-Apr",전북,계,5630,943974,36832,986436,"2023-04-01",2023
"23-Apr",전남,강진군,257,19208,1045,20510,"2023-04-01",2023
"23-Apr",전남,고흥군,312,33713,593,34618,"2023-04-01",2023
"23-Apr",전남,곡성군,164,15611,663,16438,"2023-04-01",2023
"23-Apr",전남,광양시,263,90044,6231,96538,"2023-04-01",2023
"23-Apr",전남,구례군,149,13413,756,14318,"2023-04-01",2023
"23-Apr",전남,나주시,486,68832,3232,72550,"2023-04-01",2023
"23-Apr",전남,담양군,233,28548,1705,30486,"2023-04-01",2023
"23-Apr",전남,목포시,424,97631,5522,103577,"2023-04-01",2023
"23-Apr",전남,무안군,588,51582,1140,53310,"2023-04-01",2023
"23-Apr",전남,보성군,239,22332,638,23209,"2023-04-01",2023
"23-Apr",전남,순천시,531,146401,5369,152301,"2023-04-01",2023
"23-Apr",전남,신안군,345,23034,102892,126271,"2023-04-01",2023
"23-Apr",전남,여수시,549,136774,7393,144716,"2023-04-01",2023
"23-Apr",전남,영광군,242,29530,793,30565,"2023-04-01",2023
"23-Apr",전남,영암군,277,35895,1225,37397,"2023-04-01",2023
"23-Apr",전남,완도군,292,26327,513,27132,"2023-04-01",2023
"23-Apr",전남,장성군,211,27885,1333,29429,"2023-04-01",2023
"23-Apr",전남,장흥군,268,20565,449,21282,"2023-04-01",2023
"23-Apr",전남,진도군,209,17611,301,18121,"2023-04-01",2023
"23-Apr",전남,함평군,211,18995,19369,38575,"2023-04-01",2023
"23-Apr",전남,해남군,329,40991,73116,114436,"2023-04-01",2023
"23-Apr",전남,화순군,247,34315,2083,36645,"2023-04-01",2023
"23-Apr",전남,계,6826,999237,236361,1242424,"2023-04-01",2023
"23-Apr",경북,경산시,346,142707,4349,147402,"2023-04-01",2023
"23-Apr",경북,경주시,598,147007,4564,152169,"2023-04-01",2023
"23-Apr",경북,고령군,181,21232,742,22155,"2023-04-01",2023
"23-Apr",경북,구미시,555,219155,7253,226963,"2023-04-01",2023
"23-Apr",경북,군위군,127,15760,308,16195,"2023-04-01",2023
"23-Apr",경북,김천시,397,78081,2075,80553,"2023-04-01",2023
"23-Apr",경북,문경시,290,38560,898,39748,"2023-04-01",2023
"23-Apr",경북,봉화군,248,18523,199,18970,"2023-04-01",2023
"23-Apr",경북,상주시,395,55245,1890,57530,"2023-04-01",2023
"23-Apr",경북,성주군,207,31980,1350,33537,"2023-04-01",2023
"23-Apr",경북,안동시,740,84791,2720,88251,"2023-04-01",2023
"23-Apr",경북,영덕군,245,19526,310,20081,"2023-04-01",2023
"23-Apr",경북,영양군,145,10079,114,10338,"2023-04-01",2023
"23-Apr",경북,영주시,362,57182,1499,59043,"2023-04-01",2023
"23-Apr",경북,영천시,356,62590,2519,65465,"2023-04-01",2023
"23-Apr",경북,예천군,287,31818,495,32600,"2023-04-01",2023
"23-Apr",경북,울릉군,156,5812,615,6583,"2023-04-01",2023
"23-Apr",경북,울진군,319,27143,336,27798,"2023-04-01",2023
"23-Apr",경북,의성군,327,32351,1089,33767,"2023-04-01",2023
"23-Apr",경북,청도군,217,26183,969,27369,"2023-04-01",2023
"23-Apr",경북,청송군,227,16236,210,16673,"2023-04-01",2023
"23-Apr",경북,칠곡군,300,70939,2495,73734,"2023-04-01",2023
"23-Apr",경북,포항시 남구,433,124491,8371,133295,"2023-04-01",2023
"23-Apr",경북,포항시 북구,378,144038,3591,148007,"2023-04-01",2023
"23-Apr",경북,계,7836,1481429,48961,1538226,"2023-04-01",2023
"23-Apr",경남,거제시,357,108433,2101,110891,"2023-04-01",2023
"23-Apr",경남,거창군,273,33948,793,35014,"2023-04-01",2023
"23-Apr",경남,고성군,231,27848,566,28645,"2023-04-01",2023
"23-Apr",경남,김해시,674,285008,7993,293675,"2023-04-01",2023
"23-Apr",경남,남해군,291,20854,459,21604,"2023-04-01",2023
"23-Apr",경남,밀양시,318,58015,3955,62288,"2023-04-01",2023
"23-Apr",경남,사천시,326,58573,1532,60431,"2023-04-01",2023
"23-Apr",경남,산청군,247,21311,753,22311,"2023-04-01",2023
"23-Apr",경남,양산시,434,173886,10719,185039,"2023-04-01",2023
"23-Apr",경남,의령군,216,15319,765,16300,"2023-04-01",2023
"23-Apr",경남,진주시,659,172187,6740,179586,"2023-04-01",2023
"23-Apr",경남,창녕군,234,36465,756,37455,"2023-04-01",2023
"23-Apr",경남,창원시 마산합포구,352,98502,2880,101734,"2023-04-01",2023
"23-Apr",경남,창원시 마산회원구,158,102833,5908,108899,"2023-04-01",2023
"23-Apr",경남,창원시 성산구,622,163930,59551,224103,"2023-04-01",2023
"23-Apr",경남,창원시 의창구,488,119139,3508,123135,"2023-04-01",2023
"23-Apr",경남,창원시 진해구,227,96514,2031,98772,"2023-04-01",2023
"23-Apr",경남,통영시,311,53290,1362,54963,"2023-04-01",2023
"23-Apr",경남,하동군,230,24506,379,25115,"2023-04-01",2023
"23-Apr",경남,함안군,216,43978,29488,73682,"2023-04-01",2023
"23-Apr",경남,함양군,231,20288,430,20949,"2023-04-01",2023
"23-Apr",경남,합천군,283,24247,637,25167,"2023-04-01",2023
"23-Apr",경남,계,7378,1759074,143306,1909758,"2023-04-01",2023
"23-Apr",제주,서귀포시,756,108022,1872,110650,"2023-04-01",2023
"23-Apr",제주,제주시,1645,309332,274980,585957,"2023-04-01",2023
"23-Apr",제주,계,2401,417354,276852,696607,"2023-04-01",2023
"23-May",서울,강남구,402,228476,22245,251123,"2023-05-01",2023
"23-May",서울,강동구,312,144818,8650,153780,"2023-05-01",2023
"23-May",서울,강북구,314,70656,4215,75185,"2023-05-01",2023
"23-May",서울,강서구,359,188763,16528,205650,"2023-05-01",2023
"23-May",서울,관악구,294,112755,5761,118810,"2023-05-01",2023
"23-May",서울,광진구,326,91978,5616,97920,"2023-05-01",2023
"23-May",서울,구로구,302,134430,13652,148384,"2023-05-01",2023
"23-May",서울,금천구,169,85741,6412,92322,"2023-05-01",2023
"23-May",서울,노원구,319,143466,8718,152503,"2023-05-01",2023
"23-May",서울,도봉구,281,87837,7459,95577,"2023-05-01",2023
"23-May",서울,동대문구,306,94996,4863,100165,"2023-05-01",2023
"23-May",서울,동작구,297,103577,2699,106573,"2023-05-01",2023
"23-May",서울,마포구,332,114458,7755,122545,"2023-05-01",2023
"23-May",서울,서대문구,428,85897,5581,91906,"2023-05-01",2023
"23-May",서울,서초구,510,165414,10341,176265,"2023-05-01",2023
"23-May",서울,성동구,365,93018,11148,104531,"2023-05-01",2023
"23-May",서울,성북구,300,117445,5105,122850,"2023-05-01",2023
"23-May",서울,송파구,408,230233,14288,244929,"2023-05-01",2023
"23-May",서울,양천구,332,142710,8562,151604,"2023-05-01",2023
"23-May",서울,영등포구,372,136030,8224,144626,"2023-05-01",2023
"23-May",서울,용산구,524,72720,2181,75425,"2023-05-01",2023
"23-May",서울,은평구,291,126039,7028,133358,"2023-05-01",2023
"23-May",서울,종로구,3815,44402,2624,50841,"2023-05-01",2023
"23-May",서울,중구,1348,51895,3496,56739,"2023-05-01",2023
"23-May",서울,중랑구,246,106763,9668,116677,"2023-05-01",2023
"23-May",서울,계,12952,2974517,202819,3190288,"2023-05-01",2023
"23-May",부산,강서구,342,84689,5234,90265,"2023-05-01",2023
"23-May",부산,금정구,279,78782,7149,86210,"2023-05-01",2023
"23-May",부산,기장군,260,84959,2840,88059,"2023-05-01",2023
"23-May",부산,남구,226,91216,9347,100789,"2023-05-01",2023
"23-May",부산,동구,189,41696,5690,47575,"2023-05-01",2023
"23-May",부산,동래구,167,97661,3540,101368,"2023-05-01",2023
"23-May",부산,부산진구,364,128071,21293,149728,"2023-05-01",2023
"23-May",부산,북구,246,102661,3744,106651,"2023-05-01",2023
"23-May",부산,사상구,281,83145,5422,88848,"2023-05-01",2023
"23-May",부산,사하구,274,108782,6028,115084,"2023-05-01",2023
"23-May",부산,서구,142,30266,1481,31889,"2023-05-01",2023
"23-May",부산,수영구,165,65425,58712,124302,"2023-05-01",2023
"23-May",부산,연제구,1000,109941,14645,125586,"2023-05-01",2023
"23-May",부산,영도구,227,31589,2080,33896,"2023-05-01",2023
"23-May",부산,중구,312,32455,6980,39747,"2023-05-01",2023
"23-May",부산,해운대구,328,165649,15786,181763,"2023-05-01",2023
"23-May",부산,계,4802,1336987,169971,1511760,"2023-05-01",2023
"23-May",대구,남구,371,56372,1593,58336,"2023-05-01",2023
"23-May",대구,달서구,501,276912,16948,294361,"2023-05-01",2023
"23-May",대구,달성군,585,140711,5274,146570,"2023-05-01",2023
"23-May",대구,동구,369,159211,10672,170252,"2023-05-01",2023
"23-May",대구,북구,493,203760,7946,212199,"2023-05-01",2023
"23-May",대구,서구,286,68059,4872,73217,"2023-05-01",2023
"23-May",대구,수성구,584,212497,5108,218189,"2023-05-01",2023
"23-May",대구,중구,302,58904,2313,61519,"2023-05-01",2023
"23-May",대구,계,3491,1176426,54726,1234643,"2023-05-01",2023
"23-May",인천,강화군,335,38227,7558,46120,"2023-05-01",2023
"23-May",인천,계양구,302,122494,149339,272135,"2023-05-01",2023
"23-May",인천,남동구,902,253288,34141,288331,"2023-05-01",2023
"23-May",인천,동구,102,24442,2961,27505,"2023-05-01",2023
"23-May",인천,미추홀구,441,162437,9154,172032,"2023-05-01",2023
"23-May",인천,부평구,351,230473,41697,272521,"2023-05-01",2023
"23-May",인천,서구,493,291152,12359,304004,"2023-05-01",2023
"23-May",인천,연수구,445,210644,9388,220477,"2023-05-01",2023
"23-May",인천,옹진군,235,13100,265,13600,"2023-05-01",2023
"23-May",인천,중구,697,75051,12050,87798,"2023-05-01",2023
"23-May",인천,계,4303,1421308,278912,1704523,"2023-05-01",2023
"23-May",광주,광산구,537,202954,13303,216794,"2023-05-01",2023
"23-May",광주,남구,237,93141,2633,96011,"2023-05-01",2023
"23-May",광주,동구,236,46404,1072,47712,"2023-05-01",2023
"23-May",광주,북구,634,195651,9233,205518,"2023-05-01",2023
"23-May",광주,서구,737,144521,6536,151794,"2023-05-01",2023
"23-May",광주,계,2381,682671,32777,717829,"2023-05-01",2023
"23-May",대전,대덕구,241,87947,7894,96082,"2023-05-01",2023
"23-May",대전,동구,248,92654,4929,97831,"2023-05-01",2023
"23-May",대전,서구,810,210386,9783,220979,"2023-05-01",2023
"23-May",대전,유성구,659,188836,5889,195384,"2023-05-01",2023
"23-May",대전,중구,229,96640,5397,102266,"2023-05-01",2023
"23-May",대전,계,2187,676463,33892,712542,"2023-05-01",2023
"23-May",울산,남구,741,156837,7112,164690,"2023-05-01",2023
"23-May",울산,동구,186,62534,1270,63990,"2023-05-01",2023
"23-May",울산,북구,230,121383,3801,125414,"2023-05-01",2023
"23-May",울산,울주군,429,129595,7032,137056,"2023-05-01",2023
"23-May",울산,중구,328,100500,2537,103365,"2023-05-01",2023
"23-May",울산,계,1914,570849,21752,594515,"2023-05-01",2023
"23-May",세종,세종특별자치시,910,192003,3596,196509,"2023-05-01",2023
"23-May",세종,계,910,192003,3596,196509,"2023-05-01",2023
"23-May",경기,가평군,428,32540,556,33524,"2023-05-01",2023
"23-May",경기,고양시 덕양구,675,195569,5054,201298,"2023-05-01",2023
"23-May",경기,고양시 일산동구,275,128685,6362,135322,"2023-05-01",2023
"23-May",경기,고양시 일산서구,134,117163,4506,121803,"2023-05-01",2023
"23-May",경기,과천시,701,30444,692,31837,"2023-05-01",2023
"23-May",경기,광명시,311,100806,4483,105600,"2023-05-01",2023
"23-May",경기,광주시,417,203279,8856,212552,"2023-05-01",2023
"23-May",경기,구리시,281,71331,3024,74636,"2023-05-01",2023
"23-May",경기,군포시,306,100044,5607,105957,"2023-05-01",2023
"23-May",경기,김포시,552,235087,9071,244710,"2023-05-01",2023
"23-May",경기,남양주시,807,318000,9573,328380,"2023-05-01",2023
"23-May",경기,동두천시,223,38915,1551,40689,"2023-05-01",2023
"23-May",경기,부천시,725,297102,13317,311144,"2023-05-01",2023
"23-May",경기,성남시 분당구,364,190500,7654,198518,"2023-05-01",2023
"23-May",경기,성남시 수정구,314,78052,2718,81084,"2023-05-01",2023
"23-May",경기,성남시 중원구,386,75335,4035,79756,"2023-05-01",2023
"23-May",경기,수원시 권선구,474,198901,9777,209152,"2023-05-01",2023
"23-May",경기,수원시 영통구,410,150031,3621,154062,"2023-05-01",2023
"23-May",경기,수원시 장안구,482,104749,3697,108928,"2023-05-01",2023
"23-May",경기,수원시 팔달구,366,80361,3265,83992,"2023-05-01",2023
"23-May",경기,시흥시,455,265420,8849,274724,"2023-05-01",2023
"23-May",경기,안산시 단원구,592,162286,7836,170714,"2023-05-01",2023
"23-May",경기,안산시 상록구,145,145652,5988,151785,"2023-05-01",2023
"23-May",경기,안성시,406,111892,4662,116960,"2023-05-01",2023
"23-May",경기,안양시 동안구,406,123190,7078,130674,"2023-05-01",2023
"23-May",경기,안양시 만안구,161,85829,3967,89957,"2023-05-01",2023
"23-May",경기,양주시,425,124488,4124,129037,"2023-05-01",2023
"23-May",경기,양평군,607,65036,1911,67554,"2023-05-01",2023
"23-May",경기,여주시,485,67718,7433,75636,"2023-05-01",2023
"23-May",경기,연천군,323,24569,5270,30162,"2023-05-01",2023
"23-May",경기,오산시,227,112145,4106,116478,"2023-05-01",2023
"23-May",경기,용인시 기흥구,122,194069,7304,201495,"2023-05-01",2023
"23-May",경기,용인시 수지구,59,150733,2352,153144,"2023-05-01",2023
"23-May",경기,용인시 처인구,837,140515,8146,149498,"2023-05-01",2023
"23-May",경기,의왕시,311,66258,2913,69482,"2023-05-01",2023
"23-May",경기,의정부시,758,172154,5691,178603,"2023-05-01",2023
"23-May",경기,이천시,430,122152,6519,129101,"2023-05-01",2023
"23-May",경기,파주시,562,239745,11607,251914,"2023-05-01",2023
"23-May",경기,평택시,784,321948,13924,336656,"2023-05-01",2023
"23-May",경기,포천시,432,89580,8448,98460,"2023-05-01",2023
"23-May",경기,하남시,441,138813,3765,143019,"2023-05-01",2023
"23-May",경기,화성시,971,501960,13951,516882,"2023-05-01",2023
"23-May",경기,계,18570,6173046,253263,6444879,"2023-05-01",2023
"23-May",강원,강릉시,584,113416,4769,118769,"2023-05-01",2023
"23-May",강원,고성군,195,15924,236,16355,"2023-05-01",2023
"23-May",강원,동해시,326,47576,1544,49446,"2023-05-01",2023
"23-May",강원,삼척시,413,33555,814,34782,"2023-05-01",2023
"23-May",강원,속초시,314,40592,1445,42351,"2023-05-01",2023
"23-May",강원,양구군,218,12497,151,12866,"2023-05-01",2023
"23-May",강원,양양군,207,16872,319,17398,"2023-05-01",2023
"23-May",강원,영월군,348,21866,386,22600,"2023-05-01",2023
"23-May",강원,원주시,637,187875,5884,194396,"2023-05-01",2023
"23-May",강원,인제군,229,19777,292,20298,"2023-05-01",2023
"23-May",강원,정선군,360,21166,490,22016,"2023-05-01",2023
"23-May",강원,철원군,265,24790,336,25391,"2023-05-01",2023
"23-May",강원,춘천시,862,141802,6413,149077,"2023-05-01",2023
"23-May",강원,태백시,238,20073,711,21022,"2023-05-01",2023
"23-May",강원,평창군,329,26713,658,27700,"2023-05-01",2023
"23-May",강원,홍천군,428,40676,1049,42153,"2023-05-01",2023
"23-May",강원,화천군,237,13289,185,13711,"2023-05-01",2023
"23-May",강원,횡성군,288,28380,897,29565,"2023-05-01",2023
"23-May",강원,계,6478,826839,26579,859896,"2023-05-01",2023
"23-May",충북,괴산군,219,24010,457,24686,"2023-05-01",2023
"23-May",충북,단양군,238,16165,830,17233,"2023-05-01",2023
"23-May",충북,보은군,245,18915,961,20121,"2023-05-01",2023
"23-May",충북,영동군,264,26068,429,26761,"2023-05-01",2023
"23-May",충북,옥천군,209,28648,1145,30002,"2023-05-01",2023
"23-May",충북,음성군,271,62233,2032,64536,"2023-05-01",2023
"23-May",충북,제천시,338,69633,3471,73442,"2023-05-01",2023
"23-May",충북,증평군,95,20683,785,21563,"2023-05-01",2023
"23-May",충북,진천군,224,53999,1477,55700,"2023-05-01",2023
"23-May",충북,청원군,1,19,0,20,"2023-05-01",2023
"23-May",충북,청주시 상당구,512,99844,2652,103008,"2023-05-01",2023
"23-May",충북,청주시 서원구,250,101354,4653,106257,"2023-05-01",2023
"23-May",충북,청주시 청원구,390,108001,4797,113188,"2023-05-01",2023
"23-May",충북,청주시 흥덕구,364,138776,7911,147051,"2023-05-01",2023
"23-May",충북,충주시,635,115806,8513,124954,"2023-05-01",2023
"23-May",충북,계,4255,884154,40113,928522,"2023-05-01",2023
"23-May",충남,계룡시,172,25116,587,25875,"2023-05-01",2023
"23-May",충남,공주시,591,56110,2702,59403,"2023-05-01",2023
"23-May",충남,금산군,208,29829,2261,32298,"2023-05-01",2023
"23-May",충남,논산시,417,62644,2420,65481,"2023-05-01",2023
"23-May",충남,당진시,413,103305,4027,107745,"2023-05-01",2023
"23-May",충남,보령시,419,54205,1413,56037,"2023-05-01",2023
"23-May",충남,부여군,307,35243,1121,36671,"2023-05-01",2023
"23-May",충남,서산시,437,101101,3710,105248,"2023-05-01",2023
"23-May",충남,서천군,236,27802,790,28828,"2023-05-01",2023
"23-May",충남,아산시,551,188267,7415,196233,"2023-05-01",2023
"23-May",충남,예산군,446,46589,1439,48474,"2023-05-01",2023
"23-May",충남,천안시 동남구,301,138508,5583,144392,"2023-05-01",2023
"23-May",충남,천안시 서북구,560,204715,5461,210736,"2023-05-01",2023
"23-May",충남,청양군,265,17597,720,18582,"2023-05-01",2023
"23-May",충남,태안군,328,35857,554,36739,"2023-05-01",2023
"23-May",충남,홍성군,406,54234,1462,56102,"2023-05-01",2023
"23-May",충남,계,6057,1181122,41665,1228844,"2023-05-01",2023
"23-May",전북,고창군,334,31531,568,32433,"2023-05-01",2023
"23-May",전북,군산시,556,136164,6457,143177,"2023-05-01",2023
"23-May",전북,김제시,320,48163,1982,50465,"2023-05-01",2023
"23-May",전북,남원시,426,42669,1705,44800,"2023-05-01",2023
"23-May",전북,무주군,194,13561,408,14163,"2023-05-01",2023
"23-May",전북,부안군,271,28382,615,29268,"2023-05-01",2023
"23-May",전북,순창군,231,15382,161,15774,"2023-05-01",2023
"23-May",전북,완주군,423,56738,3169,60330,"2023-05-01",2023
"23-May",전북,익산시,541,140282,5819,146642,"2023-05-01",2023
"23-May",전북,임실군,222,14913,425,15560,"2023-05-01",2023
"23-May",전북,장수군,266,12592,161,13019,"2023-05-01",2023
"23-May",전북,전주시 덕진구,392,175973,7130,183495,"2023-05-01",2023
"23-May",전북,전주시 완산구,764,155668,4243,160675,"2023-05-01",2023
"23-May",전북,정읍시,384,56955,3565,60904,"2023-05-01",2023
"23-May",전북,진안군,275,14747,251,15273,"2023-05-01",2023
"23-May",전북,계,5599,943720,36659,985978,"2023-05-01",2023
"23-May",전남,강진군,258,19288,1041,20587,"2023-05-01",2023
"23-May",전남,고흥군,311,33720,593,34624,"2023-05-01",2023
"23-May",전남,곡성군,170,15656,657,16483,"2023-05-01",2023
"23-May",전남,광양시,259,90256,6240,96755,"2023-05-01",2023
"23-May",전남,구례군,150,13451,746,14347,"2023-05-01",2023
"23-May",전남,나주시,480,68900,3222,72602,"2023-05-01",2023
"23-May",전남,담양군,233,28557,1714,30504,"2023-05-01",2023
"23-May",전남,목포시,423,97581,5503,103507,"2023-05-01",2023
"23-May",전남,무안군,594,51654,1144,53392,"2023-05-01",2023
"23-May",전남,보성군,238,22355,626,23219,"2023-05-01",2023
"23-May",전남,순천시,532,146594,5340,152466,"2023-05-01",2023
"23-May",전남,신안군,355,23147,104091,127593,"2023-05-01",2023
"23-May",전남,여수시,555,136818,7394,144767,"2023-05-01",2023
"23-May",전남,영광군,237,29579,789,30605,"2023-05-01",2023
"23-May",전남,영암군,277,36012,1201,37490,"2023-05-01",2023
"23-May",전남,완도군,308,26367,513,27188,"2023-05-01",2023
"23-May",전남,장성군,218,27853,1337,29408,"2023-05-01",2023
"23-May",전남,장흥군,274,20575,448,21297,"2023-05-01",2023
"23-May",전남,진도군,215,17634,301,18150,"2023-05-01",2023
"23-May",전남,함평군,215,18973,17848,37036,"2023-05-01",2023
"23-May",전남,해남군,329,41028,75789,117146,"2023-05-01",2023
"23-May",전남,화순군,251,34274,2152,36677,"2023-05-01",2023
"23-May",전남,계,6882,1000272,238689,1245843,"2023-05-01",2023
"23-May",경북,경산시,351,142732,4365,147448,"2023-05-01",2023
"23-May",경북,경주시,605,146785,4618,152008,"2023-05-01",2023
"23-May",경북,고령군,180,21241,743,22164,"2023-05-01",2023
"23-May",경북,구미시,559,219237,7269,227065,"2023-05-01",2023
"23-May",경북,군위군,128,15788,305,16221,"2023-05-01",2023
"23-May",경북,김천시,403,78159,2079,80641,"2023-05-01",2023
"23-May",경북,문경시,290,38548,891,39729,"2023-05-01",2023
"23-May",경북,봉화군,247,18576,198,19021,"2023-05-01",2023
"23-May",경북,상주시,396,55382,1888,57666,"2023-05-01",2023
"23-May",경북,성주군,211,31953,1364,33528,"2023-05-01",2023
"23-May",경북,안동시,743,84770,2717,88230,"2023-05-01",2023
"23-May",경북,영덕군,250,19483,308,20041,"2023-05-01",2023
"23-May",경북,영양군,147,10101,115,10363,"2023-05-01",2023
"23-May",경북,영주시,365,57193,1499,59057,"2023-05-01",2023
"23-May",경북,영천시,360,62649,2518,65527,"2023-05-01",2023
"23-May",경북,예천군,291,31820,497,32608,"2023-05-01",2023
"23-May",경북,울릉군,158,5817,616,6591,"2023-05-01",2023
"23-May",경북,울진군,325,27207,339,27871,"2023-05-01",2023
"23-May",경북,의성군,324,32436,1092,33852,"2023-05-01",2023
"23-May",경북,청도군,216,26183,979,27378,"2023-05-01",2023
"23-May",경북,청송군,226,16260,212,16698,"2023-05-01",2023
"23-May",경북,칠곡군,304,71002,2493,73799,"2023-05-01",2023
"23-May",경북,포항시 남구,437,124899,8373,133709,"2023-05-01",2023
"23-May",경북,포항시 북구,377,144107,3587,148071,"2023-05-01",2023
"23-May",경북,계,7893,1482328,49065,1539286,"2023-05-01",2023
"23-May",경남,거제시,361,108529,2095,110985,"2023-05-01",2023
"23-May",경남,거창군,285,34027,795,35107,"2023-05-01",2023
"23-May",경남,고성군,231,27858,562,28651,"2023-05-01",2023
"23-May",경남,김해시,681,285410,8020,294111,"2023-05-01",2023
"23-May",경남,남해군,295,20874,459,21628,"2023-05-01",2023
"23-May",경남,밀양시,328,58161,3952,62441,"2023-05-01",2023
"23-May",경남,사천시,329,58608,1539,60476,"2023-05-01",2023
"23-May",경남,산청군,251,21290,753,22294,"2023-05-01",2023
"23-May",경남,양산시,437,174163,10713,185313,"2023-05-01",2023
"23-May",경남,의령군,222,15339,765,16326,"2023-05-01",2023
"23-May",경남,진주시,663,172275,6732,179670,"2023-05-01",2023
"23-May",경남,창녕군,247,36546,754,37547,"2023-05-01",2023
"23-May",경남,창원시 마산합포구,353,98959,2870,102182,"2023-05-01",2023
"23-May",경남,창원시 마산회원구,157,103180,5958,109295,"2023-05-01",2023
"23-May",경남,창원시 성산구,620,164830,59887,225337,"2023-05-01",2023
"23-May",경남,창원시 의창구,490,118938,3574,123002,"2023-05-01",2023
"23-May",경남,창원시 진해구,227,96517,2032,98776,"2023-05-01",2023
"23-May",경남,통영시,311,53328,1363,55002,"2023-05-01",2023
"23-May",경남,하동군,232,24506,381,25119,"2023-05-01",2023
"23-May",경남,함안군,220,44370,31057,75647,"2023-05-01",2023
"23-May",경남,함양군,237,20345,425,21007,"2023-05-01",2023
"23-May",경남,합천군,285,24276,640,25201,"2023-05-01",2023
"23-May",경남,계,7462,1762329,145326,1915117,"2023-05-01",2023
"23-May",제주,서귀포시,751,107934,1862,110547,"2023-05-01",2023
"23-May",제주,제주시,1658,310031,275452,587141,"2023-05-01",2023
"23-May",제주,계,2409,417965,277314,697688,"2023-05-01",2023
"23-Jun",서울,강남구,411,228876,22628,251915,"2023-06-01",2023
"23-Jun",서울,강동구,318,144889,8663,153870,"2023-06-01",2023
"23-Jun",서울,강북구,319,70567,4217,75103,"2023-06-01",2023
"23-Jun",서울,강서구,355,189337,16398,206090,"2023-06-01",2023
"23-Jun",서울,관악구,296,112793,5756,118845,"2023-06-01",2023
"23-Jun",서울,광진구,327,91948,5591,97866,"2023-06-01",2023
"23-Jun",서울,구로구,306,134681,13666,148653,"2023-06-01",2023
"23-Jun",서울,금천구,170,85827,6400,92397,"2023-06-01",2023
"23-Jun",서울,노원구,318,143288,8723,152329,"2023-06-01",2023
"23-Jun",서울,도봉구,282,87731,7475,95488,"2023-06-01",2023
"23-Jun",서울,동대문구,308,95305,5012,100625,"2023-06-01",2023
"23-Jun",서울,동작구,300,103667,2698,106665,"2023-06-01",2023
"23-Jun",서울,마포구,334,114563,7767,122664,"2023-06-01",2023
"23-Jun",서울,서대문구,443,85921,5583,91947,"2023-06-01",2023
"23-Jun",서울,서초구,527,165831,10315,176673,"2023-06-01",2023
"23-Jun",서울,성동구,364,93022,11028,104414,"2023-06-01",2023
"23-Jun",서울,성북구,299,117492,5108,122899,"2023-06-01",2023
"23-Jun",서울,송파구,409,230459,14275,245143,"2023-06-01",2023
"23-Jun",서울,양천구,335,142697,8530,151562,"2023-06-01",2023
"23-Jun",서울,영등포구,372,136166,8227,144765,"2023-06-01",2023
"23-Jun",서울,용산구,531,72749,2196,75476,"2023-06-01",2023
"23-Jun",서울,은평구,293,126055,7018,133366,"2023-06-01",2023
"23-Jun",서울,종로구,3646,44430,2590,50666,"2023-06-01",2023
"23-Jun",서울,중구,1349,51680,3409,56438,"2023-06-01",2023
"23-Jun",서울,중랑구,251,106709,9615,116575,"2023-06-01",2023
"23-Jun",서울,계,12863,2976683,202888,3192434,"2023-06-01",2023
"23-Jun",부산,강서구,342,84796,5278,90416,"2023-06-01",2023
"23-Jun",부산,금정구,284,78722,7165,86171,"2023-06-01",2023
"23-Jun",부산,기장군,263,85364,2869,88496,"2023-06-01",2023
"23-Jun",부산,남구,227,91260,9669,101156,"2023-06-01",2023
"23-Jun",부산,동구,189,42520,5647,48356,"2023-06-01",2023
"23-Jun",부산,동래구,169,97766,3537,101472,"2023-06-01",2023
"23-Jun",부산,부산진구,366,128376,21514,150256,"2023-06-01",2023
"23-Jun",부산,북구,246,102698,3718,106662,"2023-06-01",2023
"23-Jun",부산,사상구,284,83046,5426,88756,"2023-06-01",2023
"23-Jun",부산,사하구,274,108563,6030,114867,"2023-06-01",2023
"23-Jun",부산,서구,141,30318,1494,31953,"2023-06-01",2023
"23-Jun",부산,수영구,165,65277,58849,124291,"2023-06-01",2023
"23-Jun",부산,연제구,1005,110230,14445,125680,"2023-06-01",2023
"23-Jun",부산,영도구,227,31600,2075,33902,"2023-06-01",2023
"23-Jun",부산,중구,321,32648,6986,39955,"2023-06-01",2023
"23-Jun",부산,해운대구,330,166087,15486,181903,"2023-06-01",2023
"23-Jun",부산,계,4833,1339271,170188,1514292,"2023-06-01",2023
"23-Jun",대구,남구,370,56216,1592,58178,"2023-06-01",2023
"23-Jun",대구,달서구,508,276999,17261,294768,"2023-06-01",2023
"23-Jun",대구,달성군,590,140930,5275,146795,"2023-06-01",2023
"23-Jun",대구,동구,371,159977,10653,171001,"2023-06-01",2023
"23-Jun",대구,북구,521,204159,7992,212672,"2023-06-01",2023
"23-Jun",대구,서구,266,68672,4873,73811,"2023-06-01",2023
"23-Jun",대구,수성구,591,212785,5069,218445,"2023-06-01",2023
"23-Jun",대구,중구,299,58452,2310,61061,"2023-06-01",2023
"23-Jun",대구,계,3516,1178190,55025,1236731,"2023-06-01",2023
"23-Jun",인천,강화군,336,38262,10905,49503,"2023-06-01",2023
"23-Jun",인천,계양구,307,122480,150041,272828,"2023-06-01",2023
"23-Jun",인천,남동구,903,254029,33677,288609,"2023-06-01",2023
"23-Jun",인천,동구,103,24515,2941,27559,"2023-06-01",2023
"23-Jun",인천,미추홀구,448,162545,9136,172129,"2023-06-01",2023
"23-Jun",인천,부평구,351,230505,41820,272676,"2023-06-01",2023
"23-Jun",인천,서구,500,292952,12451,305903,"2023-06-01",2023
"23-Jun",인천,연수구,446,211735,9525,221706,"2023-06-01",2023
"23-Jun",인천,옹진군,243,13102,269,13614,"2023-06-01",2023
"23-Jun",인천,중구,687,75404,12048,88139,"2023-06-01",2023
"23-Jun",인천,계,4324,1425529,282813,1712666,"2023-06-01",2023
"23-Jun",광주,광산구,546,203332,13337,217215,"2023-06-01",2023
"23-Jun",광주,남구,240,93118,2636,95994,"2023-06-01",2023
"23-Jun",광주,동구,237,46510,1092,47839,"2023-06-01",2023
"23-Jun",광주,북구,616,195760,9202,205578,"2023-06-01",2023
"23-Jun",광주,서구,744,144730,6506,151980,"2023-06-01",2023
"23-Jun",광주,계,2383,683450,32773,718606,"2023-06-01",2023
"23-Jun",대전,대덕구,241,88068,7934,96243,"2023-06-01",2023
"23-Jun",대전,동구,246,92675,4949,97870,"2023-06-01",2023
"23-Jun",대전,서구,814,210576,10965,222355,"2023-06-01",2023
"23-Jun",대전,유성구,658,189749,5803,196210,"2023-06-01",2023
"23-Jun",대전,중구,228,96639,5287,102154,"2023-06-01",2023
"23-Jun",대전,계,2187,677707,34938,714832,"2023-06-01",2023
"23-Jun",울산,남구,743,156943,7119,164805,"2023-06-01",2023
"23-Jun",울산,동구,188,63070,1272,64530,"2023-06-01",2023
"23-Jun",울산,북구,230,121877,3832,125939,"2023-06-01",2023
"23-Jun",울산,울주군,431,129755,7038,137224,"2023-06-01",2023
"23-Jun",울산,중구,331,100424,2549,103304,"2023-06-01",2023
"23-Jun",울산,계,1923,572069,21810,595802,"2023-06-01",2023
"23-Jun",세종,세종특별자치시,918,192412,3630,196960,"2023-06-01",2023
"23-Jun",세종,계,918,192412,3630,196960,"2023-06-01",2023
"23-Jun",경기,가평군,430,32579,612,33621,"2023-06-01",2023
"23-Jun",경기,고양시 덕양구,671,196164,5056,201891,"2023-06-01",2023
"23-Jun",경기,고양시 일산동구,271,128729,6469,135469,"2023-06-01",2023
"23-Jun",경기,고양시 일산서구,132,117282,4537,121951,"2023-06-01",2023
"23-Jun",경기,과천시,699,30668,698,32065,"2023-06-01",2023
"23-Jun",경기,광명시,316,100852,4487,105655,"2023-06-01",2023
"23-Jun",경기,광주시,420,203799,8918,213137,"2023-06-01",2023
"23-Jun",경기,구리시,279,71357,3056,74692,"2023-06-01",2023
"23-Jun",경기,군포시,309,100030,5612,105951,"2023-06-01",2023
"23-Jun",경기,김포시,557,235822,9127,245506,"2023-06-01",2023
"23-Jun",경기,남양주시,809,317853,9679,328341,"2023-06-01",2023
"23-Jun",경기,동두천시,225,38716,1539,40480,"2023-06-01",2023
"23-Jun",경기,부천시,734,297515,13382,311631,"2023-06-01",2023
"23-Jun",경기,성남시 분당구,368,190479,7732,198579,"2023-06-01",2023
"23-Jun",경기,성남시 수정구,308,78219,2716,81243,"2023-06-01",2023
"23-Jun",경기,성남시 중원구,388,75321,4042,79751,"2023-06-01",2023
"23-Jun",경기,수원시 권선구,472,201419,9814,211705,"2023-06-01",2023
"23-Jun",경기,수원시 영통구,411,150096,3591,154098,"2023-06-01",2023
"23-Jun",경기,수원시 장안구,494,105182,3717,109393,"2023-06-01",2023
"23-Jun",경기,수원시 팔달구,367,80277,3247,83891,"2023-06-01",2023
"23-Jun",경기,시흥시,462,266119,8883,275464,"2023-06-01",2023
"23-Jun",경기,안산시 단원구,595,162843,7856,171294,"2023-06-01",2023
"23-Jun",경기,안산시 상록구,150,145701,5957,151808,"2023-06-01",2023
"23-Jun",경기,안성시,406,112393,4701,117500,"2023-06-01",2023
"23-Jun",경기,안양시 동안구,402,123416,7018,130836,"2023-06-01",2023
"23-Jun",경기,안양시 만안구,169,85806,3972,89947,"2023-06-01",2023
"23-Jun",경기,양주시,429,126269,4245,130943,"2023-06-01",2023
"23-Jun",경기,양평군,606,65092,1922,67620,"2023-06-01",2023
"23-Jun",경기,여주시,485,67963,7424,75872,"2023-06-01",2023
"23-Jun",경기,연천군,327,24636,5276,30239,"2023-06-01",2023
"23-Jun",경기,오산시,228,112218,4150,116596,"2023-06-01",2023
"23-Jun",경기,용인시 기흥구,124,194746,7263,202133,"2023-06-01",2023
"23-Jun",경기,용인시 수지구,60,150898,2364,153322,"2023-06-01",2023
"23-Jun",경기,용인시 처인구,855,140941,8173,149969,"2023-06-01",2023
"23-Jun",경기,의왕시,312,66205,2907,69424,"2023-06-01",2023
"23-Jun",경기,의정부시,754,173103,5718,179575,"2023-06-01",2023
"23-Jun",경기,이천시,430,122511,6492,129433,"2023-06-01",2023
"23-Jun",경기,파주시,566,240001,11696,252263,"2023-06-01",2023
"23-Jun",경기,평택시,796,322968,14038,337802,"2023-06-01",2023
"23-Jun",경기,포천시,439,89448,8204,98091,"2023-06-01",2023
"23-Jun",경기,하남시,449,139089,3776,143314,"2023-06-01",2023
"23-Jun",경기,화성시,967,503914,14046,518927,"2023-06-01",2023
"23-Jun",경기,계,18671,6188639,254112,6461422,"2023-06-01",2023
"23-Jun",강원,강릉시,597,113537,4785,118919,"2023-06-01",2023
"23-Jun",강원,고성군,200,16000,234,16434,"2023-06-01",2023
"23-Jun",강원,동해시,327,47576,1546,49449,"2023-06-01",2023
"23-Jun",강원,삼척시,415,33623,815,34853,"2023-06-01",2023
"23-Jun",강원,속초시,312,40710,1476,42498,"2023-06-01",2023
"23-Jun",강원,양구군,219,12510,149,12878,"2023-06-01",2023
"23-Jun",강원,양양군,208,16871,316,17395,"2023-06-01",2023
"23-Jun",강원,영월군,350,21872,390,22612,"2023-06-01",2023
"23-Jun",강원,원주시,642,188222,5909,194773,"2023-06-01",2023
"23-Jun",강원,인제군,231,19833,291,20355,"2023-06-01",2023
"23-Jun",강원,정선군,363,21179,488,22030,"2023-06-01",2023
"23-Jun",강원,철원군,266,24778,336,25380,"2023-06-01",2023
"23-Jun",강원,춘천시,873,142049,6338,149260,"2023-06-01",2023
"23-Jun",강원,태백시,241,20129,705,21075,"2023-06-01",2023
"23-Jun",강원,평창군,329,26823,664,27816,"2023-06-01",2023
"23-Jun",강원,홍천군,430,40760,1042,42232,"2023-06-01",2023
"23-Jun",강원,화천군,237,13329,185,13751,"2023-06-01",2023
"23-Jun",강원,횡성군,286,28464,901,29651,"2023-06-01",2023
"23-Jun",강원,계,6526,828265,26570,861361,"2023-06-01",2023
"23-Jun",충북,괴산군,221,24027,459,24707,"2023-06-01",2023
"23-Jun",충북,단양군,238,16202,830,17270,"2023-06-01",2023
"23-Jun",충북,보은군,246,18917,959,20122,"2023-06-01",2023
"23-Jun",충북,영동군,266,26138,433,26837,"2023-06-01",2023
"23-Jun",충북,옥천군,212,28650,1127,29989,"2023-06-01",2023
"23-Jun",충북,음성군,275,62397,2027,64699,"2023-06-01",2023
"23-Jun",충북,제천시,336,69644,3465,73445,"2023-06-01",2023
"23-Jun",충북,증평군,93,20704,812,21609,"2023-06-01",2023
"23-Jun",충북,진천군,224,54104,1461,55789,"2023-06-01",2023
"23-Jun",충북,청원군,1,19,0,20,"2023-06-01",2023
"23-Jun",충북,청주시 상당구,512,100137,2640,103289,"2023-06-01",2023
"23-Jun",충북,청주시 서원구,246,101121,4669,106036,"2023-06-01",2023
"23-Jun",충북,청주시 청원구,397,108074,4831,113302,"2023-06-01",2023
"23-Jun",충북,청주시 흥덕구,373,139300,7908,147581,"2023-06-01",2023
"23-Jun",충북,충주시,643,115891,8393,124927,"2023-06-01",2023
"23-Jun",충북,계,4283,885325,40014,929622,"2023-06-01",2023
"23-Jun",충남,계룡시,172,25239,589,26000,"2023-06-01",2023
"23-Jun",충남,공주시,594,56230,2693,59517,"2023-06-01",2023
"23-Jun",충남,금산군,209,29848,2292,32349,"2023-06-01",2023
"23-Jun",충남,논산시,416,62651,2413,65480,"2023-06-01",2023
"23-Jun",충남,당진시,415,103582,4028,108025,"2023-06-01",2023
"23-Jun",충남,보령시,424,54230,1411,56065,"2023-06-01",2023
"23-Jun",충남,부여군,314,35240,1125,36679,"2023-06-01",2023
"23-Jun",충남,서산시,442,101379,3723,105544,"2023-06-01",2023
"23-Jun",충남,서천군,241,27805,787,28833,"2023-06-01",2023
"23-Jun",충남,아산시,551,188736,7393,196680,"2023-06-01",2023
"23-Jun",충남,예산군,456,46702,1438,48596,"2023-06-01",2023
"23-Jun",충남,천안시 동남구,304,138895,5567,144766,"2023-06-01",2023
"23-Jun",충남,천안시 서북구,559,205191,5434,211184,"2023-06-01",2023
"23-Jun",충남,청양군,267,17665,723,18655,"2023-06-01",2023
"23-Jun",충남,태안군,334,35914,552,36800,"2023-06-01",2023
"23-Jun",충남,홍성군,405,54360,1464,56229,"2023-06-01",2023
"23-Jun",충남,계,6103,1183667,41632,1231402,"2023-06-01",2023
"23-Jun",전북,고창군,336,31541,572,32449,"2023-06-01",2023
"23-Jun",전북,군산시,555,136377,6466,143398,"2023-06-01",2023
"23-Jun",전북,김제시,321,48310,1980,50611,"2023-06-01",2023
"23-Jun",전북,남원시,427,42679,1546,44652,"2023-06-01",2023
"23-Jun",전북,무주군,193,13587,408,14188,"2023-06-01",2023
"23-Jun",전북,부안군,272,28398,614,29284,"2023-06-01",2023
"23-Jun",전북,순창군,232,15465,158,15855,"2023-06-01",2023
"23-Jun",전북,완주군,427,57041,3185,60653,"2023-06-01",2023
"23-Jun",전북,익산시,549,140341,5805,146695,"2023-06-01",2023
"23-Jun",전북,임실군,234,14953,427,15614,"2023-06-01",2023
"23-Jun",전북,장수군,261,12604,162,13027,"2023-06-01",2023
"23-Jun",전북,전주시 덕진구,384,175926,7157,183467,"2023-06-01",2023
"23-Jun",전북,전주시 완산구,768,155665,4185,160618,"2023-06-01",2023
"23-Jun",전북,정읍시,387,57089,3705,61181,"2023-06-01",2023
"23-Jun",전북,진안군,278,14804,250,15332,"2023-06-01",2023
"23-Jun",전북,계,5624,944780,36620,987024,"2023-06-01",2023
"23-Jun",전남,강진군,257,19310,1035,20602,"2023-06-01",2023
"23-Jun",전남,고흥군,314,33812,584,34710,"2023-06-01",2023
"23-Jun",전남,곡성군,171,15726,649,16546,"2023-06-01",2023
"23-Jun",전남,광양시,259,90453,6231,96943,"2023-06-01",2023
"23-Jun",전남,구례군,150,13489,747,14386,"2023-06-01",2023
"23-Jun",전남,나주시,483,68964,3217,72664,"2023-06-01",2023
"23-Jun",전남,담양군,235,28634,1721,30590,"2023-06-01",2023
"23-Jun",전남,목포시,424,97651,5470,103545,"2023-06-01",2023
"23-Jun",전남,무안군,605,51796,1162,53563,"2023-06-01",2023
"23-Jun",전남,보성군,238,22412,628,23278,"2023-06-01",2023
"23-Jun",전남,순천시,533,146915,5357,152805,"2023-06-01",2023
"23-Jun",전남,신안군,358,23266,101436,125060,"2023-06-01",2023
"23-Jun",전남,여수시,564,136843,7356,144763,"2023-06-01",2023
"23-Jun",전남,영광군,237,29658,792,30687,"2023-06-01",2023
"23-Jun",전남,영암군,276,36184,1192,37652,"2023-06-01",2023
"23-Jun",전남,완도군,312,26414,508,27234,"2023-06-01",2023
"23-Jun",전남,장성군,216,27883,1337,29436,"2023-06-01",2023
"23-Jun",전남,장흥군,273,20607,448,21328,"2023-06-01",2023
"23-Jun",전남,진도군,217,17680,302,18199,"2023-06-01",2023
"23-Jun",전남,함평군,216,19016,16347,35579,"2023-06-01",2023
"23-Jun",전남,해남군,333,41030,75893,117256,"2023-06-01",2023
"23-Jun",전남,화순군,253,34432,2128,36813,"2023-06-01",2023
"23-Jun",전남,계,6924,1002175,234540,1243639,"2023-06-01",2023
"23-Jun",경북,경산시,360,142838,4377,147575,"2023-06-01",2023
"23-Jun",경북,경주시,624,146837,4593,152054,"2023-06-01",2023
"23-Jun",경북,고령군,181,21211,723,22115,"2023-06-01",2023
"23-Jun",경북,구미시,562,219403,7315,227280,"2023-06-01",2023
"23-Jun",경북,군위군,130,15790,304,16224,"2023-06-01",2023
"23-Jun",경북,김천시,406,78196,2081,80683,"2023-06-01",2023
"23-Jun",경북,문경시,296,38601,895,39792,"2023-06-01",2023
"23-Jun",경북,봉화군,251,18619,202,19072,"2023-06-01",2023
"23-Jun",경북,상주시,399,55413,1884,57696,"2023-06-01",2023
"23-Jun",경북,성주군,212,32038,1343,33593,"2023-06-01",2023
"23-Jun",경북,안동시,762,84864,2716,88342,"2023-06-01",2023
"23-Jun",경북,영덕군,254,19458,307,20019,"2023-06-01",2023
"23-Jun",경북,영양군,149,10110,116,10375,"2023-06-01",2023
"23-Jun",경북,영주시,370,57259,1498,59127,"2023-06-01",2023
"23-Jun",경북,영천시,370,62739,2510,65619,"2023-06-01",2023
"23-Jun",경북,예천군,292,31855,494,32641,"2023-06-01",2023
"23-Jun",경북,울릉군,160,5869,609,6638,"2023-06-01",2023
"23-Jun",경북,울진군,331,27276,342,27949,"2023-06-01",2023
"23-Jun",경북,의성군,326,32451,1119,33896,"2023-06-01",2023
"23-Jun",경북,청도군,219,26184,962,27365,"2023-06-01",2023
"23-Jun",경북,청송군,226,16282,213,16721,"2023-06-01",2023
"23-Jun",경북,칠곡군,315,71083,2502,73900,"2023-06-01",2023
"23-Jun",경북,포항시 남구,443,125395,8370,134208,"2023-06-01",2023
"23-Jun",경북,포항시 북구,381,144198,3618,148197,"2023-06-01",2023
"23-Jun",경북,계,8019,1483969,49093,1541081,"2023-06-01",2023
"23-Jun",경남,거제시,367,108695,2098,111160,"2023-06-01",2023
"23-Jun",경남,거창군,293,34144,792,35229,"2023-06-01",2023
"23-Jun",경남,고성군,231,27890,561,28682,"2023-06-01",2023
"23-Jun",경남,김해시,691,285920,8133,294744,"2023-06-01",2023
"23-Jun",경남,남해군,299,20901,456,21656,"2023-06-01",2023
"23-Jun",경남,밀양시,330,58260,3955,62545,"2023-06-01",2023
"23-Jun",경남,사천시,336,58725,1538,60599,"2023-06-01",2023
"23-Jun",경남,산청군,254,21314,756,22324,"2023-06-01",2023
"23-Jun",경남,양산시,438,174981,10700,186119,"2023-06-01",2023
"23-Jun",경남,의령군,227,15384,768,16379,"2023-06-01",2023
"23-Jun",경남,진주시,663,172544,6728,179935,"2023-06-01",2023
"23-Jun",경남,창녕군,256,36559,753,37568,"2023-06-01",2023
"23-Jun",경남,창원시 마산합포구,355,99340,2868,102563,"2023-06-01",2023
"23-Jun",경남,창원시 마산회원구,159,103801,6062,110022,"2023-06-01",2023
"23-Jun",경남,창원시 성산구,624,165931,60097,226652,"2023-06-01",2023
"23-Jun",경남,창원시 의창구,501,119348,3585,123434,"2023-06-01",2023
"23-Jun",경남,창원시 진해구,229,96618,2039,98886,"2023-06-01",2023
"23-Jun",경남,통영시,312,53415,1363,55090,"2023-06-01",2023
"23-Jun",경남,하동군,239,24513,384,25136,"2023-06-01",2023
"23-Jun",경남,함안군,224,44255,33059,77538,"2023-06-01",2023
"23-Jun",경남,함양군,241,20292,424,20957,"2023-06-01",2023
"23-Jun",경남,합천군,288,24308,640,25236,"2023-06-01",2023
"23-Jun",경남,계,7557,1767138,147759,1922454,"2023-06-01",2023
"23-Jun",제주,서귀포시,750,107912,1867,110529,"2023-06-01",2023
"23-Jun",제주,제주시,1677,309140,275527,586344,"2023-06-01",2023
"23-Jun",제주,계,2427,417052,277394,696873,"2023-06-01",2023
"23-Jul",서울,강남구,415,229284,22458,252157,"2023-07-01",2023
"23-Jul",서울,강동구,313,144811,8636,153760,"2023-07-01",2023
"23-Jul",서울,강북구,319,70581,4219,75119,"2023-07-01",2023
"23-Jul",서울,강서구,357,189142,16441,205940,"2023-07-01",2023
"23-Jul",서울,관악구,297,112879,5791,118967,"2023-07-01",2023
"23-Jul",서울,광진구,330,92073,5483,97886,"2023-07-01",2023
"23-Jul",서울,구로구,309,134743,13618,148670,"2023-07-01",2023
"23-Jul",서울,금천구,172,85856,6402,92430,"2023-07-01",2023
"23-Jul",서울,노원구,318,143420,8727,152465,"2023-07-01",2023
"23-Jul",서울,도봉구,282,87661,7501,95444,"2023-07-01",2023
"23-Jul",서울,동대문구,308,95624,5123,101055,"2023-07-01",2023
"23-Jul",서울,동작구,298,103777,2687,106762,"2023-07-01",2023
"23-Jul",서울,마포구,333,114481,7772,122586,"2023-07-01",2023
"23-Jul",서울,서대문구,446,85951,5552,91949,"2023-07-01",2023
"23-Jul",서울,서초구,518,165928,9743,176189,"2023-07-01",2023
"23-Jul",서울,성동구,367,92960,10961,104288,"2023-07-01",2023
"23-Jul",서울,성북구,298,117466,5098,122862,"2023-07-01",2023
"23-Jul",서울,송파구,409,230236,14295,244940,"2023-07-01",2023
"23-Jul",서울,양천구,334,142667,8530,151531,"2023-07-01",2023
"23-Jul",서울,영등포구,373,136280,8171,144824,"2023-07-01",2023
"23-Jul",서울,용산구,528,72713,2199,75440,"2023-07-01",2023
"23-Jul",서울,은평구,293,126315,7020,133628,"2023-07-01",2023
"23-Jul",서울,종로구,3583,44693,2524,50800,"2023-07-01",2023
"23-Jul",서울,중구,1363,51445,3372,56180,"2023-07-01",2023
"23-Jul",서울,중랑구,251,106668,9623,116542,"2023-07-01",2023
"23-Jul",서울,계,12814,2977654,201946,3192414,"2023-07-01",2023
"23-Jul",부산,강서구,347,84876,5259,90482,"2023-07-01",2023
"23-Jul",부산,금정구,283,78572,7136,85991,"2023-07-01",2023
"23-Jul",부산,기장군,264,85683,2875,88822,"2023-07-01",2023
"23-Jul",부산,남구,229,91190,9654,101073,"2023-07-01",2023
"23-Jul",부산,동구,187,43022,5653,48862,"2023-07-01",2023
"23-Jul",부산,동래구,169,97810,3536,101515,"2023-07-01",2023
"23-Jul",부산,부산진구,363,128541,21814,150718,"2023-07-01",2023
"23-Jul",부산,북구,276,102770,3706,106752,"2023-07-01",2023
"23-Jul",부산,사상구,292,83134,5479,88905,"2023-07-01",2023
"23-Jul",부산,사하구,272,108317,6037,114626,"2023-07-01",2023
"23-Jul",부산,서구,139,30312,1508,31959,"2023-07-01",2023
"23-Jul",부산,수영구,165,65231,59239,124635,"2023-07-01",2023
"23-Jul",부산,연제구,1008,110400,14832,126240,"2023-07-01",2023
"23-Jul",부산,영도구,227,31800,2077,34104,"2023-07-01",2023
"23-Jul",부산,중구,317,32747,7016,40080,"2023-07-01",2023
"23-Jul",부산,해운대구,330,166137,15212,181679,"2023-07-01",2023
"23-Jul",부산,계,4868,1340542,171033,1516443,"2023-07-01",2023
"23-Jul",대구,군위군,129,15660,92,15881,"2023-07-01",2023
"23-Jul",대구,남구,387,56091,1589,58067,"2023-07-01",2023
"23-Jul",대구,달서구,490,276812,17479,294781,"2023-07-01",2023
"23-Jul",대구,달성군,593,141015,5323,146931,"2023-07-01",2023
"23-Jul",대구,동구,371,160284,10590,171245,"2023-07-01",2023
"23-Jul",대구,북구,531,204021,8128,212680,"2023-07-01",2023
"23-Jul",대구,서구,265,68484,4794,73543,"2023-07-01",2023
"23-Jul",대구,수성구,593,212611,5163,218367,"2023-07-01",2023
"23-Jul",대구,중구,301,58844,2199,61344,"2023-07-01",2023
"23-Jul",대구,계,3660,1193822,55357,1252839,"2023-07-01",2023
"23-Jul",인천,강화군,340,38373,16813,55526,"2023-07-01",2023
"23-Jul",인천,계양구,304,122292,149769,272365,"2023-07-01",2023
"23-Jul",인천,남동구,907,254293,33244,288444,"2023-07-01",2023
"23-Jul",인천,동구,103,24506,2936,27545,"2023-07-01",2023
"23-Jul",인천,미추홀구,446,163185,9176,172807,"2023-07-01",2023
"23-Jul",인천,부평구,351,230445,42234,273030,"2023-07-01",2023
"23-Jul",인천,서구,503,295270,12548,308321,"2023-07-01",2023
"23-Jul",인천,연수구,446,212498,9544,222488,"2023-07-01",2023
"23-Jul",인천,옹진군,244,13152,272,13668,"2023-07-01",2023
"23-Jul",인천,중구,659,75588,12062,88309,"2023-07-01",2023
"23-Jul",인천,계,4303,1429602,288598,1722503,"2023-07-01",2023
"23-Jul",광주,광산구,565,203568,13329,217462,"2023-07-01",2023
"23-Jul",광주,남구,239,93179,2890,96308,"2023-07-01",2023
"23-Jul",광주,동구,239,46628,1077,47944,"2023-07-01",2023
"23-Jul",광주,북구,623,195993,9222,205838,"2023-07-01",2023
"23-Jul",광주,서구,731,144707,6261,151699,"2023-07-01",2023
"23-Jul",광주,계,2397,684075,32779,719251,"2023-07-01",2023
"23-Jul",대전,대덕구,241,88234,7958,96433,"2023-07-01",2023
"23-Jul",대전,동구,245,92707,4957,97909,"2023-07-01",2023
"23-Jul",대전,서구,831,210734,11728,223293,"2023-07-01",2023
"23-Jul",대전,유성구,658,190338,5891,196887,"2023-07-01",2023
"23-Jul",대전,중구,228,96804,5304,102336,"2023-07-01",2023
"23-Jul",대전,계,2203,678817,35838,716858,"2023-07-01",2023
"23-Jul",울산,남구,738,157196,7156,165090,"2023-07-01",2023
"23-Jul",울산,동구,190,63429,1261,64880,"2023-07-01",2023
"23-Jul",울산,북구,229,121762,3818,125809,"2023-07-01",2023
"23-Jul",울산,울주군,434,129910,7052,137396,"2023-07-01",2023
"23-Jul",울산,중구,336,100336,2556,103228,"2023-07-01",2023
"23-Jul",울산,계,1927,572633,21843,596403,"2023-07-01",2023
"23-Jul",세종,세종특별자치시,915,192679,3625,197219,"2023-07-01",2023
"23-Jul",세종,계,915,192679,3625,197219,"2023-07-01",2023
"23-Jul",경기,가평군,431,32603,602,33636,"2023-07-01",2023
"23-Jul",경기,고양시 덕양구,672,196450,5040,202162,"2023-07-01",2023
"23-Jul",경기,고양시 일산동구,268,128828,6483,135579,"2023-07-01",2023
"23-Jul",경기,고양시 일산서구,132,117467,4512,122111,"2023-07-01",2023
"23-Jul",경기,과천시,703,31020,702,32425,"2023-07-01",2023
"23-Jul",경기,광명시,315,100616,4619,105550,"2023-07-01",2023
"23-Jul",경기,광주시,423,204068,8916,213407,"2023-07-01",2023
"23-Jul",경기,구리시,273,71490,3048,74811,"2023-07-01",2023
"23-Jul",경기,군포시,304,100083,5646,106033,"2023-07-01",2023
"23-Jul",경기,김포시,561,236270,9175,246006,"2023-07-01",2023
"23-Jul",경기,남양주시,817,318010,9662,328489,"2023-07-01",2023
"23-Jul",경기,동두천시,225,38650,1536,40411,"2023-07-01",2023
"23-Jul",경기,부천시,729,297435,13415,311579,"2023-07-01",2023
"23-Jul",경기,성남시 분당구,367,190051,7797,198215,"2023-07-01",2023
"23-Jul",경기,성남시 수정구,309,78251,2717,81277,"2023-07-01",2023
"23-Jul",경기,성남시 중원구,388,75310,4054,79752,"2023-07-01",2023
"23-Jul",경기,수원시 권선구,471,202204,9845,212520,"2023-07-01",2023
"23-Jul",경기,수원시 영통구,409,150697,3595,154701,"2023-07-01",2023
"23-Jul",경기,수원시 장안구,497,105386,3717,109600,"2023-07-01",2023
"23-Jul",경기,수원시 팔달구,366,80081,3252,83699,"2023-07-01",2023
"23-Jul",경기,시흥시,460,266474,8937,275871,"2023-07-01",2023
"23-Jul",경기,안산시 단원구,594,162965,7915,171474,"2023-07-01",2023
"23-Jul",경기,안산시 상록구,150,145807,5955,151912,"2023-07-01",2023
"23-Jul",경기,안성시,402,112728,4724,117854,"2023-07-01",2023
"23-Jul",경기,안양시 동안구,408,123447,6950,130805,"2023-07-01",2023
"23-Jul",경기,안양시 만안구,159,85857,4009,90025,"2023-07-01",2023
"23-Jul",경기,양주시,434,127599,4288,132321,"2023-07-01",2023
"23-Jul",경기,양평군,603,65223,1915,67741,"2023-07-01",2023
"23-Jul",경기,여주시,486,68165,7445,76096,"2023-07-01",2023
"23-Jul",경기,연천군,326,24703,5251,30280,"2023-07-01",2023
"23-Jul",경기,오산시,229,112572,4178,116979,"2023-07-01",2023
"23-Jul",경기,용인시 기흥구,122,195132,7438,202692,"2023-07-01",2023
"23-Jul",경기,용인시 수지구,60,150977,2371,153408,"2023-07-01",2023
"23-Jul",경기,용인시 처인구,851,141230,7908,149989,"2023-07-01",2023
"23-Jul",경기,의왕시,313,66104,2901,69318,"2023-07-01",2023
"23-Jul",경기,의정부시,753,173594,5739,180086,"2023-07-01",2023
"23-Jul",경기,이천시,432,122955,6470,129857,"2023-07-01",2023
"23-Jul",경기,파주시,561,240381,11645,252587,"2023-07-01",2023
"23-Jul",경기,평택시,798,324055,14098,338951,"2023-07-01",2023
"23-Jul",경기,포천시,427,89578,7996,98001,"2023-07-01",2023
"23-Jul",경기,하남시,447,139582,3755,143784,"2023-07-01",2023
"23-Jul",경기,화성시,969,505692,14102,520763,"2023-07-01",2023
"23-Jul",경기,계,18644,6199790,254323,6472757,"2023-07-01",2023
"23-Jul",충북,괴산군,220,23986,463,24669,"2023-07-01",2023
"23-Jul",충북,단양군,242,16212,843,17297,"2023-07-01",2023
"23-Jul",충북,보은군,249,18924,958,20131,"2023-07-01",2023
"23-Jul",충북,영동군,273,26167,431,26871,"2023-07-01",2023
"23-Jul",충북,옥천군,215,28709,1107,30031,"2023-07-01",2023
"23-Jul",충북,음성군,279,62504,2030,64813,"2023-07-01",2023
"23-Jul",충북,제천시,341,69705,3471,73517,"2023-07-01",2023
"23-Jul",충북,증평군,95,20764,816,21675,"2023-07-01",2023
"23-Jul",충북,진천군,224,54158,1480,55862,"2023-07-01",2023
"23-Jul",충북,청원군,1,19,0,20,"2023-07-01",2023
"23-Jul",충북,청주시 상당구,511,100388,2646,103545,"2023-07-01",2023
"23-Jul",충북,청주시 서원구,244,100828,4665,105737,"2023-07-01",2023
"23-Jul",충북,청주시 청원구,406,108092,4815,113313,"2023-07-01",2023
"23-Jul",충북,청주시 흥덕구,368,140050,7928,148346,"2023-07-01",2023
"23-Jul",충북,충주시,645,116139,8269,125053,"2023-07-01",2023
"23-Jul",충북,계,4313,886645,39922,930880,"2023-07-01",2023
"23-Jul",충남,계룡시,172,25303,590,26065,"2023-07-01",2023
"23-Jul",충남,공주시,594,56207,2705,59506,"2023-07-01",2023
"23-Jul",충남,금산군,209,29941,2307,32457,"2023-07-01",2023
"23-Jul",충남,논산시,416,62712,2411,65539,"2023-07-01",2023
"23-Jul",충남,당진시,418,103929,4058,108405,"2023-07-01",2023
"23-Jul",충남,보령시,423,54283,1422,56128,"2023-07-01",2023
"23-Jul",충남,부여군,316,35291,972,36579,"2023-07-01",2023
"23-Jul",충남,서산시,442,101598,3732,105772,"2023-07-01",2023
"23-Jul",충남,서천군,240,27773,788,28801,"2023-07-01",2023
"23-Jul",충남,아산시,547,189674,7340,197561,"2023-07-01",2023
"23-Jul",충남,예산군,457,46844,1441,48742,"2023-07-01",2023
"23-Jul",충남,천안시 동남구,304,138980,5569,144853,"2023-07-01",2023
"23-Jul",충남,천안시 서북구,552,205565,5483,211600,"2023-07-01",2023
"23-Jul",충남,청양군,263,17718,722,18703,"2023-07-01",2023
"23-Jul",충남,태안군,332,35957,552,36841,"2023-07-01",2023
"23-Jul",충남,홍성군,401,54400,1467,56268,"2023-07-01",2023
"23-Jul",충남,계,6086,1186175,41559,1233820,"2023-07-01",2023
"23-Jul",전북,고창군,339,31579,574,32492,"2023-07-01",2023
"23-Jul",전북,군산시,557,136690,6477,143724,"2023-07-01",2023
"23-Jul",전북,김제시,322,48376,1975,50673,"2023-07-01",2023
"23-Jul",전북,남원시,426,42733,1453,44612,"2023-07-01",2023
"23-Jul",전북,무주군,218,13619,408,14245,"2023-07-01",2023
"23-Jul",전북,부안군,274,28458,611,29343,"2023-07-01",2023
"23-Jul",전북,순창군,232,15474,158,15864,"2023-07-01",2023
"23-Jul",전북,완주군,438,57732,3192,61362,"2023-07-01",2023
"23-Jul",전북,익산시,552,140415,5837,146804,"2023-07-01",2023
"23-Jul",전북,임실군,258,14985,428,15671,"2023-07-01",2023
"23-Jul",전북,장수군,237,12601,164,13002,"2023-07-01",2023
"23-Jul",전북,전주시 덕진구,384,175920,7156,183460,"2023-07-01",2023
"23-Jul",전북,전주시 완산구,750,155640,4201,160591,"2023-07-01",2023
"23-Jul",전북,정읍시,392,57178,3627,61197,"2023-07-01",2023
"23-Jul",전북,진안군,281,14876,247,15404,"2023-07-01",2023
"23-Jul",전북,계,5660,946276,36508,988444,"2023-07-01",2023
"23-Jul",전남,강진군,256,19322,1039,20617,"2023-07-01",2023
"23-Jul",전남,고흥군,314,33852,589,34755,"2023-07-01",2023
"23-Jul",전남,곡성군,171,15738,649,16558,"2023-07-01",2023
"23-Jul",전남,광양시,263,90763,6202,97228,"2023-07-01",2023
"23-Jul",전남,구례군,149,13505,748,14402,"2023-07-01",2023
"23-Jul",전남,나주시,485,69065,3225,72775,"2023-07-01",2023
"23-Jul",전남,담양군,232,28670,1747,30649,"2023-07-01",2023
"23-Jul",전남,목포시,421,97889,5450,103760,"2023-07-01",2023
"23-Jul",전남,무안군,606,51851,1158,53615,"2023-07-01",2023
"23-Jul",전남,보성군,237,22429,629,23295,"2023-07-01",2023
"23-Jul",전남,순천시,530,147287,5365,153182,"2023-07-01",2023
"23-Jul",전남,신안군,360,23346,95540,119246,"2023-07-01",2023
"23-Jul",전남,여수시,567,136919,7349,144835,"2023-07-01",2023
"23-Jul",전남,영광군,235,29622,788,30645,"2023-07-01",2023
"23-Jul",전남,영암군,272,36287,1175,37734,"2023-07-01",2023
"23-Jul",전남,완도군,304,26409,505,27218,"2023-07-01",2023
"23-Jul",전남,장성군,216,27830,1339,29385,"2023-07-01",2023
"23-Jul",전남,장흥군,280,20632,448,21360,"2023-07-01",2023
"23-Jul",전남,진도군,218,17708,302,18228,"2023-07-01",2023
"23-Jul",전남,함평군,215,19055,15080,34350,"2023-07-01",2023
"23-Jul",전남,해남군,336,41103,76872,118311,"2023-07-01",2023
"23-Jul",전남,화순군,249,34440,2181,36870,"2023-07-01",2023
"23-Jul",전남,계,6916,1003722,228380,1239018,"2023-07-01",2023
"23-Jul",경북,경산시,361,143062,4381,147804,"2023-07-01",2023
"23-Jul",경북,경주시,619,147382,4589,152590,"2023-07-01",2023
"23-Jul",경북,고령군,184,21244,725,22153,"2023-07-01",2023
"23-Jul",경북,구미시,566,219690,7387,227643,"2023-07-01",2023
"23-Jul",경북,군위군,1,129,216,346,"2023-07-01",2023
"23-Jul",경북,김천시,405,78267,2089,80761,"2023-07-01",2023
"23-Jul",경북,문경시,296,38642,896,39834,"2023-07-01",2023
"23-Jul",경북,봉화군,255,18672,196,19123,"2023-07-01",2023
"23-Jul",경북,상주시,401,55544,1886,57831,"2023-07-01",2023
"23-Jul",경북,성주군,212,32102,1341,33655,"2023-07-01",2023
"23-Jul",경북,안동시,768,84998,2668,88434,"2023-07-01",2023
"23-Jul",경북,영덕군,256,19504,307,20067,"2023-07-01",2023
"23-Jul",경북,영양군,147,10102,116,10365,"2023-07-01",2023
"23-Jul",경북,영주시,372,57259,1496,59127,"2023-07-01",2023
"23-Jul",경북,영천시,369,62836,2498,65703,"2023-07-01",2023
"23-Jul",경북,예천군,299,31906,494,32699,"2023-07-01",2023
"23-Jul",경북,울릉군,159,5922,605,6686,"2023-07-01",2023
"23-Jul",경북,울진군,336,27348,344,28028,"2023-07-01",2023
"23-Jul",경북,의성군,328,32556,1110,33994,"2023-07-01",2023
"23-Jul",경북,청도군,222,26236,963,27421,"2023-07-01",2023
"23-Jul",경북,청송군,225,16274,215,16714,"2023-07-01",2023
"23-Jul",경북,칠곡군,314,71210,2491,74015,"2023-07-01",2023
"23-Jul",경북,포항시 남구,446,125797,8369,134612,"2023-07-01",2023
"23-Jul",경북,포항시 북구,386,144330,3611,148327,"2023-07-01",2023
"23-Jul",경북,계,7927,1471012,48993,1527932,"2023-07-01",2023
"23-Jul",경남,거제시,357,108899,2090,111346,"2023-07-01",2023
"23-Jul",경남,거창군,292,34261,795,35348,"2023-07-01",2023
"23-Jul",경남,고성군,230,27917,567,28714,"2023-07-01",2023
"23-Jul",경남,김해시,694,286666,8159,295519,"2023-07-01",2023
"23-Jul",경남,남해군,298,20863,449,21610,"2023-07-01",2023
"23-Jul",경남,밀양시,327,58281,3941,62549,"2023-07-01",2023
"23-Jul",경남,사천시,332,58839,1538,60709,"2023-07-01",2023
"23-Jul",경남,산청군,249,21264,754,22267,"2023-07-01",2023
"23-Jul",경남,양산시,435,175285,10682,186402,"2023-07-01",2023
"23-Jul",경남,의령군,225,15365,765,16355,"2023-07-01",2023
"23-Jul",경남,진주시,665,172744,6731,180140,"2023-07-01",2023
"23-Jul",경남,창녕군,257,36506,757,37520,"2023-07-01",2023
"23-Jul",경남,창원시 마산합포구,353,99436,2875,102664,"2023-07-01",2023
"23-Jul",경남,창원시 마산회원구,155,104224,6053,110432,"2023-07-01",2023
"23-Jul",경남,창원시 성산구,618,166862,60327,227807,"2023-07-01",2023
"23-Jul",경남,창원시 의창구,502,119447,3583,123532,"2023-07-01",2023
"23-Jul",경남,창원시 진해구,229,96737,2052,99018,"2023-07-01",2023
"23-Jul",경남,통영시,312,53484,1368,55164,"2023-07-01",2023
"23-Jul",경남,하동군,237,24504,386,25127,"2023-07-01",2023
"23-Jul",경남,함안군,224,44246,34657,79127,"2023-07-01",2023
"23-Jul",경남,함양군,241,20307,422,20970,"2023-07-01",2023
"23-Jul",경남,합천군,287,24321,641,25249,"2023-07-01",2023
"23-Jul",경남,계,7519,1770458,149592,1927569,"2023-07-01",2023
"23-Jul",제주,서귀포시,773,107818,1868,110459,"2023-07-01",2023
"23-Jul",제주,제주시,1693,309842,276468,588003,"2023-07-01",2023
"23-Jul",제주,계,2466,417660,278336,698462,"2023-07-01",2023
"23-Jul",강원,강릉시,593,113645,4768,119006,"2023-07-01",2023
"23-Jul",강원,고성군,203,16100,235,16538,"2023-07-01",2023
"23-Jul",강원,동해시,331,47676,1545,49552,"2023-07-01",2023
"23-Jul",강원,삼척시,415,33643,821,34879,"2023-07-01",2023
"23-Jul",강원,속초시,314,40762,1482,42558,"2023-07-01",2023
"23-Jul",강원,양구군,220,12522,145,12887,"2023-07-01",2023
"23-Jul",강원,양양군,213,16910,320,17443,"2023-07-01",2023
"23-Jul",강원,영월군,346,21906,401,22653,"2023-07-01",2023
"23-Jul",강원,원주시,646,188586,5919,195151,"2023-07-01",2023
"23-Jul",강원,인제군,236,19853,290,20379,"2023-07-01",2023
"23-Jul",강원,정선군,363,21158,487,22008,"2023-07-01",2023
"23-Jul",강원,철원군,267,24793,336,25396,"2023-07-01",2023
"23-Jul",강원,춘천시,873,142235,6331,149439,"2023-07-01",2023
"23-Jul",강원,태백시,246,20152,699,21097,"2023-07-01",2023
"23-Jul",강원,평창군,325,26893,566,27784,"2023-07-01",2023
"23-Jul",강원,홍천군,430,40830,1042,42302,"2023-07-01",2023
"23-Jul",강원,화천군,237,13334,185,13756,"2023-07-01",2023
"23-Jul",강원,횡성군,279,28517,900,29696,"2023-07-01",2023
"23-Jul",강원,계,6537,829515,26472,862524,"2023-07-01",2023
"23-Aug",서울,강남구,418,229735,22287,252440,"2023-08-01",2023
"23-Aug",서울,강동구,313,144734,8629,153676,"2023-08-01",2023
"23-Aug",서울,강북구,314,70449,4229,74992,"2023-08-01",2023
"23-Aug",서울,강서구,360,188645,16420,205425,"2023-08-01",2023
"23-Aug",서울,관악구,297,112634,5819,118750,"2023-08-01",2023
"23-Aug",서울,광진구,328,92186,5427,97941,"2023-08-01",2023
"23-Aug",서울,구로구,306,134576,13443,148325,"2023-08-01",2023
"23-Aug",서울,금천구,173,85766,6423,92362,"2023-08-01",2023
"23-Aug",서울,노원구,318,143413,8747,152478,"2023-08-01",2023
"23-Aug",서울,도봉구,281,87514,7482,95277,"2023-08-01",2023
"23-Aug",서울,동대문구,306,96180,5188,101674,"2023-08-01",2023
"23-Aug",서울,동작구,296,103791,2671,106758,"2023-08-01",2023
"23-Aug",서울,마포구,333,114327,7787,122447,"2023-08-01",2023
"23-Aug",서울,서대문구,448,85845,5546,91839,"2023-08-01",2023
"23-Aug",서울,서초구,515,165962,9760,176237,"2023-08-01",2023
"23-Aug",서울,성동구,363,92767,10745,103875,"2023-08-01",2023
"23-Aug",서울,성북구,299,117329,5096,122724,"2023-08-01",2023
"23-Aug",서울,송파구,409,229789,14308,244506,"2023-08-01",2023
"23-Aug",서울,양천구,335,142675,8567,151577,"2023-08-01",2023
"23-Aug",서울,영등포구,372,135970,8179,144521,"2023-08-01",2023
"23-Aug",서울,용산구,534,72639,2186,75359,"2023-08-01",2023
"23-Aug",서울,은평구,293,127020,7044,134357,"2023-08-01",2023
"23-Aug",서울,종로구,3518,44701,2491,50710,"2023-08-01",2023
"23-Aug",서울,중구,1282,51257,3294,55833,"2023-08-01",2023
"23-Aug",서울,중랑구,253,106519,9591,116363,"2023-08-01",2023
"23-Aug",서울,계,12664,2976423,201359,3190446,"2023-08-01",2023
"23-Aug",부산,강서구,345,84905,5541,90791,"2023-08-01",2023
"23-Aug",부산,금정구,283,78468,7106,85857,"2023-08-01",2023
"23-Aug",부산,기장군,262,85804,2886,88952,"2023-08-01",2023
"23-Aug",부산,남구,227,91181,9829,101237,"2023-08-01",2023
"23-Aug",부산,동구,190,43517,5501,49208,"2023-08-01",2023
"23-Aug",부산,동래구,168,97823,3536,101527,"2023-08-01",2023
"23-Aug",부산,부산진구,361,128698,22099,151158,"2023-08-01",2023
"23-Aug",부산,북구,287,102600,3720,106607,"2023-08-01",2023
"23-Aug",부산,사상구,262,83260,5408,88930,"2023-08-01",2023
"23-Aug",부산,사하구,269,108176,6028,114473,"2023-08-01",2023
"23-Aug",부산,서구,140,30388,1510,32038,"2023-08-01",2023
"23-Aug",부산,수영구,165,65162,59404,124731,"2023-08-01",2023
"23-Aug",부산,연제구,1006,110371,15196,126573,"2023-08-01",2023
"23-Aug",부산,영도구,227,31856,2098,34181,"2023-08-01",2023
"23-Aug",부산,중구,312,33110,7034,40456,"2023-08-01",2023
"23-Aug",부산,해운대구,325,165993,14951,181269,"2023-08-01",2023
"23-Aug",부산,계,4829,1341312,171847,1517988,"2023-08-01",2023
"23-Aug",대구,군위군,129,15694,102,15925,"2023-08-01",2023
"23-Aug",대구,남구,386,55991,1582,57959,"2023-08-01",2023
"23-Aug",대구,달서구,489,276637,17674,294800,"2023-08-01",2023
"23-Aug",대구,달성군,590,141137,5322,147049,"2023-08-01",2023
"23-Aug",대구,동구,368,160737,10506,171611,"2023-08-01",2023
"23-Aug",대구,북구,529,203715,8109,212353,"2023-08-01",2023
"23-Aug",대구,서구,261,68376,4803,73440,"2023-08-01",2023
"23-Aug",대구,수성구,594,212680,5253,218527,"2023-08-01",2023
"23-Aug",대구,중구,310,58944,2209,61463,"2023-08-01",2023
"23-Aug",대구,계,3656,1193911,55560,1253127,"2023-08-01",2023
"23-Aug",인천,강화군,340,38423,15958,54721,"2023-08-01",2023
"23-Aug",인천,계양구,303,122138,148157,270598,"2023-08-01",2023
"23-Aug",인천,남동구,933,254947,32808,288688,"2023-08-01",2023
"23-Aug",인천,동구,108,24519,2921,27548,"2023-08-01",2023
"23-Aug",인천,미추홀구,447,163567,9183,173197,"2023-08-01",2023
"23-Aug",인천,부평구,345,230350,42207,272902,"2023-08-01",2023
"23-Aug",인천,서구,505,297283,12673,310461,"2023-08-01",2023
"23-Aug",인천,연수구,441,213033,9594,223068,"2023-08-01",2023
"23-Aug",인천,옹진군,251,13208,279,13738,"2023-08-01",2023
"23-Aug",인천,중구,657,75821,12047,88525,"2023-08-01",2023
"23-Aug",인천,계,4330,1433289,285827,1723446,"2023-08-01",2023
"23-Aug",광주,광산구,568,203578,13298,217444,"2023-08-01",2023
"23-Aug",광주,남구,239,93192,2889,96320,"2023-08-01",2023
"23-Aug",광주,동구,243,46682,1070,47995,"2023-08-01",2023
"23-Aug",광주,북구,618,196516,9221,206355,"2023-08-01",2023
"23-Aug",광주,서구,733,144324,6324,151381,"2023-08-01",2023
"23-Aug",광주,계,2401,684292,32802,719495,"2023-08-01",2023
"23-Aug",대전,대덕구,241,88042,7970,96253,"2023-08-01",2023
"23-Aug",대전,동구,252,92675,4980,97907,"2023-08-01",2023
"23-Aug",대전,서구,815,210380,12316,223511,"2023-08-01",2023
"23-Aug",대전,유성구,654,190201,5982,196837,"2023-08-01",2023
"23-Aug",대전,중구,228,96672,5315,102215,"2023-08-01",2023
"23-Aug",대전,계,2190,677970,36563,716723,"2023-08-01",2023
"23-Aug",울산,남구,743,157422,7203,165368,"2023-08-01",2023
"23-Aug",울산,동구,193,63606,1258,65057,"2023-08-01",2023
"23-Aug",울산,북구,231,121686,3797,125714,"2023-08-01",2023
"23-Aug",울산,울주군,437,129955,7050,137442,"2023-08-01",2023
"23-Aug",울산,중구,334,100268,2580,103182,"2023-08-01",2023
"23-Aug",울산,계,1938,572937,21888,596763,"2023-08-01",2023
"23-Aug",세종,세종특별자치시,920,192593,3652,197165,"2023-08-01",2023
"23-Aug",세종,계,920,192593,3652,197165,"2023-08-01",2023
"23-Aug",경기,가평군,426,32625,601,33652,"2023-08-01",2023
"23-Aug",경기,고양시 덕양구,671,196675,5053,202399,"2023-08-01",2023
"23-Aug",경기,고양시 일산동구,267,128989,6478,135734,"2023-08-01",2023
"23-Aug",경기,고양시 일산서구,131,117429,4521,122081,"2023-08-01",2023
"23-Aug",경기,과천시,704,31192,701,32597,"2023-08-01",2023
"23-Aug",경기,광명시,311,100533,4643,105487,"2023-08-01",2023
"23-Aug",경기,광주시,426,204345,9212,213983,"2023-08-01",2023
"23-Aug",경기,구리시,273,71435,3059,74767,"2023-08-01",2023
"23-Aug",경기,군포시,300,99978,5375,105653,"2023-08-01",2023
"23-Aug",경기,김포시,566,236105,9206,245877,"2023-08-01",2023
"23-Aug",경기,남양주시,816,318063,9722,328601,"2023-08-01",2023
"23-Aug",경기,동두천시,225,38655,1549,40429,"2023-08-01",2023
"23-Aug",경기,부천시,730,296984,13408,311122,"2023-08-01",2023
"23-Aug",경기,성남시 분당구,367,189721,8046,198134,"2023-08-01",2023
"23-Aug",경기,성남시 수정구,309,78425,2708,81442,"2023-08-01",2023
"23-Aug",경기,성남시 중원구,388,75209,4059,79656,"2023-08-01",2023
"23-Aug",경기,수원시 권선구,471,200926,9895,211292,"2023-08-01",2023
"23-Aug",경기,수원시 영통구,412,151060,3598,155070,"2023-08-01",2023
"23-Aug",경기,수원시 장안구,494,105232,3692,109418,"2023-08-01",2023
"23-Aug",경기,수원시 팔달구,365,81450,3105,84920,"2023-08-01",2023
"23-Aug",경기,시흥시,454,266585,9006,276045,"2023-08-01",2023
"23-Aug",경기,안산시 단원구,592,163000,7934,171526,"2023-08-01",2023
"23-Aug",경기,안산시 상록구,150,145771,5931,151852,"2023-08-01",2023
"23-Aug",경기,안성시,401,112637,4736,117774,"2023-08-01",2023
"23-Aug",경기,안양시 동안구,402,123498,7047,130947,"2023-08-01",2023
"23-Aug",경기,안양시 만안구,158,85749,3990,89897,"2023-08-01",2023
"23-Aug",경기,양주시,435,128367,4305,133107,"2023-08-01",2023
"23-Aug",경기,양평군,606,65399,1936,67941,"2023-08-01",2023
"23-Aug",경기,여주시,486,68257,7481,76224,"2023-08-01",2023
"23-Aug",경기,연천군,325,24700,5242,30267,"2023-08-01",2023
"23-Aug",경기,오산시,230,112671,4221,117122,"2023-08-01",2023
"23-Aug",경기,용인시 기흥구,121,195081,7462,202664,"2023-08-01",2023
"23-Aug",경기,용인시 수지구,60,150976,2367,153403,"2023-08-01",2023
"23-Aug",경기,용인시 처인구,845,141405,7949,150199,"2023-08-01",2023
"23-Aug",경기,의왕시,307,66017,2909,69233,"2023-08-01",2023
"23-Aug",경기,의정부시,754,173837,5755,180346,"2023-08-01",2023
"23-Aug",경기,이천시,431,122903,6498,129832,"2023-08-01",2023
"23-Aug",경기,파주시,557,240767,11629,252953,"2023-08-01",2023
"23-Aug",경기,평택시,795,324627,14097,339519,"2023-08-01",2023
"23-Aug",경기,포천시,425,89470,7816,97711,"2023-08-01",2023
"23-Aug",경기,하남시,445,139882,3774,144101,"2023-08-01",2023
"23-Aug",경기,화성시,978,506979,14205,522162,"2023-08-01",2023
"23-Aug",경기,계,18609,6203609,254921,6477139,"2023-08-01",2023
"23-Aug",충북,괴산군,219,23973,463,24655,"2023-08-01",2023
"23-Aug",충북,단양군,243,16255,835,17333,"2023-08-01",2023
"23-Aug",충북,보은군,247,18947,954,20148,"2023-08-01",2023
"23-Aug",충북,영동군,274,26137,428,26839,"2023-08-01",2023
"23-Aug",충북,옥천군,216,28764,1101,30081,"2023-08-01",2023
"23-Aug",충북,음성군,279,62600,2062,64941,"2023-08-01",2023
"23-Aug",충북,제천시,341,69617,3486,73444,"2023-08-01",2023
"23-Aug",충북,증평군,96,20823,880,21799,"2023-08-01",2023
"23-Aug",충북,진천군,226,54209,1478,55913,"2023-08-01",2023
"23-Aug",충북,청원군,1,19,0,20,"2023-08-01",2023
"23-Aug",충북,청주시 상당구,508,101284,2692,104484,"2023-08-01",2023
"23-Aug",충북,청주시 서원구,246,100316,4628,105190,"2023-08-01",2023
"23-Aug",충북,청주시 청원구,403,107510,4811,112724,"2023-08-01",2023
"23-Aug",충북,청주시 흥덕구,368,141150,7964,149482,"2023-08-01",2023
"23-Aug",충북,충주시,639,116231,8344,125214,"2023-08-01",2023
"23-Aug",충북,계,4306,887835,40126,932267,"2023-08-01",2023
"23-Aug",충남,계룡시,173,25604,598,26375,"2023-08-01",2023
"23-Aug",충남,공주시,594,56256,2763,59613,"2023-08-01",2023
"23-Aug",충남,금산군,207,29977,2342,32526,"2023-08-01",2023
"23-Aug",충남,논산시,414,62636,2392,65442,"2023-08-01",2023
"23-Aug",충남,당진시,415,104150,4123,108688,"2023-08-01",2023
"23-Aug",충남,보령시,423,54272,1420,56115,"2023-08-01",2023
"23-Aug",충남,부여군,322,35243,976,36541,"2023-08-01",2023
"23-Aug",충남,서산시,444,101682,3736,105862,"2023-08-01",2023
"23-Aug",충남,서천군,240,27806,787,28833,"2023-08-01",2023
"23-Aug",충남,아산시,543,191015,7246,198804,"2023-08-01",2023
"23-Aug",충남,예산군,448,46876,1438,48762,"2023-08-01",2023
"23-Aug",충남,천안시 동남구,303,138742,5557,144602,"2023-08-01",2023
"23-Aug",충남,천안시 서북구,554,205196,5469,211219,"2023-08-01",2023
"23-Aug",충남,청양군,263,17743,726,18732,"2023-08-01",2023
"23-Aug",충남,태안군,332,35987,553,36872,"2023-08-01",2023
"23-Aug",충남,홍성군,399,54682,1464,56545,"2023-08-01",2023
"23-Aug",충남,계,6074,1187867,41590,1235531,"2023-08-01",2023
"23-Aug",전북,고창군,341,31614,576,32531,"2023-08-01",2023
"23-Aug",전북,군산시,562,136772,6480,143814,"2023-08-01",2023
"23-Aug",전북,김제시,325,48395,1966,50686,"2023-08-01",2023
"23-Aug",전북,남원시,426,42774,1410,44610,"2023-08-01",2023
"23-Aug",전북,무주군,220,13619,408,14247,"2023-08-01",2023
"23-Aug",전북,부안군,278,28465,616,29359,"2023-08-01",2023
"23-Aug",전북,순창군,233,15490,159,15882,"2023-08-01",2023
"23-Aug",전북,완주군,442,58092,3184,61718,"2023-08-01",2023
"23-Aug",전북,익산시,553,140379,5869,146801,"2023-08-01",2023
"23-Aug",전북,임실군,255,14976,425,15656,"2023-08-01",2023
"23-Aug",전북,장수군,237,12591,165,12993,"2023-08-01",2023
"23-Aug",전북,전주시 덕진구,384,175446,7158,182988,"2023-08-01",2023
"23-Aug",전북,전주시 완산구,753,155642,4268,160663,"2023-08-01",2023
"23-Aug",전북,정읍시,390,57233,3702,61325,"2023-08-01",2023
"23-Aug",전북,진안군,282,14858,247,15387,"2023-08-01",2023
"23-Aug",전북,계,5681,946346,36633,988660,"2023-08-01",2023
"23-Aug",전남,강진군,260,19308,1028,20596,"2023-08-01",2023
"23-Aug",전남,고흥군,313,33850,593,34756,"2023-08-01",2023
"23-Aug",전남,곡성군,186,15726,642,16554,"2023-08-01",2023
"23-Aug",전남,광양시,266,90924,6212,97402,"2023-08-01",2023
"23-Aug",전남,구례군,150,13492,739,14381,"2023-08-01",2023
"23-Aug",전남,나주시,495,69150,3233,72878,"2023-08-01",2023
"23-Aug",전남,담양군,217,28717,1747,30681,"2023-08-01",2023
"23-Aug",전남,목포시,424,97934,5446,103804,"2023-08-01",2023
"23-Aug",전남,무안군,610,51848,1160,53618,"2023-08-01",2023
"23-Aug",전남,보성군,239,22445,634,23318,"2023-08-01",2023
"23-Aug",전남,순천시,537,147453,5368,153358,"2023-08-01",2023
"23-Aug",전남,신안군,365,23411,95910,119686,"2023-08-01",2023
"23-Aug",전남,여수시,564,137094,7393,145051,"2023-08-01",2023
"23-Aug",전남,영광군,234,29618,788,30640,"2023-08-01",2023
"23-Aug",전남,영암군,274,36282,1173,37729,"2023-08-01",2023
"23-Aug",전남,완도군,295,26361,512,27168,"2023-08-01",2023
"23-Aug",전남,장성군,214,27821,1341,29376,"2023-08-01",2023
"23-Aug",전남,장흥군,281,20659,447,21387,"2023-08-01",2023
"23-Aug",전남,진도군,219,17716,303,18238,"2023-08-01",2023
"23-Aug",전남,함평군,215,19049,13465,32729,"2023-08-01",2023
"23-Aug",전남,해남군,340,41096,77714,119150,"2023-08-01",2023
"23-Aug",전남,화순군,250,34435,2159,36844,"2023-08-01",2023
"23-Aug",전남,계,6948,1004389,228007,1239344,"2023-08-01",2023
"23-Aug",경북,경산시,359,143174,4425,147958,"2023-08-01",2023
"23-Aug",경북,경주시,619,147522,4581,152722,"2023-08-01",2023
"23-Aug",경북,고령군,184,21238,723,22145,"2023-08-01",2023
"23-Aug",경북,구미시,562,219903,7428,227893,"2023-08-01",2023
"23-Aug",경북,군위군,1,124,180,305,"2023-08-01",2023
"23-Aug",경북,김천시,405,78234,2083,80722,"2023-08-01",2023
"23-Aug",경북,문경시,296,38669,895,39860,"2023-08-01",2023
"23-Aug",경북,봉화군,257,18641,196,19094,"2023-08-01",2023
"23-Aug",경북,상주시,400,55572,1882,57854,"2023-08-01",2023
"23-Aug",경북,성주군,212,32111,1345,33668,"2023-08-01",2023
"23-Aug",경북,안동시,770,85142,2660,88572,"2023-08-01",2023
"23-Aug",경북,영덕군,256,19528,307,20091,"2023-08-01",2023
"23-Aug",경북,영양군,147,10111,117,10375,"2023-08-01",2023
"23-Aug",경북,영주시,376,57279,1499,59154,"2023-08-01",2023
"23-Aug",경북,영천시,368,62885,2493,65746,"2023-08-01",2023
"23-Aug",경북,예천군,298,31900,497,32695,"2023-08-01",2023
"23-Aug",경북,울릉군,158,5911,639,6708,"2023-08-01",2023
"23-Aug",경북,울진군,338,27357,350,28045,"2023-08-01",2023
"23-Aug",경북,의성군,324,32616,1110,34050,"2023-08-01",2023
"23-Aug",경북,청도군,224,26207,961,27392,"2023-08-01",2023
"23-Aug",경북,청송군,226,16268,213,16707,"2023-08-01",2023
"23-Aug",경북,칠곡군,313,71161,2492,73966,"2023-08-01",2023
"23-Aug",경북,포항시 남구,450,125966,8360,134776,"2023-08-01",2023
"23-Aug",경북,포항시 북구,388,144318,3600,148306,"2023-08-01",2023
"23-Aug",경북,계,7931,1471837,49036,1528804,"2023-08-01",2023
"23-Aug",경남,거제시,358,108914,2112,111384,"2023-08-01",2023
"23-Aug",경남,거창군,289,34235,791,35315,"2023-08-01",2023
"23-Aug",경남,고성군,231,27928,564,28723,"2023-08-01",2023
"23-Aug",경남,김해시,691,286641,7882,295214,"2023-08-01",2023
"23-Aug",경남,남해군,298,20862,450,21610,"2023-08-01",2023
"23-Aug",경남,밀양시,328,58277,3952,62557,"2023-08-01",2023
"23-Aug",경남,사천시,332,58830,1533,60695,"2023-08-01",2023
"23-Aug",경남,산청군,249,21299,756,22304,"2023-08-01",2023
"23-Aug",경남,양산시,431,175214,10672,186317,"2023-08-01",2023
"23-Aug",경남,의령군,225,15339,764,16328,"2023-08-01",2023
"23-Aug",경남,진주시,666,172884,6728,180278,"2023-08-01",2023
"23-Aug",경남,창녕군,255,36528,750,37533,"2023-08-01",2023
"23-Aug",경남,창원시 마산합포구,351,99470,2879,102700,"2023-08-01",2023
"23-Aug",경남,창원시 마산회원구,157,104592,6322,111071,"2023-08-01",2023
"23-Aug",경남,창원시 성산구,619,167536,60553,228708,"2023-08-01",2023
"23-Aug",경남,창원시 의창구,506,119407,3585,123498,"2023-08-01",2023
"23-Aug",경남,창원시 진해구,229,96788,2054,99071,"2023-08-01",2023
"23-Aug",경남,통영시,313,53469,1372,55154,"2023-08-01",2023
"23-Aug",경남,하동군,237,24444,383,25064,"2023-08-01",2023
"23-Aug",경남,함안군,222,44270,34913,79405,"2023-08-01",2023
"23-Aug",경남,함양군,242,20285,422,20949,"2023-08-01",2023
"23-Aug",경남,합천군,290,24330,638,25258,"2023-08-01",2023
"23-Aug",경남,계,7519,1771542,150075,1929136,"2023-08-01",2023
"23-Aug",제주,서귀포시,766,107651,1867,110284,"2023-08-01",2023
"23-Aug",제주,제주시,1691,310245,276561,588497,"2023-08-01",2023
"23-Aug",제주,계,2457,417896,278428,698781,"2023-08-01",2023
"23-Aug",강원,강릉시,596,113687,4756,119039,"2023-08-01",2023
"23-Aug",강원,고성군,206,16111,238,16555,"2023-08-01",2023
"23-Aug",강원,동해시,333,47737,1546,49616,"2023-08-01",2023
"23-Aug",강원,삼척시,414,33655,821,34890,"2023-08-01",2023
"23-Aug",강원,속초시,314,40727,1477,42518,"2023-08-01",2023
"23-Aug",강원,양구군,224,12527,142,12893,"2023-08-01",2023
"23-Aug",강원,양양군,213,16900,317,17430,"2023-08-01",2023
"23-Aug",강원,영월군,345,21906,400,22651,"2023-08-01",2023
"23-Aug",강원,원주시,649,188848,5948,195445,"2023-08-01",2023
"23-Aug",강원,인제군,238,19903,294,20435,"2023-08-01",2023
"23-Aug",강원,정선군,361,21148,491,22000,"2023-08-01",2023
"23-Aug",강원,철원군,270,24781,338,25389,"2023-08-01",2023
"23-Aug",강원,춘천시,871,142256,6326,149453,"2023-08-01",2023
"23-Aug",강원,태백시,248,20127,700,21075,"2023-08-01",2023
"23-Aug",강원,평창군,324,26932,582,27838,"2023-08-01",2023
"23-Aug",강원,홍천군,430,40830,1036,42296,"2023-08-01",2023
"23-Aug",강원,화천군,239,13344,184,13767,"2023-08-01",2023
"23-Aug",강원,횡성군,277,28581,908,29766,"2023-08-01",2023
"23-Aug",강원,계,6552,830000,26504,863056,"2023-08-01",2023
"23-Sep",서울,강남구,412,230091,22035,252538,"2023-09-01",2023
"23-Sep",서울,강동구,313,144697,8642,153652,"2023-09-01",2023
"23-Sep",서울,강북구,314,70412,4236,74962,"2023-09-01",2023
"23-Sep",서울,강서구,358,188466,16350,205174,"2023-09-01",2023
"23-Sep",서울,관악구,299,112593,5829,118721,"2023-09-01",2023
"23-Sep",서울,광진구,328,92408,5405,98141,"2023-09-01",2023
"23-Sep",서울,구로구,304,134586,13452,148342,"2023-09-01",2023
"23-Sep",서울,금천구,177,85725,6447,92349,"2023-09-01",2023
"23-Sep",서울,노원구,321,143565,8747,152633,"2023-09-01",2023
"23-Sep",서울,도봉구,284,87411,7501,95196,"2023-09-01",2023
"23-Sep",서울,동대문구,304,96619,5204,102127,"2023-09-01",2023
"23-Sep",서울,동작구,298,103778,2665,106741,"2023-09-01",2023
"23-Sep",서울,마포구,334,114286,7754,122374,"2023-09-01",2023
"23-Sep",서울,서대문구,453,85865,5540,91858,"2023-09-01",2023
"23-Sep",서울,서초구,519,166777,9777,177073,"2023-09-01",2023
"23-Sep",서울,성동구,361,92720,10786,103867,"2023-09-01",2023
"23-Sep",서울,성북구,301,117290,5077,122668,"2023-09-01",2023
"23-Sep",서울,송파구,409,229948,14348,244705,"2023-09-01",2023
"23-Sep",서울,양천구,338,142776,8573,151687,"2023-09-01",2023
"23-Sep",서울,영등포구,372,136095,8160,144627,"2023-09-01",2023
"23-Sep",서울,용산구,534,72619,2175,75328,"2023-09-01",2023
"23-Sep",서울,은평구,299,127585,7075,134959,"2023-09-01",2023
"23-Sep",서울,종로구,3479,44742,2483,50704,"2023-09-01",2023
"23-Sep",서울,중구,1285,51008,3225,55518,"2023-09-01",2023
"23-Sep",서울,중랑구,252,106567,9596,116415,"2023-09-01",2023
"23-Sep",서울,계,12648,2978629,201082,3192359,"2023-09-01",2023
"23-Sep",부산,강서구,344,85015,5534,90893,"2023-09-01",2023
"23-Sep",부산,금정구,284,78382,7115,85781,"2023-09-01",2023
"23-Sep",부산,기장군,263,86065,2897,89225,"2023-09-01",2023
"23-Sep",부산,남구,226,91064,9789,101079,"2023-09-01",2023
"23-Sep",부산,동구,191,44135,5518,49844,"2023-09-01",2023
"23-Sep",부산,동래구,167,97775,3545,101487,"2023-09-01",2023
"23-Sep",부산,부산진구,362,129352,22566,152280,"2023-09-01",2023
"23-Sep",부산,북구,274,102372,3730,106376,"2023-09-01",2023
"23-Sep",부산,사상구,263,83403,5381,89047,"2023-09-01",2023
"23-Sep",부산,사하구,270,108211,6048,114529,"2023-09-01",2023
"23-Sep",부산,서구,140,30398,1501,32039,"2023-09-01",2023
"23-Sep",부산,수영구,164,65058,59989,125211,"2023-09-01",2023
"23-Sep",부산,연제구,1004,110585,15453,127042,"2023-09-01",2023
"23-Sep",부산,영도구,230,31920,2101,34251,"2023-09-01",2023
"23-Sep",부산,중구,310,33218,7011,40539,"2023-09-01",2023
"23-Sep",부산,해운대구,326,166175,14639,181140,"2023-09-01",2023
"23-Sep",부산,계,4818,1343128,172817,1520763,"2023-09-01",2023
"23-Sep",대구,군위군,129,15769,109,16007,"2023-09-01",2023
"23-Sep",대구,남구,387,55993,1587,57967,"2023-09-01",2023
"23-Sep",대구,달서구,499,276627,17827,294953,"2023-09-01",2023
"23-Sep",대구,달성군,590,141127,5310,147027,"2023-09-01",2023
"23-Sep",대구,동구,369,161346,10474,172189,"2023-09-01",2023
"23-Sep",대구,북구,544,203552,8096,212192,"2023-09-01",2023
"23-Sep",대구,서구,261,68820,4809,73890,"2023-09-01",2023
"23-Sep",대구,수성구,594,213165,5239,218998,"2023-09-01",2023
"23-Sep",대구,중구,312,59008,2224,61544,"2023-09-01",2023
"23-Sep",대구,계,3685,1195407,55675,1254767,"2023-09-01",2023
"23-Sep",인천,강화군,341,38380,15480,54201,"2023-09-01",2023
"23-Sep",인천,계양구,305,122359,147967,270631,"2023-09-01",2023
"23-Sep",인천,남동구,926,255458,32258,288642,"2023-09-01",2023
"23-Sep",인천,동구,107,24563,2923,27593,"2023-09-01",2023
"23-Sep",인천,미추홀구,448,163379,9226,173053,"2023-09-01",2023
"23-Sep",인천,부평구,346,230001,42046,272393,"2023-09-01",2023
"23-Sep",인천,서구,505,299325,12752,312582,"2023-09-01",2023
"23-Sep",인천,연수구,440,213924,9663,224027,"2023-09-01",2023
"23-Sep",인천,옹진군,256,13207,277,13740,"2023-09-01",2023
"23-Sep",인천,중구,658,76349,12029,89036,"2023-09-01",2023
"23-Sep",인천,계,4332,1436945,284621,1725898,"2023-09-01",2023
"23-Sep",광주,광산구,565,203813,13290,217668,"2023-09-01",2023
"23-Sep",광주,남구,240,93351,2890,96481,"2023-09-01",2023
"23-Sep",광주,동구,247,46749,1051,48047,"2023-09-01",2023
"23-Sep",광주,북구,610,196905,9222,206737,"2023-09-01",2023
"23-Sep",광주,서구,735,144673,6301,151709,"2023-09-01",2023
"23-Sep",광주,계,2397,685491,32754,720642,"2023-09-01",2023
"23-Sep",대전,대덕구,241,87610,7995,95846,"2023-09-01",2023
"23-Sep",대전,동구,252,92760,4989,98001,"2023-09-01",2023
"23-Sep",대전,서구,819,210504,13117,224440,"2023-09-01",2023
"23-Sep",대전,유성구,658,190612,6097,197367,"2023-09-01",2023
"23-Sep",대전,중구,228,96774,5337,102339,"2023-09-01",2023
"23-Sep",대전,계,2198,678260,37535,717993,"2023-09-01",2023
"23-Sep",울산,남구,743,157603,7133,165479,"2023-09-01",2023
"23-Sep",울산,동구,193,63846,1256,65295,"2023-09-01",2023
"23-Sep",울산,북구,229,121632,3790,125651,"2023-09-01",2023
"23-Sep",울산,울주군,443,130057,7051,137551,"2023-09-01",2023
"23-Sep",울산,중구,332,100289,2646,103267,"2023-09-01",2023
"23-Sep",울산,계,1940,573427,21876,597243,"2023-09-01",2023
"23-Sep",세종,세종특별자치시,921,192819,3685,197425,"2023-09-01",2023
"23-Sep",세종,계,921,192819,3685,197425,"2023-09-01",2023
"23-Sep",경기,가평군,425,32783,595,33803,"2023-09-01",2023
"23-Sep",경기,고양시 덕양구,672,197046,5064,202782,"2023-09-01",2023
"23-Sep",경기,고양시 일산동구,270,128937,6494,135701,"2023-09-01",2023
"23-Sep",경기,고양시 일산서구,131,117650,4562,122343,"2023-09-01",2023
"23-Sep",경기,과천시,702,31262,743,32707,"2023-09-01",2023
"23-Sep",경기,광명시,311,100527,4656,105494,"2023-09-01",2023
"23-Sep",경기,광주시,421,204647,9167,214235,"2023-09-01",2023
"23-Sep",경기,구리시,274,71469,3044,74787,"2023-09-01",2023
"23-Sep",경기,군포시,298,99941,5365,105604,"2023-09-01",2023
"23-Sep",경기,김포시,567,236487,9245,246299,"2023-09-01",2023
"23-Sep",경기,남양주시,817,318013,9750,328580,"2023-09-01",2023
"23-Sep",경기,동두천시,227,38682,1532,40441,"2023-09-01",2023
"23-Sep",경기,부천시,728,296956,13436,311120,"2023-09-01",2023
"23-Sep",경기,성남시 분당구,370,189913,8157,198440,"2023-09-01",2023
"23-Sep",경기,성남시 수정구,308,78476,2715,81499,"2023-09-01",2023
"23-Sep",경기,성남시 중원구,389,75229,4076,79694,"2023-09-01",2023
"23-Sep",경기,수원시 권선구,474,200729,9694,210897,"2023-09-01",2023
"23-Sep",경기,수원시 영통구,416,151366,3698,155480,"2023-09-01",2023
"23-Sep",경기,수원시 장안구,499,105262,3712,109473,"2023-09-01",2023
"23-Sep",경기,수원시 팔달구,364,82293,3172,85829,"2023-09-01",2023
"23-Sep",경기,시흥시,456,267091,9073,276620,"2023-09-01",2023
"23-Sep",경기,안산시 단원구,590,163131,7940,171661,"2023-09-01",2023
"23-Sep",경기,안산시 상록구,152,145809,5922,151883,"2023-09-01",2023
"23-Sep",경기,안성시,402,112892,4744,118038,"2023-09-01",2023
"23-Sep",경기,안양시 동안구,400,123506,7045,130951,"2023-09-01",2023
"23-Sep",경기,안양시 만안구,157,85780,4012,89949,"2023-09-01",2023
"23-Sep",경기,양주시,437,129114,4336,133887,"2023-09-01",2023
"23-Sep",경기,양평군,613,65636,1945,68194,"2023-09-01",2023
"23-Sep",경기,여주시,479,68452,7476,76407,"2023-09-01",2023
"23-Sep",경기,연천군,325,24755,5209,30289,"2023-09-01",2023
"23-Sep",경기,오산시,230,112914,4227,117371,"2023-09-01",2023
"23-Sep",경기,용인시 기흥구,122,195460,7774,203356,"2023-09-01",2023
"23-Sep",경기,용인시 수지구,60,151229,2383,153672,"2023-09-01",2023
"23-Sep",경기,용인시 처인구,845,141699,7926,150470,"2023-09-01",2023
"23-Sep",경기,의왕시,308,66285,2905,69498,"2023-09-01",2023
"23-Sep",경기,의정부시,759,174221,5772,180752,"2023-09-01",2023
"23-Sep",경기,이천시,431,123123,6515,130069,"2023-09-01",2023
"23-Sep",경기,파주시,554,241199,11594,253347,"2023-09-01",2023
"23-Sep",경기,평택시,792,325565,14133,340490,"2023-09-01",2023
"23-Sep",경기,포천시,424,89539,7659,97622,"2023-09-01",2023
"23-Sep",경기,하남시,448,140148,3766,144362,"2023-09-01",2023
"23-Sep",경기,화성시,984,508991,14271,524246,"2023-09-01",2023
"23-Sep",경기,계,18631,6214207,255504,6488342,"2023-09-01",2023
"23-Sep",충북,괴산군,220,24001,460,24681,"2023-09-01",2023
"23-Sep",충북,단양군,242,16306,838,17386,"2023-09-01",2023
"23-Sep",충북,보은군,247,18959,949,20155,"2023-09-01",2023
"23-Sep",충북,영동군,271,26209,427,26907,"2023-09-01",2023
"23-Sep",충북,옥천군,220,28757,1093,30070,"2023-09-01",2023
"23-Sep",충북,음성군,279,62576,2069,64924,"2023-09-01",2023
"23-Sep",충북,제천시,345,69688,3510,73543,"2023-09-01",2023
"23-Sep",충북,증평군,98,20823,818,21739,"2023-09-01",2023
"23-Sep",충북,진천군,228,54293,1492,56013,"2023-09-01",2023
"23-Sep",충북,청원군,1,19,0,20,"2023-09-01",2023
"23-Sep",충북,청주시 상당구,513,101588,2683,104784,"2023-09-01",2023
"23-Sep",충북,청주시 서원구,253,100067,4632,104952,"2023-09-01",2023
"23-Sep",충북,청주시 청원구,402,107489,4935,112826,"2023-09-01",2023
"23-Sep",충북,청주시 흥덕구,379,141848,8010,150237,"2023-09-01",2023
"23-Sep",충북,충주시,629,116442,8586,125657,"2023-09-01",2023
"23-Sep",충북,계,4327,889065,40502,933894,"2023-09-01",2023
"23-Sep",충남,계룡시,172,25742,597,26511,"2023-09-01",2023
"23-Sep",충남,공주시,596,56276,2775,59647,"2023-09-01",2023
"23-Sep",충남,금산군,211,30060,2349,32620,"2023-09-01",2023
"23-Sep",충남,논산시,410,62670,2402,65482,"2023-09-01",2023
"23-Sep",충남,당진시,415,104520,4120,109055,"2023-09-01",2023
"23-Sep",충남,보령시,428,54282,1416,56126,"2023-09-01",2023
"23-Sep",충남,부여군,322,35260,973,36555,"2023-09-01",2023
"23-Sep",충남,서산시,444,101760,3719,105923,"2023-09-01",2023
"23-Sep",충남,서천군,243,27838,795,28876,"2023-09-01",2023
"23-Sep",충남,아산시,547,192006,7225,199778,"2023-09-01",2023
"23-Sep",충남,예산군,442,46744,1438,48624,"2023-09-01",2023
"23-Sep",충남,천안시 동남구,305,138966,5540,144811,"2023-09-01",2023
"23-Sep",충남,천안시 서북구,566,205495,5482,211543,"2023-09-01",2023
"23-Sep",충남,청양군,261,17786,720,18767,"2023-09-01",2023
"23-Sep",충남,태안군,337,36035,555,36927,"2023-09-01",2023
"23-Sep",충남,홍성군,406,54851,1463,56720,"2023-09-01",2023
"23-Sep",충남,계,6105,1190291,41569,1237965,"2023-09-01",2023
"23-Sep",전북,고창군,336,31681,580,32597,"2023-09-01",2023
"23-Sep",전북,군산시,564,137117,6455,144136,"2023-09-01",2023
"23-Sep",전북,김제시,332,48410,1973,50715,"2023-09-01",2023
"23-Sep",전북,남원시,429,42763,1383,44575,"2023-09-01",2023
"23-Sep",전북,무주군,220,13657,406,14283,"2023-09-01",2023
"23-Sep",전북,부안군,278,28480,618,29376,"2023-09-01",2023
"23-Sep",전북,순창군,233,15525,160,15918,"2023-09-01",2023
"23-Sep",전북,완주군,446,58261,3128,61835,"2023-09-01",2023
"23-Sep",전북,익산시,559,140692,5853,147104,"2023-09-01",2023
"23-Sep",전북,임실군,256,15021,423,15700,"2023-09-01",2023
"23-Sep",전북,장수군,235,12605,166,13006,"2023-09-01",2023
"23-Sep",전북,전주시 덕진구,382,175642,7149,183173,"2023-09-01",2023
"23-Sep",전북,전주시 완산구,753,155703,4292,160748,"2023-09-01",2023
"23-Sep",전북,정읍시,384,57205,3771,61360,"2023-09-01",2023
"23-Sep",전북,진안군,281,14857,246,15384,"2023-09-01",2023
"23-Sep",전북,계,5688,947619,36603,989910,"2023-09-01",2023
"23-Sep",전남,강진군,259,19314,1027,20600,"2023-09-01",2023
"23-Sep",전남,고흥군,318,33906,594,34818,"2023-09-01",2023
"23-Sep",전남,곡성군,190,15770,641,16601,"2023-09-01",2023
"23-Sep",전남,광양시,259,91211,6211,97681,"2023-09-01",2023
"23-Sep",전남,구례군,174,13504,741,14419,"2023-09-01",2023
"23-Sep",전남,나주시,491,69372,3250,73113,"2023-09-01",2023
"23-Sep",전남,담양군,216,28725,1757,30698,"2023-09-01",2023
"23-Sep",전남,목포시,418,98074,5440,103932,"2023-09-01",2023
"23-Sep",전남,무안군,587,51901,1171,53659,"2023-09-01",2023
"23-Sep",전남,보성군,240,22441,633,23314,"2023-09-01",2023
"23-Sep",전남,순천시,510,147403,5361,153274,"2023-09-01",2023
"23-Sep",전남,신안군,388,23503,96844,120735,"2023-09-01",2023
"23-Sep",전남,여수시,571,137273,7399,145243,"2023-09-01",2023
"23-Sep",전남,영광군,234,29637,784,30655,"2023-09-01",2023
"23-Sep",전남,영암군,276,36340,1165,37781,"2023-09-01",2023
"23-Sep",전남,완도군,299,26441,516,27256,"2023-09-01",2023
"23-Sep",전남,장성군,213,27918,1340,29471,"2023-09-01",2023
"23-Sep",전남,장흥군,284,20659,446,21389,"2023-09-01",2023
"23-Sep",전남,진도군,223,17701,298,18222,"2023-09-01",2023
"23-Sep",전남,함평군,217,19016,12249,31482,"2023-09-01",2023
"23-Sep",전남,해남군,345,41139,79026,120510,"2023-09-01",2023
"23-Sep",전남,화순군,251,34389,2184,36824,"2023-09-01",2023
"23-Sep",전남,계,6963,1005637,229077,1241677,"2023-09-01",2023
"23-Sep",경북,경산시,354,143383,4430,148167,"2023-09-01",2023
"23-Sep",경북,경주시,618,147649,4590,152857,"2023-09-01",2023
"23-Sep",경북,고령군,186,21244,763,22193,"2023-09-01",2023
"23-Sep",경북,구미시,555,220193,7395,228143,"2023-09-01",2023
"23-Sep",경북,군위군,0,65,176,241,"2023-09-01",2023
"23-Sep",경북,김천시,404,78262,2097,80763,"2023-09-01",2023
"23-Sep",경북,문경시,295,38615,897,39807,"2023-09-01",2023
"23-Sep",경북,봉화군,256,18674,194,19124,"2023-09-01",2023
"23-Sep",경북,상주시,397,55692,1880,57969,"2023-09-01",2023
"23-Sep",경북,성주군,215,32137,1337,33689,"2023-09-01",2023
"23-Sep",경북,안동시,750,85251,2668,88669,"2023-09-01",2023
"23-Sep",경북,영덕군,255,19550,309,20114,"2023-09-01",2023
"23-Sep",경북,영양군,146,10140,117,10403,"2023-09-01",2023
"23-Sep",경북,영주시,375,57245,1507,59127,"2023-09-01",2023
"23-Sep",경북,영천시,367,63006,2498,65871,"2023-09-01",2023
"23-Sep",경북,예천군,295,31934,489,32718,"2023-09-01",2023
"23-Sep",경북,울릉군,159,5906,636,6701,"2023-09-01",2023
"23-Sep",경북,울진군,335,27431,354,28120,"2023-09-01",2023
"23-Sep",경북,의성군,310,32651,1112,34073,"2023-09-01",2023
"23-Sep",경북,청도군,222,26189,967,27378,"2023-09-01",2023
"23-Sep",경북,청송군,224,16281,210,16715,"2023-09-01",2023
"23-Sep",경북,칠곡군,311,71192,2506,74009,"2023-09-01",2023
"23-Sep",경북,포항시 남구,448,126142,8312,134902,"2023-09-01",2023
"23-Sep",경북,포항시 북구,386,144566,3615,148567,"2023-09-01",2023
"23-Sep",경북,계,7863,1473398,49059,1530320,"2023-09-01",2023
"23-Sep",경남,거제시,361,109015,2108,111484,"2023-09-01",2023
"23-Sep",경남,거창군,289,34255,793,35337,"2023-09-01",2023
"23-Sep",경남,고성군,238,27966,568,28772,"2023-09-01",2023
"23-Sep",경남,김해시,690,286959,7890,295539,"2023-09-01",2023
"23-Sep",경남,남해군,300,20899,449,21648,"2023-09-01",2023
"23-Sep",경남,밀양시,327,58312,3954,62593,"2023-09-01",2023
"23-Sep",경남,사천시,333,58892,1561,60786,"2023-09-01",2023
"23-Sep",경남,산청군,249,21330,758,22337,"2023-09-01",2023
"23-Sep",경남,양산시,429,175589,10664,186682,"2023-09-01",2023
"23-Sep",경남,의령군,225,15374,766,16365,"2023-09-01",2023
"23-Sep",경남,진주시,665,172867,6717,180249,"2023-09-01",2023
"23-Sep",경남,창녕군,254,36482,755,37491,"2023-09-01",2023
"23-Sep",경남,창원시 마산합포구,352,99995,2878,103225,"2023-09-01",2023
"23-Sep",경남,창원시 마산회원구,156,104643,6748,111547,"2023-09-01",2023
"23-Sep",경남,창원시 성산구,615,168054,60700,229369,"2023-09-01",2023
"23-Sep",경남,창원시 의창구,501,119271,3580,123352,"2023-09-01",2023
"23-Sep",경남,창원시 진해구,230,96813,2067,99110,"2023-09-01",2023
"23-Sep",경남,통영시,312,53554,1368,55234,"2023-09-01",2023
"23-Sep",경남,하동군,239,24469,382,25090,"2023-09-01",2023
"23-Sep",경남,함안군,218,44193,34479,78890,"2023-09-01",2023
"23-Sep",경남,함양군,239,20327,416,20982,"2023-09-01",2023
"23-Sep",경남,합천군,288,24370,635,25293,"2023-09-01",2023
"23-Sep",경남,계,7510,1773629,150236,1931375,"2023-09-01",2023
"23-Sep",제주,서귀포시,773,107664,1871,110308,"2023-09-01",2023
"23-Sep",제주,제주시,1694,310981,277847,590522,"2023-09-01",2023
"23-Sep",제주,계,2467,418645,279718,700830,"2023-09-01",2023
"23-Sep",강원,강릉시,602,113950,4812,119364,"2023-09-01",2023
"23-Sep",강원,고성군,206,16147,238,16591,"2023-09-01",2023
"23-Sep",강원,동해시,329,47781,1543,49653,"2023-09-01",2023
"23-Sep",강원,삼척시,412,33702,828,34942,"2023-09-01",2023
"23-Sep",강원,속초시,313,40703,1464,42480,"2023-09-01",2023
"23-Sep",강원,양구군,224,12521,142,12887,"2023-09-01",2023
"23-Sep",강원,양양군,214,16934,315,17463,"2023-09-01",2023
"23-Sep",강원,영월군,347,21926,400,22673,"2023-09-01",2023
"23-Sep",강원,원주시,647,189144,5969,195760,"2023-09-01",2023
"23-Sep",강원,인제군,240,19961,296,20497,"2023-09-01",2023
"23-Sep",강원,정선군,366,21128,490,21984,"2023-09-01",2023
"23-Sep",강원,철원군,272,24743,340,25355,"2023-09-01",2023
"23-Sep",강원,춘천시,870,142482,6316,149668,"2023-09-01",2023
"23-Sep",강원,태백시,246,20154,700,21100,"2023-09-01",2023
"23-Sep",강원,평창군,327,26969,591,27887,"2023-09-01",2023
"23-Sep",강원,홍천군,439,40877,1040,42356,"2023-09-01",2023
"23-Sep",강원,화천군,235,13383,188,13806,"2023-09-01",2023
"23-Sep",강원,횡성군,279,28602,898,29779,"2023-09-01",2023
"23-Sep",강원,계,6568,831107,26570,864245,"2023-09-01",2023
"23-Oct",서울,강남구,412,230310,22070,252792,"2023-10-01",2023
"23-Oct",서울,강동구,314,144717,8581,153612,"2023-10-01",2023
"23-Oct",서울,강북구,314,70195,4245,74754,"2023-10-01",2023
"23-Oct",서울,강서구,358,188501,16299,205158,"2023-10-01",2023
"23-Oct",서울,관악구,299,112498,5831,118628,"2023-10-01",2023
"23-Oct",서울,광진구,327,92374,5197,97898,"2023-10-01",2023
"23-Oct",서울,구로구,302,134548,13398,148248,"2023-10-01",2023
"23-Oct",서울,금천구,176,85660,6450,92286,"2023-10-01",2023
"23-Oct",서울,노원구,324,143520,8736,152580,"2023-10-01",2023
"23-Oct",서울,도봉구,283,87369,7511,95163,"2023-10-01",2023
"23-Oct",서울,동대문구,305,96913,5249,102467,"2023-10-01",2023
"23-Oct",서울,동작구,300,103651,2662,106613,"2023-10-01",2023
"23-Oct",서울,마포구,336,114200,7840,122376,"2023-10-01",2023
"23-Oct",서울,서대문구,454,85778,5546,91778,"2023-10-01",2023
"23-Oct",서울,서초구,513,166710,9718,176941,"2023-10-01",2023
"23-Oct",서울,성동구,362,92549,11440,104351,"2023-10-01",2023
"23-Oct",서울,성북구,301,117258,5089,122648,"2023-10-01",2023
"23-Oct",서울,송파구,409,229919,14421,244749,"2023-10-01",2023
"23-Oct",서울,양천구,337,142703,8564,151604,"2023-10-01",2023
"23-Oct",서울,영등포구,371,136066,8158,144595,"2023-10-01",2023
"23-Oct",서울,용산구,531,72488,2176,75195,"2023-10-01",2023
"23-Oct",서울,은평구,302,127856,7073,135231,"2023-10-01",2023
"23-Oct",서울,종로구,3486,44732,2472,50690,"2023-10-01",2023
"23-Oct",서울,중구,1291,50757,3143,55191,"2023-10-01",2023
"23-Oct",서울,중랑구,254,106482,9548,116284,"2023-10-01",2023
"23-Oct",서울,계,12661,2977754,201417,3191832,"2023-10-01",2023
"23-Oct",부산,강서구,344,85067,5551,90962,"2023-10-01",2023
"23-Oct",부산,금정구,286,78233,7154,85673,"2023-10-01",2023
"23-Oct",부산,기장군,265,86234,2875,89374,"2023-10-01",2023
"23-Oct",부산,남구,225,91239,9812,101276,"2023-10-01",2023
"23-Oct",부산,동구,191,44685,5503,50379,"2023-10-01",2023
"23-Oct",부산,동래구,168,97750,3542,101460,"2023-10-01",2023
"23-Oct",부산,부산진구,361,130050,22753,153164,"2023-10-01",2023
"23-Oct",부산,북구,271,102267,3725,106263,"2023-10-01",2023
"23-Oct",부산,사상구,266,83517,5387,89170,"2023-10-01",2023
"23-Oct",부산,사하구,270,108279,6058,114607,"2023-10-01",2023
"23-Oct",부산,서구,138,30407,1509,32054,"2023-10-01",2023
"23-Oct",부산,수영구,167,64875,60296,125338,"2023-10-01",2023
"23-Oct",부산,연제구,995,110985,15628,127608,"2023-10-01",2023
"23-Oct",부산,영도구,229,31885,2100,34214,"2023-10-01",2023
"23-Oct",부산,중구,313,33306,7011,40630,"2023-10-01",2023
"23-Oct",부산,해운대구,328,166152,14366,180846,"2023-10-01",2023
"23-Oct",부산,계,4817,1344931,173270,1523018,"2023-10-01",2023
"23-Oct",대구,군위군,128,15775,135,16038,"2023-10-01",2023
"23-Oct",대구,남구,388,55872,1580,57840,"2023-10-01",2023
"23-Oct",대구,달서구,506,276147,17780,294433,"2023-10-01",2023
"23-Oct",대구,달성군,590,141050,5277,146917,"2023-10-01",2023
"23-Oct",대구,동구,367,161643,10427,172437,"2023-10-01",2023
"23-Oct",대구,북구,544,203221,8157,211922,"2023-10-01",2023
"23-Oct",대구,서구,261,69465,4714,74440,"2023-10-01",2023
"23-Oct",대구,수성구,595,213312,5254,219161,"2023-10-01",2023
"23-Oct",대구,중구,313,59134,2231,61678,"2023-10-01",2023
"23-Oct",대구,계,3692,1195619,55555,1254866,"2023-10-01",2023
"23-Oct",인천,강화군,335,38426,15108,53869,"2023-10-01",2023
"23-Oct",인천,계양구,306,123089,146301,269696,"2023-10-01",2023
"23-Oct",인천,남동구,928,255656,31719,288303,"2023-10-01",2023
"23-Oct",인천,동구,110,24485,2931,27526,"2023-10-01",2023
"23-Oct",인천,미추홀구,446,163399,9233,173078,"2023-10-01",2023
"23-Oct",인천,부평구,347,229442,41993,271782,"2023-10-01",2023
"23-Oct",인천,서구,504,301013,12817,314334,"2023-10-01",2023
"23-Oct",인천,연수구,438,214945,9691,225074,"2023-10-01",2023
"23-Oct",인천,옹진군,254,13201,280,13735,"2023-10-01",2023
"23-Oct",인천,중구,654,76659,12023,89336,"2023-10-01",2023
"23-Oct",인천,계,4322,1440315,282096,1726733,"2023-10-01",2023
"23-Oct",광주,광산구,566,203854,13265,217685,"2023-10-01",2023
"23-Oct",광주,남구,238,93438,2887,96563,"2023-10-01",2023
"23-Oct",광주,동구,249,46962,1056,48267,"2023-10-01",2023
"23-Oct",광주,북구,615,197044,9232,206891,"2023-10-01",2023
"23-Oct",광주,서구,742,144766,6301,151809,"2023-10-01",2023
"23-Oct",광주,계,2410,686064,32741,721215,"2023-10-01",2023
"23-Oct",대전,대덕구,242,87544,7968,95754,"2023-10-01",2023
"23-Oct",대전,동구,255,92749,5009,98013,"2023-10-01",2023
"23-Oct",대전,서구,817,210249,13887,224953,"2023-10-01",2023
"23-Oct",대전,유성구,660,191326,6085,198071,"2023-10-01",2023
"23-Oct",대전,중구,225,96653,5315,102193,"2023-10-01",2023
"23-Oct",대전,계,2199,678521,38264,718984,"2023-10-01",2023
"23-Oct",울산,남구,742,157328,7101,165171,"2023-10-01",2023
"23-Oct",울산,동구,194,63842,1252,65288,"2023-10-01",2023
"23-Oct",울산,북구,227,121577,3764,125568,"2023-10-01",2023
"23-Oct",울산,울주군,444,130010,7042,137496,"2023-10-01",2023
"23-Oct",울산,중구,328,101358,2669,104355,"2023-10-01",2023
"23-Oct",울산,계,1935,574115,21828,597878,"2023-10-01",2023
"23-Oct",세종,세종특별자치시,923,193036,3680,197639,"2023-10-01",2023
"23-Oct",세종,계,923,193036,3680,197639,"2023-10-01",2023
"23-Oct",경기,가평군,426,32891,591,33908,"2023-10-01",2023
"23-Oct",경기,고양시 덕양구,675,197241,5077,202993,"2023-10-01",2023
"23-Oct",경기,고양시 일산동구,269,128750,6480,135499,"2023-10-01",2023
"23-Oct",경기,고양시 일산서구,131,117522,4585,122238,"2023-10-01",2023
"23-Oct",경기,과천시,700,31258,742,32700,"2023-10-01",2023
"23-Oct",경기,광명시,313,100645,4744,105702,"2023-10-01",2023
"23-Oct",경기,광주시,426,204493,9138,214057,"2023-10-01",2023
"23-Oct",경기,구리시,273,71430,3029,74732,"2023-10-01",2023
"23-Oct",경기,군포시,298,99804,5382,105484,"2023-10-01",2023
"23-Oct",경기,김포시,570,236499,9231,246300,"2023-10-01",2023
"23-Oct",경기,남양주시,809,317779,9769,328357,"2023-10-01",2023
"23-Oct",경기,동두천시,228,38587,1532,40347,"2023-10-01",2023
"23-Oct",경기,부천시,728,297091,13478,311297,"2023-10-01",2023
"23-Oct",경기,성남시 분당구,365,189680,8303,198348,"2023-10-01",2023
"23-Oct",경기,성남시 수정구,305,78616,2724,81645,"2023-10-01",2023
"23-Oct",경기,성남시 중원구,389,75231,4101,79721,"2023-10-01",2023
"23-Oct",경기,수원시 권선구,472,201719,9723,211914,"2023-10-01",2023
"23-Oct",경기,수원시 영통구,413,151433,3688,155534,"2023-10-01",2023
"23-Oct",경기,수원시 장안구,490,105805,3683,109978,"2023-10-01",2023
"23-Oct",경기,수원시 팔달구,358,82579,3177,86114,"2023-10-01",2023
"23-Oct",경기,시흥시,460,267522,9032,277014,"2023-10-01",2023
"23-Oct",경기,안산시 단원구,588,163102,7917,171607,"2023-10-01",2023
"23-Oct",경기,안산시 상록구,150,145646,5968,151764,"2023-10-01",2023
"23-Oct",경기,안성시,404,113378,4737,118519,"2023-10-01",2023
"23-Oct",경기,안양시 동안구,404,123550,7041,130995,"2023-10-01",2023
"23-Oct",경기,안양시 만안구,159,85773,3997,89929,"2023-10-01",2023
"23-Oct",경기,양주시,442,130005,4301,134748,"2023-10-01",2023
"23-Oct",경기,양평군,613,65919,1951,68483,"2023-10-01",2023
"23-Oct",경기,여주시,482,68583,7494,76559,"2023-10-01",2023
"23-Oct",경기,연천군,326,24778,5208,30312,"2023-10-01",2023
"23-Oct",경기,오산시,233,113437,4272,117942,"2023-10-01",2023
"23-Oct",경기,용인시 기흥구,122,196702,7738,204562,"2023-10-01",2023
"23-Oct",경기,용인시 수지구,62,151173,2360,153595,"2023-10-01",2023
"23-Oct",경기,용인시 처인구,842,141904,7936,150682,"2023-10-01",2023
"23-Oct",경기,의왕시,309,66419,2899,69627,"2023-10-01",2023
"23-Oct",경기,의정부시,763,174551,5627,180941,"2023-10-01",2023
"23-Oct",경기,이천시,437,123348,6520,130305,"2023-10-01",2023
"23-Oct",경기,파주시,556,241578,11546,253680,"2023-10-01",2023
"23-Oct",경기,평택시,791,326116,14142,341049,"2023-10-01",2023
"23-Oct",경기,포천시,425,89608,7500,97533,"2023-10-01",2023
"23-Oct",경기,하남시,447,140150,3752,144349,"2023-10-01",2023
"23-Oct",경기,화성시,988,510270,14325,525583,"2023-10-01",2023
"23-Oct",경기,계,18641,6222565,255440,6496646,"2023-10-01",2023
"23-Oct",충북,괴산군,221,24007,463,24691,"2023-10-01",2023
"23-Oct",충북,단양군,241,16327,836,17404,"2023-10-01",2023
"23-Oct",충북,보은군,251,18968,945,20164,"2023-10-01",2023
"23-Oct",충북,영동군,269,26249,430,26948,"2023-10-01",2023
"23-Oct",충북,옥천군,217,28735,1093,30045,"2023-10-01",2023
"23-Oct",충북,음성군,285,62579,2044,64908,"2023-10-01",2023
"23-Oct",충북,제천시,351,69776,3505,73632,"2023-10-01",2023
"23-Oct",충북,증평군,98,20822,817,21737,"2023-10-01",2023
"23-Oct",충북,진천군,229,54442,1496,56167,"2023-10-01",2023
"23-Oct",충북,청원군,1,19,0,20,"2023-10-01",2023
"23-Oct",충북,청주시 상당구,515,101687,2700,104902,"2023-10-01",2023
"23-Oct",충북,청주시 서원구,255,99880,4632,104767,"2023-10-01",2023
"23-Oct",충북,청주시 청원구,404,107356,4942,112702,"2023-10-01",2023
"23-Oct",충북,청주시 흥덕구,367,142327,8019,150713,"2023-10-01",2023
"23-Oct",충북,충주시,634,116303,8141,125078,"2023-10-01",2023
"23-Oct",충북,계,4338,889477,40063,933878,"2023-10-01",2023
"23-Oct",충남,계룡시,174,25898,597,26669,"2023-10-01",2023
"23-Oct",충남,공주시,600,56346,2728,59674,"2023-10-01",2023
"23-Oct",충남,금산군,212,30081,2326,32619,"2023-10-01",2023
"23-Oct",충남,논산시,408,62767,2403,65578,"2023-10-01",2023
"23-Oct",충남,당진시,420,104947,4130,109497,"2023-10-01",2023
"23-Oct",충남,보령시,422,54385,1409,56216,"2023-10-01",2023
"23-Oct",충남,부여군,323,35286,969,36578,"2023-10-01",2023
"23-Oct",충남,서산시,442,101950,3695,106087,"2023-10-01",2023
"23-Oct",충남,서천군,244,27889,806,28939,"2023-10-01",2023
"23-Oct",충남,아산시,549,193009,7192,200750,"2023-10-01",2023
"23-Oct",충남,예산군,439,46772,1453,48664,"2023-10-01",2023
"23-Oct",충남,천안시 동남구,307,138972,5527,144806,"2023-10-01",2023
"23-Oct",충남,천안시 서북구,573,205536,5492,211601,"2023-10-01",2023
"23-Oct",충남,청양군,259,17767,713,18739,"2023-10-01",2023
"23-Oct",충남,태안군,338,36141,556,37035,"2023-10-01",2023
"23-Oct",충남,홍성군,411,55028,1459,56898,"2023-10-01",2023
"23-Oct",충남,계,6121,1192774,41455,1240350,"2023-10-01",2023
"23-Oct",전북,고창군,335,31729,580,32644,"2023-10-01",2023
"23-Oct",전북,군산시,555,137092,6460,144107,"2023-10-01",2023
"23-Oct",전북,김제시,333,48423,1969,50725,"2023-10-01",2023
"23-Oct",전북,남원시,426,42715,1365,44506,"2023-10-01",2023
"23-Oct",전북,무주군,221,13675,407,14303,"2023-10-01",2023
"23-Oct",전북,부안군,277,28470,606,29353,"2023-10-01",2023
"23-Oct",전북,순창군,231,15557,160,15948,"2023-10-01",2023
"23-Oct",전북,완주군,450,58435,3140,62025,"2023-10-01",2023
"23-Oct",전북,익산시,561,140852,5908,147321,"2023-10-01",2023
"23-Oct",전북,임실군,257,15031,422,15710,"2023-10-01",2023
"23-Oct",전북,장수군,235,12604,144,12983,"2023-10-01",2023
"23-Oct",전북,전주시 덕진구,384,175708,7103,183195,"2023-10-01",2023
"23-Oct",전북,전주시 완산구,752,155680,4290,160722,"2023-10-01",2023
"23-Oct",전북,정읍시,384,57273,3703,61360,"2023-10-01",2023
"23-Oct",전북,진안군,279,14910,245,15434,"2023-10-01",2023
"23-Oct",전북,계,5680,948154,36502,990336,"2023-10-01",2023
"23-Oct",전남,강진군,259,19307,1029,20595,"2023-10-01",2023
"23-Oct",전남,고흥군,322,33950,592,34864,"2023-10-01",2023
"23-Oct",전남,곡성군,190,15767,638,16595,"2023-10-01",2023
"23-Oct",전남,광양시,255,91491,6201,97947,"2023-10-01",2023
"23-Oct",전남,구례군,179,13517,740,14436,"2023-10-01",2023
"23-Oct",전남,나주시,492,69499,3230,73221,"2023-10-01",2023
"23-Oct",전남,담양군,217,28737,1760,30714,"2023-10-01",2023
"23-Oct",전남,목포시,421,98258,5436,104115,"2023-10-01",2023
"23-Oct",전남,무안군,592,51973,1163,53728,"2023-10-01",2023
"23-Oct",전남,보성군,241,22441,636,23318,"2023-10-01",2023
"23-Oct",전남,순천시,514,147440,5396,153350,"2023-10-01",2023
"23-Oct",전남,신안군,387,23549,97203,121139,"2023-10-01",2023
"23-Oct",전남,여수시,569,137282,7437,145288,"2023-10-01",2023
"23-Oct",전남,영광군,235,29697,789,30721,"2023-10-01",2023
"23-Oct",전남,영암군,276,36346,1152,37774,"2023-10-01",2023
"23-Oct",전남,완도군,302,26485,517,27304,"2023-10-01",2023
"23-Oct",전남,장성군,214,27915,1309,29438,"2023-10-01",2023
"23-Oct",전남,장흥군,282,20691,449,21422,"2023-10-01",2023
"23-Oct",전남,진도군,221,17728,297,18246,"2023-10-01",2023
"23-Oct",전남,함평군,217,19087,10946,30250,"2023-10-01",2023
"23-Oct",전남,해남군,348,41200,80863,122411,"2023-10-01",2023
"23-Oct",전남,화순군,252,34396,2207,36855,"2023-10-01",2023
"23-Oct",전남,계,6985,1006756,229990,1243731,"2023-10-01",2023
"23-Oct",경북,경산시,352,143375,4432,148159,"2023-10-01",2023
"23-Oct",경북,경주시,608,147794,4582,152984,"2023-10-01",2023
"23-Oct",경북,고령군,186,21270,763,22219,"2023-10-01",2023
"23-Oct",경북,구미시,554,220120,7414,228088,"2023-10-01",2023
"23-Oct",경북,군위군,0,64,141,205,"2023-10-01",2023
"23-Oct",경북,김천시,403,78321,2106,80830,"2023-10-01",2023
"23-Oct",경북,문경시,295,38612,914,39821,"2023-10-01",2023
"23-Oct",경북,봉화군,252,18616,196,19064,"2023-10-01",2023
"23-Oct",경북,상주시,416,55647,1876,57939,"2023-10-01",2023
"23-Oct",경북,성주군,215,32146,1349,33710,"2023-10-01",2023
"23-Oct",경북,안동시,752,85360,2651,88763,"2023-10-01",2023
"23-Oct",경북,영덕군,258,19554,305,20117,"2023-10-01",2023
"23-Oct",경북,영양군,148,10146,118,10412,"2023-10-01",2023
"23-Oct",경북,영주시,376,57190,1521,59087,"2023-10-01",2023
"23-Oct",경북,영천시,368,63005,2512,65885,"2023-10-01",2023
"23-Oct",경북,예천군,289,31989,490,32768,"2023-10-01",2023
"23-Oct",경북,울릉군,158,5868,634,6660,"2023-10-01",2023
"23-Oct",경북,울진군,335,27460,357,28152,"2023-10-01",2023
"23-Oct",경북,의성군,308,32699,1106,34113,"2023-10-01",2023
"23-Oct",경북,청도군,225,26195,974,27394,"2023-10-01",2023
"23-Oct",경북,청송군,224,16311,209,16744,"2023-10-01",2023
"23-Oct",경북,칠곡군,311,71235,2513,74059,"2023-10-01",2023
"23-Oct",경북,포항시 남구,449,126300,8268,135017,"2023-10-01",2023
"23-Oct",경북,포항시 북구,385,144673,3614,148672,"2023-10-01",2023
"23-Oct",경북,계,7867,1473950,49045,1530862,"2023-10-01",2023
"23-Oct",경남,거제시,362,109099,2099,111560,"2023-10-01",2023
"23-Oct",경남,거창군,288,34329,793,35410,"2023-10-01",2023
"23-Oct",경남,고성군,239,27922,565,28726,"2023-10-01",2023
"23-Oct",경남,김해시,706,287458,7927,296091,"2023-10-01",2023
"23-Oct",경남,남해군,301,20872,448,21621,"2023-10-01",2023
"23-Oct",경남,밀양시,330,58416,3935,62681,"2023-10-01",2023
"23-Oct",경남,사천시,337,59145,1568,61050,"2023-10-01",2023
"23-Oct",경남,산청군,251,21385,759,22395,"2023-10-01",2023
"23-Oct",경남,양산시,427,176365,10635,187427,"2023-10-01",2023
"23-Oct",경남,의령군,226,15390,769,16385,"2023-10-01",2023
"23-Oct",경남,진주시,667,172790,6714,180171,"2023-10-01",2023
"23-Oct",경남,창녕군,255,36518,750,37523,"2023-10-01",2023
"23-Oct",경남,창원시 마산합포구,355,100514,2877,103746,"2023-10-01",2023
"23-Oct",경남,창원시 마산회원구,157,104650,7050,111857,"2023-10-01",2023
"23-Oct",경남,창원시 성산구,621,168600,61229,230450,"2023-10-01",2023
"23-Oct",경남,창원시 의창구,502,119254,3588,123344,"2023-10-01",2023
"23-Oct",경남,창원시 진해구,230,96818,2077,99125,"2023-10-01",2023
"23-Oct",경남,통영시,313,53599,1368,55280,"2023-10-01",2023
"23-Oct",경남,하동군,238,24498,381,25117,"2023-10-01",2023
"23-Oct",경남,함안군,214,44482,34533,79229,"2023-10-01",2023
"23-Oct",경남,함양군,240,20320,411,20971,"2023-10-01",2023
"23-Oct",경남,합천군,288,24396,638,25322,"2023-10-01",2023
"23-Oct",경남,계,7547,1776820,151114,1935481,"2023-10-01",2023
"23-Oct",제주,서귀포시,769,107757,1873,110399,"2023-10-01",2023
"23-Oct",제주,제주시,1691,311758,277991,591440,"2023-10-01",2023
"23-Oct",제주,계,2460,419515,279864,701839,"2023-10-01",2023
"23-Oct",강원,강릉시,609,114017,4806,119432,"2023-10-01",2023
"23-Oct",강원,고성군,205,16184,236,16625,"2023-10-01",2023
"23-Oct",강원,동해시,329,47781,1549,49659,"2023-10-01",2023
"23-Oct",강원,삼척시,416,33669,833,34918,"2023-10-01",2023
"23-Oct",강원,속초시,314,40747,1467,42528,"2023-10-01",2023
"23-Oct",강원,양구군,224,12542,141,12907,"2023-10-01",2023
"23-Oct",강원,양양군,215,16953,308,17476,"2023-10-01",2023
"23-Oct",강원,영월군,347,21954,395,22696,"2023-10-01",2023
"23-Oct",강원,원주시,645,189466,5964,196075,"2023-10-01",2023
"23-Oct",강원,인제군,240,19950,297,20487,"2023-10-01",2023
"23-Oct",강원,정선군,363,21070,492,21925,"2023-10-01",2023
"23-Oct",강원,철원군,273,24752,338,25363,"2023-10-01",2023
"23-Oct",강원,춘천시,880,142501,6301,149682,"2023-10-01",2023
"23-Oct",강원,태백시,250,20201,697,21148,"2023-10-01",2023
"23-Oct",강원,평창군,326,27016,596,27938,"2023-10-01",2023
"23-Oct",강원,홍천군,445,40858,1042,42345,"2023-10-01",2023
"23-Oct",강원,화천군,235,13391,184,13810,"2023-10-01",2023
"23-Oct",강원,횡성군,280,28663,907,29850,"2023-10-01",2023
"23-Oct",강원,계,6596,831715,26553,864864,"2023-10-01",2023
"23-Nov",서울,강남구,419,230420,21596,252435,"2023-11-01",2023
"23-Nov",서울,강동구,313,144879,8631,153823,"2023-11-01",2023
"23-Nov",서울,강북구,317,70109,4233,74659,"2023-11-01",2023
"23-Nov",서울,강서구,359,189066,16148,205573,"2023-11-01",2023
"23-Nov",서울,관악구,295,112371,5829,118495,"2023-11-01",2023
"23-Nov",서울,광진구,330,92303,5175,97808,"2023-11-01",2023
"23-Nov",서울,구로구,305,134379,13364,148048,"2023-11-01",2023
"23-Nov",서울,금천구,178,85636,6422,92236,"2023-11-01",2023
"23-Nov",서울,노원구,325,143596,8726,152647,"2023-11-01",2023
"23-Nov",서울,도봉구,285,87391,7507,95183,"2023-11-01",2023
"23-Nov",서울,동대문구,308,97029,5273,102610,"2023-11-01",2023
"23-Nov",서울,동작구,303,103633,2660,106596,"2023-11-01",2023
"23-Nov",서울,마포구,340,114302,7787,122429,"2023-11-01",2023
"23-Nov",서울,서대문구,452,85758,5515,91725,"2023-11-01",2023
"23-Nov",서울,서초구,511,166843,9717,177071,"2023-11-01",2023
"23-Nov",서울,성동구,363,92625,11426,104414,"2023-11-01",2023
"23-Nov",서울,성북구,300,117243,5095,122638,"2023-11-01",2023
"23-Nov",서울,송파구,411,229933,14327,244671,"2023-11-01",2023
"23-Nov",서울,양천구,337,142740,8545,151622,"2023-11-01",2023
"23-Nov",서울,영등포구,363,136160,8194,144717,"2023-11-01",2023
"23-Nov",서울,용산구,541,72309,2147,74997,"2023-11-01",2023
"23-Nov",서울,은평구,300,127918,7081,135299,"2023-11-01",2023
"23-Nov",서울,종로구,3489,44747,2464,50700,"2023-11-01",2023
"23-Nov",서울,중구,1303,50495,3092,54890,"2023-11-01",2023
"23-Nov",서울,중랑구,254,106458,9550,116262,"2023-11-01",2023
"23-Nov",서울,계,12701,2978343,200504,3191548,"2023-11-01",2023
"23-Nov",부산,강서구,340,85258,5639,91237,"2023-11-01",2023
"23-Nov",부산,금정구,286,78147,7194,85627,"2023-11-01",2023
"23-Nov",부산,기장군,261,86401,2884,89546,"2023-11-01",2023
"23-Nov",부산,남구,224,91524,9748,101496,"2023-11-01",2023
"23-Nov",부산,동구,190,45443,5509,51142,"2023-11-01",2023
"23-Nov",부산,동래구,167,97713,3567,101447,"2023-11-01",2023
"23-Nov",부산,부산진구,364,130701,23132,154197,"2023-11-01",2023
"23-Nov",부산,북구,272,102285,3714,106271,"2023-11-01",2023
"23-Nov",부산,사상구,263,83676,5343,89282,"2023-11-01",2023
"23-Nov",부산,사하구,267,108300,6044,114611,"2023-11-01",2023
"23-Nov",부산,서구,139,30417,1514,32070,"2023-11-01",2023
"23-Nov",부산,수영구,165,64778,60570,125513,"2023-11-01",2023
"23-Nov",부산,연제구,988,110969,15748,127705,"2023-11-01",2023
"23-Nov",부산,영도구,227,31890,2106,34223,"2023-11-01",2023
"23-Nov",부산,중구,311,33484,6983,40778,"2023-11-01",2023
"23-Nov",부산,해운대구,329,166073,14134,180536,"2023-11-01",2023
"23-Nov",부산,계,4793,1347059,173829,1525681,"2023-11-01",2023
"23-Nov",대구,군위군,127,15788,158,16073,"2023-11-01",2023
"23-Nov",대구,남구,388,55747,1585,57720,"2023-11-01",2023
"23-Nov",대구,달서구,502,275766,17889,294157,"2023-11-01",2023
"23-Nov",대구,달성군,590,141060,5282,146932,"2023-11-01",2023
"23-Nov",대구,동구,366,162547,10528,173441,"2023-11-01",2023
"23-Nov",대구,북구,538,202777,8057,211372,"2023-11-01",2023
"23-Nov",대구,서구,267,70654,4729,75650,"2023-11-01",2023
"23-Nov",대구,수성구,590,213844,5259,219693,"2023-11-01",2023
"23-Nov",대구,중구,311,59160,2231,61702,"2023-11-01",2023
"23-Nov",대구,계,3679,1197343,55718,1256740,"2023-11-01",2023
"23-Nov",인천,강화군,334,38448,14626,53408,"2023-11-01",2023
"23-Nov",인천,계양구,306,123415,141673,265394,"2023-11-01",2023
"23-Nov",인천,남동구,926,256002,31177,288105,"2023-11-01",2023
"23-Nov",인천,동구,110,24457,2930,27497,"2023-11-01",2023
"23-Nov",인천,미추홀구,443,163486,9239,173168,"2023-11-01",2023
"23-Nov",인천,부평구,345,230728,41648,272721,"2023-11-01",2023
"23-Nov",인천,서구,509,302891,12939,316339,"2023-11-01",2023
"23-Nov",인천,연수구,440,216448,9747,226635,"2023-11-01",2023
"23-Nov",인천,옹진군,252,13233,280,13765,"2023-11-01",2023
"23-Nov",인천,중구,653,76946,12000,89599,"2023-11-01",2023
"23-Nov",인천,계,4318,1446054,276259,1726631,"2023-11-01",2023
"23-Nov",광주,광산구,563,204273,13240,218076,"2023-11-01",2023
"23-Nov",광주,남구,237,93521,2862,96620,"2023-11-01",2023
"23-Nov",광주,동구,250,47231,1065,48546,"2023-11-01",2023
"23-Nov",광주,북구,621,197288,9256,207165,"2023-11-01",2023
"23-Nov",광주,서구,749,145226,6294,152269,"2023-11-01",2023
"23-Nov",광주,계,2420,687539,32717,722676,"2023-11-01",2023
"23-Nov",대전,대덕구,244,87652,7518,95414,"2023-11-01",2023
"23-Nov",대전,동구,253,92769,5023,98045,"2023-11-01",2023
"23-Nov",대전,서구,816,210077,15572,226465,"2023-11-01",2023
"23-Nov",대전,유성구,659,192873,6041,199573,"2023-11-01",2023
"23-Nov",대전,중구,225,96527,5322,102074,"2023-11-01",2023
"23-Nov",대전,계,2197,679898,39476,721571,"2023-11-01",2023
"23-Nov",울산,남구,736,157299,7100,165135,"2023-11-01",2023
"23-Nov",울산,동구,196,63949,1254,65399,"2023-11-01",2023
"23-Nov",울산,북구,229,121556,3768,125553,"2023-11-01",2023
"23-Nov",울산,울주군,448,130173,7023,137644,"2023-11-01",2023
"23-Nov",울산,중구,328,102178,2696,105202,"2023-11-01",2023
"23-Nov",울산,계,1937,575155,21841,598933,"2023-11-01",2023
"23-Nov",세종,세종특별자치시,921,193249,3700,197870,"2023-11-01",2023
"23-Nov",세종,계,921,193249,3700,197870,"2023-11-01",2023
"23-Nov",경기,가평군,414,32944,594,33952,"2023-11-01",2023
"23-Nov",경기,고양시 덕양구,672,197548,5077,203297,"2023-11-01",2023
"23-Nov",경기,고양시 일산동구,265,128975,6328,135568,"2023-11-01",2023
"23-Nov",경기,고양시 일산서구,128,117569,4708,122405,"2023-11-01",2023
"23-Nov",경기,과천시,704,31225,744,32673,"2023-11-01",2023
"23-Nov",경기,광명시,311,100894,4735,105940,"2023-11-01",2023
"23-Nov",경기,광주시,425,204675,9174,214274,"2023-11-01",2023
"23-Nov",경기,구리시,274,71414,3038,74726,"2023-11-01",2023
"23-Nov",경기,군포시,297,99697,5392,105386,"2023-11-01",2023
"23-Nov",경기,김포시,569,237035,9253,246857,"2023-11-01",2023
"23-Nov",경기,남양주시,804,318217,9809,328830,"2023-11-01",2023
"23-Nov",경기,동두천시,228,38624,1526,40378,"2023-11-01",2023
"23-Nov",경기,부천시,729,297550,13534,311813,"2023-11-01",2023
"23-Nov",경기,성남시 분당구,363,189625,8165,198153,"2023-11-01",2023
"23-Nov",경기,성남시 수정구,306,80045,2993,83344,"2023-11-01",2023
"23-Nov",경기,성남시 중원구,390,74996,4002,79388,"2023-11-01",2023
"23-Nov",경기,수원시 권선구,470,204500,9712,214682,"2023-11-01",2023
"23-Nov",경기,수원시 영통구,445,151705,3710,155860,"2023-11-01",2023
"23-Nov",경기,수원시 장안구,479,106313,3708,110500,"2023-11-01",2023
"23-Nov",경기,수원시 팔달구,357,82551,3196,86104,"2023-11-01",2023
"23-Nov",경기,시흥시,459,268456,9067,277982,"2023-11-01",2023
"23-Nov",경기,안산시 단원구,588,163463,7912,171963,"2023-11-01",2023
"23-Nov",경기,안산시 상록구,150,145470,5989,151609,"2023-11-01",2023
"23-Nov",경기,안성시,404,113528,4774,118706,"2023-11-01",2023
"23-Nov",경기,안양시 동안구,399,123785,6978,131162,"2023-11-01",2023
"23-Nov",경기,안양시 만안구,158,85705,4003,89866,"2023-11-01",2023
"23-Nov",경기,양주시,434,130756,4304,135494,"2023-11-01",2023
"23-Nov",경기,양평군,615,66225,1942,68782,"2023-11-01",2023
"23-Nov",경기,여주시,474,68827,7552,76853,"2023-11-01",2023
"23-Nov",경기,연천군,327,24788,5186,30301,"2023-11-01",2023
"23-Nov",경기,오산시,232,113532,4305,118069,"2023-11-01",2023
"23-Nov",경기,용인시 기흥구,121,197734,7772,205627,"2023-11-01",2023
"23-Nov",경기,용인시 수지구,60,151216,2359,153635,"2023-11-01",2023
"23-Nov",경기,용인시 처인구,848,142208,7931,150987,"2023-11-01",2023
"23-Nov",경기,의왕시,307,66836,2915,70058,"2023-11-01",2023
"23-Nov",경기,의정부시,754,174580,5646,180980,"2023-11-01",2023
"23-Nov",경기,이천시,437,123449,6540,130426,"2023-11-01",2023
"23-Nov",경기,파주시,553,242013,12238,254804,"2023-11-01",2023
"23-Nov",경기,평택시,790,327032,14123,341945,"2023-11-01",2023
"23-Nov",경기,포천시,422,89713,9921,100056,"2023-11-01",2023
"23-Nov",경기,하남시,442,140396,3736,144574,"2023-11-01",2023
"23-Nov",경기,화성시,987,512295,14304,527586,"2023-11-01",2023
"23-Nov",경기,계,18591,6238109,258895,6515595,"2023-11-01",2023
"23-Nov",충북,괴산군,220,24017,476,24713,"2023-11-01",2023
"23-Nov",충북,단양군,239,16321,838,17398,"2023-11-01",2023
"23-Nov",충북,보은군,254,19014,942,20210,"2023-11-01",2023
"23-Nov",충북,영동군,266,26224,433,26923,"2023-11-01",2023
"23-Nov",충북,옥천군,218,28755,1091,30064,"2023-11-01",2023
"23-Nov",충북,음성군,281,62672,2045,64998,"2023-11-01",2023
"23-Nov",충북,제천시,351,69886,3507,73744,"2023-11-01",2023
"23-Nov",충북,증평군,97,20850,825,21772,"2023-11-01",2023
"23-Nov",충북,진천군,230,54687,1491,56408,"2023-11-01",2023
"23-Nov",충북,청원군,1,19,0,20,"2023-11-01",2023
"23-Nov",충북,청주시 상당구,515,101754,2771,105040,"2023-11-01",2023
"23-Nov",충북,청주시 서원구,264,99681,4558,104503,"2023-11-01",2023
"23-Nov",충북,청주시 청원구,404,107844,4932,113180,"2023-11-01",2023
"23-Nov",충북,청주시 흥덕구,364,142553,8023,150940,"2023-11-01",2023
"23-Nov",충북,충주시,636,116452,8401,125489,"2023-11-01",2023
"23-Nov",충북,계,4340,890729,40333,935402,"2023-11-01",2023
"23-Nov",충남,계룡시,173,25961,605,26739,"2023-11-01",2023
"23-Nov",충남,공주시,601,56423,2785,59809,"2023-11-01",2023
"23-Nov",충남,금산군,213,30095,2350,32658,"2023-11-01",2023
"23-Nov",충남,논산시,414,62670,2406,65490,"2023-11-01",2023
"23-Nov",충남,당진시,421,105301,4157,109879,"2023-11-01",2023
"23-Nov",충남,보령시,422,54414,1408,56244,"2023-11-01",2023
"23-Nov",충남,부여군,323,35315,973,36611,"2023-11-01",2023
"23-Nov",충남,서산시,442,102288,3694,106424,"2023-11-01",2023
"23-Nov",충남,서천군,240,27892,788,28920,"2023-11-01",2023
"23-Nov",충남,아산시,552,194404,7194,202150,"2023-11-01",2023
"23-Nov",충남,예산군,440,46901,1455,48796,"2023-11-01",2023
"23-Nov",충남,천안시 동남구,308,139254,5508,145070,"2023-11-01",2023
"23-Nov",충남,천안시 서북구,569,205628,5504,211701,"2023-11-01",2023
"23-Nov",충남,청양군,261,17877,709,18847,"2023-11-01",2023
"23-Nov",충남,태안군,339,36107,565,37011,"2023-11-01",2023
"23-Nov",충남,홍성군,413,55205,1459,57077,"2023-11-01",2023
"23-Nov",충남,계,6131,1195735,41560,1243426,"2023-11-01",2023
"23-Nov",전북,고창군,340,31814,581,32735,"2023-11-01",2023
"23-Nov",전북,군산시,561,137451,6432,144444,"2023-11-01",2023
"23-Nov",전북,김제시,332,48454,1961,50747,"2023-11-01",2023
"23-Nov",전북,남원시,428,42757,1344,44529,"2023-11-01",2023
"23-Nov",전북,무주군,220,13683,408,14311,"2023-11-01",2023
"23-Nov",전북,부안군,282,28412,608,29302,"2023-11-01",2023
"23-Nov",전북,순창군,235,15640,159,16034,"2023-11-01",2023
"23-Nov",전북,완주군,464,58744,3155,62363,"2023-11-01",2023
"23-Nov",전북,익산시,557,140953,5898,147408,"2023-11-01",2023
"23-Nov",전북,임실군,257,15029,424,15710,"2023-11-01",2023
"23-Nov",전북,장수군,234,12614,145,12993,"2023-11-01",2023
"23-Nov",전북,전주시 덕진구,385,176062,7108,183555,"2023-11-01",2023
"23-Nov",전북,전주시 완산구,757,155864,4328,160949,"2023-11-01",2023
"23-Nov",전북,정읍시,382,57241,3632,61255,"2023-11-01",2023
"23-Nov",전북,진안군,283,14885,250,15418,"2023-11-01",2023
"23-Nov",전북,계,5717,949603,36433,991753,"2023-11-01",2023
"23-Nov",전남,강진군,258,19360,1029,20647,"2023-11-01",2023
"23-Nov",전남,고흥군,321,34069,593,34983,"2023-11-01",2023
"23-Nov",전남,곡성군,188,15815,638,16641,"2023-11-01",2023
"23-Nov",전남,광양시,255,91839,6196,98290,"2023-11-01",2023
"23-Nov",전남,구례군,178,13549,738,14465,"2023-11-01",2023
"23-Nov",전남,나주시,494,69699,3212,73405,"2023-11-01",2023
"23-Nov",전남,담양군,219,28742,1783,30744,"2023-11-01",2023
"23-Nov",전남,목포시,420,98436,5421,104277,"2023-11-01",2023
"23-Nov",전남,무안군,592,52102,1172,53866,"2023-11-01",2023
"23-Nov",전남,보성군,241,22465,641,23347,"2023-11-01",2023
"23-Nov",전남,순천시,513,147874,5392,153779,"2023-11-01",2023
"23-Nov",전남,신안군,383,23669,98228,122280,"2023-11-01",2023
"23-Nov",전남,여수시,563,137586,7479,145628,"2023-11-01",2023
"23-Nov",전남,영광군,238,29698,789,30725,"2023-11-01",2023
"23-Nov",전남,영암군,277,36354,1136,37767,"2023-11-01",2023
"23-Nov",전남,완도군,300,26506,514,27320,"2023-11-01",2023
"23-Nov",전남,장성군,214,27912,1304,29430,"2023-11-01",2023
"23-Nov",전남,장흥군,286,20755,448,21489,"2023-11-01",2023
"23-Nov",전남,진도군,224,17792,299,18315,"2023-11-01",2023
"23-Nov",전남,함평군,215,19158,9656,29029,"2023-11-01",2023
"23-Nov",전남,해남군,354,41307,82133,123794,"2023-11-01",2023
"23-Nov",전남,화순군,254,34457,2191,36902,"2023-11-01",2023
"23-Nov",전남,계,6987,1009144,230992,1247123,"2023-11-01",2023
"23-Nov",경북,경산시,382,143454,4438,148274,"2023-11-01",2023
"23-Nov",경북,경주시,602,147982,4578,153162,"2023-11-01",2023
"23-Nov",경북,고령군,185,21309,763,22257,"2023-11-01",2023
"23-Nov",경북,구미시,556,220520,7457,228533,"2023-11-01",2023
"23-Nov",경북,군위군,0,62,91,153,"2023-11-01",2023
"23-Nov",경북,김천시,408,78340,2110,80858,"2023-11-01",2023
"23-Nov",경북,문경시,296,38630,904,39830,"2023-11-01",2023
"23-Nov",경북,봉화군,253,18589,195,19037,"2023-11-01",2023
"23-Nov",경북,상주시,414,55709,1878,58001,"2023-11-01",2023
"23-Nov",경북,성주군,216,32163,1355,33734,"2023-11-01",2023
"23-Nov",경북,안동시,759,85440,2636,88835,"2023-11-01",2023
"23-Nov",경북,영덕군,259,19559,303,20121,"2023-11-01",2023
"23-Nov",경북,영양군,148,10168,115,10431,"2023-11-01",2023
"23-Nov",경북,영주시,377,57314,1517,59208,"2023-11-01",2023
"23-Nov",경북,영천시,364,63223,2531,66118,"2023-11-01",2023
"23-Nov",경북,예천군,288,32031,487,32806,"2023-11-01",2023
"23-Nov",경북,울릉군,157,5902,642,6701,"2023-11-01",2023
"23-Nov",경북,울진군,340,27535,358,28233,"2023-11-01",2023
"23-Nov",경북,의성군,307,32770,1132,34209,"2023-11-01",2023
"23-Nov",경북,청도군,225,26189,964,27378,"2023-11-01",2023
"23-Nov",경북,청송군,227,16312,211,16750,"2023-11-01",2023
"23-Nov",경북,칠곡군,314,71345,2501,74160,"2023-11-01",2023
"23-Nov",경북,포항시 남구,441,126563,8241,135245,"2023-11-01",2023
"23-Nov",경북,포항시 북구,385,144968,3616,148969,"2023-11-01",2023
"23-Nov",경북,계,7903,1476077,49023,1533003,"2023-11-01",2023
"23-Nov",경남,거제시,363,109343,2106,111812,"2023-11-01",2023
"23-Nov",경남,거창군,287,34406,799,35492,"2023-11-01",2023
"23-Nov",경남,고성군,240,27938,561,28739,"2023-11-01",2023
"23-Nov",경남,김해시,693,288221,7957,296871,"2023-11-01",2023
"23-Nov",경남,남해군,302,20865,443,21610,"2023-11-01",2023
"23-Nov",경남,밀양시,324,58472,3933,62729,"2023-11-01",2023
"23-Nov",경남,사천시,339,59233,1570,61142,"2023-11-01",2023
"23-Nov",경남,산청군,251,21380,756,22387,"2023-11-01",2023
"23-Nov",경남,양산시,427,177046,10678,188151,"2023-11-01",2023
"23-Nov",경남,의령군,223,15398,760,16381,"2023-11-01",2023
"23-Nov",경남,진주시,664,172967,6707,180338,"2023-11-01",2023
"23-Nov",경남,창녕군,255,36504,743,37502,"2023-11-01",2023
"23-Nov",경남,창원시 마산합포구,350,100872,2893,104115,"2023-11-01",2023
"23-Nov",경남,창원시 마산회원구,156,105259,7266,112681,"2023-11-01",2023
"23-Nov",경남,창원시 성산구,622,169101,61610,231333,"2023-11-01",2023
"23-Nov",경남,창원시 의창구,502,119213,3770,123485,"2023-11-01",2023
"23-Nov",경남,창원시 진해구,229,96853,2082,99164,"2023-11-01",2023
"23-Nov",경남,통영시,312,53638,1370,55320,"2023-11-01",2023
"23-Nov",경남,하동군,238,24501,384,25123,"2023-11-01",2023
"23-Nov",경남,함안군,214,45113,35373,80700,"2023-11-01",2023
"23-Nov",경남,함양군,238,20366,410,21014,"2023-11-01",2023
"23-Nov",경남,합천군,285,24412,641,25338,"2023-11-01",2023
"23-Nov",경남,계,7514,1781101,152812,1941427,"2023-11-01",2023
"23-Nov",제주,서귀포시,766,107868,1875,110509,"2023-11-01",2023
"23-Nov",제주,제주시,1687,312844,277574,592105,"2023-11-01",2023
"23-Nov",제주,계,2453,420712,279449,702614,"2023-11-01",2023
"23-Nov",강원,강릉시,615,114120,4859,119594,"2023-11-01",2023
"23-Nov",강원,고성군,203,16223,234,16660,"2023-11-01",2023
"23-Nov",강원,동해시,327,47814,1556,49697,"2023-11-01",2023
"23-Nov",강원,삼척시,417,33706,839,34962,"2023-11-01",2023
"23-Nov",강원,속초시,316,40773,1461,42550,"2023-11-01",2023
"23-Nov",강원,양구군,224,12564,140,12928,"2023-11-01",2023
"23-Nov",강원,양양군,216,16986,302,17504,"2023-11-01",2023
"23-Nov",강원,영월군,348,21961,396,22705,"2023-11-01",2023
"23-Nov",강원,원주시,650,189812,5955,196417,"2023-11-01",2023
"23-Nov",강원,인제군,236,20019,292,20547,"2023-11-01",2023
"23-Nov",강원,정선군,364,21089,492,21945,"2023-11-01",2023
"23-Nov",강원,철원군,274,24759,352,25385,"2023-11-01",2023
"23-Nov",강원,춘천시,881,142677,6281,149839,"2023-11-01",2023
"23-Nov",강원,태백시,251,20212,671,21134,"2023-11-01",2023
"23-Nov",강원,평창군,327,27119,617,28063,"2023-11-01",2023
"23-Nov",강원,홍천군,443,40893,1030,42366,"2023-11-01",2023
"23-Nov",강원,화천군,233,13335,185,13753,"2023-11-01",2023
"23-Nov",강원,횡성군,283,28740,911,29934,"2023-11-01",2023
"23-Nov",강원,계,6608,832802,26573,865983,"2023-11-01",2023
"23-Dec",서울,강남구,412,232181,21263,253856,"2023-12-01",2023
"23-Dec",서울,강동구,309,145096,8615,154020,"2023-12-01",2023
"23-Dec",서울,강북구,316,69993,4240,74549,"2023-12-01",2023
"23-Dec",서울,강서구,364,189416,16041,205821,"2023-12-01",2023
"23-Dec",서울,관악구,295,112171,5837,118303,"2023-12-01",2023
"23-Dec",서울,광진구,331,92125,5171,97627,"2023-12-01",2023
"23-Dec",서울,구로구,306,134195,13317,147818,"2023-12-01",2023
"23-Dec",서울,금천구,172,85570,6397,92139,"2023-12-01",2023
"23-Dec",서울,노원구,325,143458,8727,152510,"2023-12-01",2023
"23-Dec",서울,도봉구,278,87370,7479,95127,"2023-12-01",2023
"23-Dec",서울,동대문구,307,96998,5332,102637,"2023-12-01",2023
"23-Dec",서울,동작구,295,103537,2664,106496,"2023-12-01",2023
"23-Dec",서울,마포구,343,114180,7786,122309,"2023-12-01",2023
"23-Dec",서울,서대문구,449,85674,5525,91648,"2023-12-01",2023
"23-Dec",서울,서초구,513,166929,9661,177103,"2023-12-01",2023
"23-Dec",서울,성동구,372,92704,11340,104416,"2023-12-01",2023
"23-Dec",서울,성북구,297,117134,5074,122505,"2023-12-01",2023
"23-Dec",서울,송파구,407,229562,14330,244299,"2023-12-01",2023
"23-Dec",서울,양천구,335,142532,8542,151409,"2023-12-01",2023
"23-Dec",서울,영등포구,364,136127,8172,144663,"2023-12-01",2023
"23-Dec",서울,용산구,538,72075,2157,74770,"2023-12-01",2023
"23-Dec",서울,은평구,301,127774,7094,135169,"2023-12-01",2023
"23-Dec",서울,종로구,3562,44723,2483,50768,"2023-12-01",2023
"23-Dec",서울,중구,1357,50366,3049,54772,"2023-12-01",2023
"23-Dec",서울,중랑구,251,106591,9586,116428,"2023-12-01",2023
"23-Dec",서울,계,12799,2978481,199882,3191162,"2023-12-01",2023
"23-Dec",부산,강서구,339,85236,5611,91186,"2023-12-01",2023
"23-Dec",부산,금정구,280,77900,7188,85368,"2023-12-01",2023
"23-Dec",부산,기장군,259,86474,2893,89626,"2023-12-01",2023
"23-Dec",부산,남구,225,91478,9869,101572,"2023-12-01",2023
"23-Dec",부산,동구,189,46048,5427,51664,"2023-12-01",2023
"23-Dec",부산,동래구,166,97480,3576,101222,"2023-12-01",2023
"23-Dec",부산,부산진구,365,131063,23402,154830,"2023-12-01",2023
"23-Dec",부산,북구,273,102168,3721,106162,"2023-12-01",2023
"23-Dec",부산,사상구,264,83764,5340,89368,"2023-12-01",2023
"23-Dec",부산,사하구,270,108300,6051,114621,"2023-12-01",2023
"23-Dec",부산,서구,139,30423,1515,32077,"2023-12-01",2023
"23-Dec",부산,수영구,165,64696,60567,125428,"2023-12-01",2023
"23-Dec",부산,연제구,990,112173,15982,129145,"2023-12-01",2023
"23-Dec",부산,영도구,226,31868,2116,34210,"2023-12-01",2023
"23-Dec",부산,중구,310,33528,7002,40840,"2023-12-01",2023
"23-Dec",부산,해운대구,329,166132,13968,180429,"2023-12-01",2023
"23-Dec",부산,계,4789,1348731,174228,1527748,"2023-12-01",2023
"23-Dec",대구,군위군,130,15759,241,16130,"2023-12-01",2023
"23-Dec",대구,남구,393,55531,1583,57507,"2023-12-01",2023
"23-Dec",대구,달서구,497,275474,17998,293969,"2023-12-01",2023
"23-Dec",대구,달성군,595,141068,5225,146888,"2023-12-01",2023
"23-Dec",대구,동구,370,162930,10530,173830,"2023-12-01",2023
"23-Dec",대구,북구,548,202215,8065,210828,"2023-12-01",2023
"23-Dec",대구,서구,268,71469,4675,76412,"2023-12-01",2023
"23-Dec",대구,수성구,592,214350,5257,220199,"2023-12-01",2023
"23-Dec",대구,중구,328,59677,2252,62257,"2023-12-01",2023
"23-Dec",대구,계,3721,1198473,55826,1258020,"2023-12-01",2023
"23-Dec",인천,강화군,338,38404,14418,53160,"2023-12-01",2023
"23-Dec",인천,계양구,307,123438,142088,265833,"2023-12-01",2023
"23-Dec",인천,남동구,926,257626,30658,289210,"2023-12-01",2023
"23-Dec",인천,동구,110,24450,2939,27499,"2023-12-01",2023
"23-Dec",인천,미추홀구,439,163806,9285,173530,"2023-12-01",2023
"23-Dec",인천,부평구,345,231794,41364,273503,"2023-12-01",2023
"23-Dec",인천,서구,512,303222,12963,316697,"2023-12-01",2023
"23-Dec",인천,연수구,433,217621,9878,227932,"2023-12-01",2023
"23-Dec",인천,옹진군,256,13179,281,13716,"2023-12-01",2023
"23-Dec",인천,중구,659,77129,11971,89759,"2023-12-01",2023
"23-Dec",인천,계,4325,1450669,275845,1730839,"2023-12-01",2023
"23-Dec",광주,광산구,559,204371,13174,218104,"2023-12-01",2023
"23-Dec",광주,남구,239,93461,2858,96558,"2023-12-01",2023
"23-Dec",광주,동구,252,47274,1013,48539,"2023-12-01",2023
"23-Dec",광주,북구,621,197372,9422,207415,"2023-12-01",2023
"23-Dec",광주,서구,752,145686,6202,152640,"2023-12-01",2023
"23-Dec",광주,계,2423,688164,32669,723256,"2023-12-01",2023
"23-Dec",대전,대덕구,243,87747,7499,95489,"2023-12-01",2023
"23-Dec",대전,동구,254,92721,5033,98008,"2023-12-01",2023
"23-Dec",대전,서구,817,209880,16738,227435,"2023-12-01",2023
"23-Dec",대전,유성구,669,193733,6079,200481,"2023-12-01",2023
"23-Dec",대전,중구,225,96449,5287,101961,"2023-12-01",2023
"23-Dec",대전,계,2208,680530,40636,723374,"2023-12-01",2023
"23-Dec",울산,남구,744,157055,7173,164972,"2023-12-01",2023
"23-Dec",울산,동구,197,63993,1275,65465,"2023-12-01",2023
"23-Dec",울산,북구,229,121856,3786,125871,"2023-12-01",2023
"23-Dec",울산,울주군,456,130143,7037,137636,"2023-12-01",2023
"23-Dec",울산,중구,330,102288,2704,105322,"2023-12-01",2023
"23-Dec",울산,계,1956,575335,21975,599266,"2023-12-01",2023
"23-Dec",세종,세종특별자치시,920,193423,3767,198110,"2023-12-01",2023
"23-Dec",세종,계,920,193423,3767,198110,"2023-12-01",2023
"23-Dec",경기,가평군,411,33074,585,34070,"2023-12-01",2023
"23-Dec",경기,고양시 덕양구,675,197645,5117,203437,"2023-12-01",2023
"23-Dec",경기,고양시 일산동구,265,128907,6335,135507,"2023-12-01",2023
"23-Dec",경기,고양시 일산서구,129,117701,4724,122554,"2023-12-01",2023
"23-Dec",경기,과천시,700,31241,748,32689,"2023-12-01",2023
"23-Dec",경기,광명시,310,101089,4692,106091,"2023-12-01",2023
"23-Dec",경기,광주시,424,204755,9172,214351,"2023-12-01",2023
"23-Dec",경기,구리시,273,71289,3022,74584,"2023-12-01",2023
"23-Dec",경기,군포시,302,99482,5351,105135,"2023-12-01",2023
"23-Dec",경기,김포시,568,237102,9319,246989,"2023-12-01",2023
"23-Dec",경기,남양주시,802,318520,9882,329204,"2023-12-01",2023
"23-Dec",경기,동두천시,223,38648,1534,40405,"2023-12-01",2023
"23-Dec",경기,부천시,722,297550,13612,311884,"2023-12-01",2023
"23-Dec",경기,성남시 분당구,364,189246,8161,197771,"2023-12-01",2023
"23-Dec",경기,성남시 수정구,303,81073,2950,84326,"2023-12-01",2023
"23-Dec",경기,성남시 중원구,393,74707,4016,79116,"2023-12-01",2023
"23-Dec",경기,수원시 권선구,474,206389,9779,216642,"2023-12-01",2023
"23-Dec",경기,수원시 영통구,457,151715,3689,155861,"2023-12-01",2023
"23-Dec",경기,수원시 장안구,478,106674,3770,110922,"2023-12-01",2023
"23-Dec",경기,수원시 팔달구,341,82480,3214,86035,"2023-12-01",2023
"23-Dec",경기,시흥시,458,268812,9114,278384,"2023-12-01",2023
"23-Dec",경기,안산시 단원구,590,163832,7941,172363,"2023-12-01",2023
"23-Dec",경기,안산시 상록구,149,145223,5975,151347,"2023-12-01",2023
"23-Dec",경기,안성시,403,113415,4809,118627,"2023-12-01",2023
"23-Dec",경기,안양시 동안구,399,124499,6979,131877,"2023-12-01",2023
"23-Dec",경기,안양시 만안구,158,85450,3981,89589,"2023-12-01",2023
"23-Dec",경기,양주시,441,131612,4348,136401,"2023-12-01",2023
"23-Dec",경기,양평군,618,66392,1950,68960,"2023-12-01",2023
"23-Dec",경기,여주시,472,68969,7578,77019,"2023-12-01",2023
"23-Dec",경기,연천군,329,24794,4966,30089,"2023-12-01",2023
"23-Dec",경기,오산시,230,113663,4318,118211,"2023-12-01",2023
"23-Dec",경기,용인시 기흥구,120,198364,7782,206266,"2023-12-01",2023
"23-Dec",경기,용인시 수지구,60,151090,2369,153519,"2023-12-01",2023
"23-Dec",경기,용인시 처인구,852,142376,8116,151344,"2023-12-01",2023
"23-Dec",경기,의왕시,306,66829,2923,70058,"2023-12-01",2023
"23-Dec",경기,의정부시,747,174631,5660,181038,"2023-12-01",2023
"23-Dec",경기,이천시,437,123582,6518,130537,"2023-12-01",2023
"23-Dec",경기,파주시,556,242311,12233,255100,"2023-12-01",2023
"23-Dec",경기,평택시,787,327778,14211,342776,"2023-12-01",2023
"23-Dec",경기,포천시,425,89677,9718,99820,"2023-12-01",2023
"23-Dec",경기,하남시,443,140387,3760,144590,"2023-12-01",2023
"23-Dec",경기,화성시,989,514231,14390,529610,"2023-12-01",2023
"23-Dec",경기,계,18583,6247204,259311,6525098,"2023-12-01",2023
"23-Dec",충북,괴산군,222,24134,479,24835,"2023-12-01",2023
"23-Dec",충북,단양군,237,16345,837,17419,"2023-12-01",2023
"23-Dec",충북,보은군,253,18984,937,20174,"2023-12-01",2023
"23-Dec",충북,영동군,266,26169,437,26872,"2023-12-01",2023
"23-Dec",충북,옥천군,218,28771,1081,30070,"2023-12-01",2023
"23-Dec",충북,음성군,275,62670,2045,64990,"2023-12-01",2023
"23-Dec",충북,제천시,350,69916,3507,73773,"2023-12-01",2023
"23-Dec",충북,증평군,98,20888,820,21806,"2023-12-01",2023
"23-Dec",충북,진천군,230,54929,1513,56672,"2023-12-01",2023
"23-Dec",충북,청원군,1,19,0,20,"2023-12-01",2023
"23-Dec",충북,청주시 상당구,512,101887,2784,105183,"2023-12-01",2023
"23-Dec",충북,청주시 서원구,256,99437,4571,104264,"2023-12-01",2023
"23-Dec",충북,청주시 청원구,408,107912,4954,113274,"2023-12-01",2023
"23-Dec",충북,청주시 흥덕구,366,142653,8004,151023,"2023-12-01",2023
"23-Dec",충북,충주시,637,116572,8685,125894,"2023-12-01",2023
"23-Dec",충북,계,4329,891286,40654,936269,"2023-12-01",2023
"23-Dec",충남,계룡시,173,26037,615,26825,"2023-12-01",2023
"23-Dec",충남,공주시,611,56507,2650,59768,"2023-12-01",2023
"23-Dec",충남,금산군,212,30093,2370,32675,"2023-12-01",2023
"23-Dec",충남,논산시,415,62546,2381,65342,"2023-12-01",2023
"23-Dec",충남,당진시,421,105329,4165,109915,"2023-12-01",2023
"23-Dec",충남,보령시,422,54325,1401,56148,"2023-12-01",2023
"23-Dec",충남,부여군,324,35337,974,36635,"2023-12-01",2023
"23-Dec",충남,서산시,445,102393,3727,106565,"2023-12-01",2023
"23-Dec",충남,서천군,238,27956,797,28991,"2023-12-01",2023
"23-Dec",충남,아산시,557,195649,7159,203365,"2023-12-01",2023
"23-Dec",충남,예산군,446,46977,1460,48883,"2023-12-01",2023
"23-Dec",충남,천안시 동남구,311,139595,5574,145480,"2023-12-01",2023
"23-Dec",충남,천안시 서북구,566,205654,5503,211723,"2023-12-01",2023
"23-Dec",충남,청양군,263,17940,708,18911,"2023-12-01",2023
"23-Dec",충남,태안군,341,36152,573,37066,"2023-12-01",2023
"23-Dec",충남,홍성군,415,55288,1451,57154,"2023-12-01",2023
"23-Dec",충남,계,6160,1197778,41508,1245446,"2023-12-01",2023
"23-Dec",전북,고창군,340,31837,585,32762,"2023-12-01",2023
"23-Dec",전북,군산시,564,137584,6405,144553,"2023-12-01",2023
"23-Dec",전북,김제시,339,48458,1981,50778,"2023-12-01",2023
"23-Dec",전북,남원시,433,42776,1338,44547,"2023-12-01",2023
"23-Dec",전북,무주군,220,13720,408,14348,"2023-12-01",2023
"23-Dec",전북,부안군,288,28416,605,29309,"2023-12-01",2023
"23-Dec",전북,순창군,236,15676,156,16068,"2023-12-01",2023
"23-Dec",전북,완주군,469,59002,3161,62632,"2023-12-01",2023
"23-Dec",전북,익산시,558,141149,5891,147598,"2023-12-01",2023
"23-Dec",전북,임실군,255,15022,427,15704,"2023-12-01",2023
"23-Dec",전북,장수군,233,12622,146,13001,"2023-12-01",2023
"23-Dec",전북,전주시 덕진구,385,176125,7166,183676,"2023-12-01",2023
"23-Dec",전북,전주시 완산구,760,155732,4309,160801,"2023-12-01",2023
"23-Dec",전북,정읍시,384,57383,3525,61292,"2023-12-01",2023
"23-Dec",전북,진안군,291,14902,254,15447,"2023-12-01",2023
"23-Dec",전북,계,5755,950404,36357,992516,"2023-12-01",2023
"23-Dec",전남,강진군,255,19413,1026,20694,"2023-12-01",2023
"23-Dec",전남,고흥군,317,34143,587,35047,"2023-12-01",2023
"23-Dec",전남,곡성군,186,15849,646,16681,"2023-12-01",2023
"23-Dec",전남,광양시,259,92161,6258,98678,"2023-12-01",2023
"23-Dec",전남,구례군,175,13526,753,14454,"2023-12-01",2023
"23-Dec",전남,나주시,497,69813,3154,73464,"2023-12-01",2023
"23-Dec",전남,담양군,220,28796,1786,30802,"2023-12-01",2023
"23-Dec",전남,목포시,420,98515,5417,104352,"2023-12-01",2023
"23-Dec",전남,무안군,596,52172,1182,53950,"2023-12-01",2023
"23-Dec",전남,보성군,242,22494,645,23381,"2023-12-01",2023
"23-Dec",전남,순천시,512,148203,5384,154099,"2023-12-01",2023
"23-Dec",전남,신안군,383,23653,99875,123911,"2023-12-01",2023
"23-Dec",전남,여수시,567,137655,7467,145689,"2023-12-01",2023
"23-Dec",전남,영광군,239,29684,789,30712,"2023-12-01",2023
"23-Dec",전남,영암군,272,36529,1099,37900,"2023-12-01",2023
"23-Dec",전남,완도군,298,26516,509,27323,"2023-12-01",2023
"23-Dec",전남,장성군,214,28026,1289,29529,"2023-12-01",2023
"23-Dec",전남,장흥군,279,20787,450,21516,"2023-12-01",2023
"23-Dec",전남,진도군,225,17800,302,18327,"2023-12-01",2023
"23-Dec",전남,함평군,219,19239,9067,28525,"2023-12-01",2023
"23-Dec",전남,해남군,354,41401,82773,124528,"2023-12-01",2023
"23-Dec",전남,화순군,254,34430,2140,36824,"2023-12-01",2023
"23-Dec",전남,계,6983,1010805,232598,1250386,"2023-12-01",2023
"23-Dec",경북,경산시,382,143585,4439,148406,"2023-12-01",2023
"23-Dec",경북,경주시,610,147921,4536,153067,"2023-12-01",2023
"23-Dec",경북,고령군,186,21243,825,22254,"2023-12-01",2023
"23-Dec",경북,구미시,561,220799,7443,228803,"2023-12-01",2023
"23-Dec",경북,군위군,0,61,7,68,"2023-12-01",2023
"23-Dec",경북,김천시,411,78259,2118,80788,"2023-12-01",2023
"23-Dec",경북,문경시,303,38627,891,39821,"2023-12-01",2023
"23-Dec",경북,봉화군,254,18595,194,19043,"2023-12-01",2023
"23-Dec",경북,상주시,415,55800,1869,58084,"2023-12-01",2023
"23-Dec",경북,성주군,225,32199,1345,33769,"2023-12-01",2023
"23-Dec",경북,안동시,782,85432,2626,88840,"2023-12-01",2023
"23-Dec",경북,영덕군,262,19568,306,20136,"2023-12-01",2023
"23-Dec",경북,영양군,149,10181,115,10445,"2023-12-01",2023
"23-Dec",경북,영주시,372,57375,1519,59266,"2023-12-01",2023
"23-Dec",경북,영천시,361,63350,2520,66231,"2023-12-01",2023
"23-Dec",경북,예천군,285,32045,487,32817,"2023-12-01",2023
"23-Dec",경북,울릉군,156,5902,635,6693,"2023-12-01",2023
"23-Dec",경북,울진군,342,27584,360,28286,"2023-12-01",2023
"23-Dec",경북,의성군,306,32836,1127,34269,"2023-12-01",2023
"23-Dec",경북,청도군,226,26193,958,27377,"2023-12-01",2023
"23-Dec",경북,청송군,227,16338,211,16776,"2023-12-01",2023
"23-Dec",경북,칠곡군,318,71264,2462,74044,"2023-12-01",2023
"23-Dec",경북,포항시 남구,446,126760,8242,135448,"2023-12-01",2023
"23-Dec",경북,포항시 북구,386,145186,3628,149200,"2023-12-01",2023
"23-Dec",경북,계,7965,1477103,48863,1533931,"2023-12-01",2023
"23-Dec",경남,거제시,365,109514,2089,111968,"2023-12-01",2023
"23-Dec",경남,거창군,293,34459,797,35549,"2023-12-01",2023
"23-Dec",경남,고성군,239,28016,557,28812,"2023-12-01",2023
"23-Dec",경남,김해시,684,288646,7975,297305,"2023-12-01",2023
"23-Dec",경남,남해군,306,20818,447,21571,"2023-12-01",2023
"23-Dec",경남,밀양시,327,58531,3908,62766,"2023-12-01",2023
"23-Dec",경남,사천시,332,59314,1544,61190,"2023-12-01",2023
"23-Dec",경남,산청군,253,21406,755,22414,"2023-12-01",2023
"23-Dec",경남,양산시,432,177039,10709,188180,"2023-12-01",2023
"23-Dec",경남,의령군,225,15364,753,16342,"2023-12-01",2023
"23-Dec",경남,진주시,658,172997,6681,180336,"2023-12-01",2023
"23-Dec",경남,창녕군,250,36504,752,37506,"2023-12-01",2023
"23-Dec",경남,창원시 마산합포구,349,101278,2901,104528,"2023-12-01",2023
"23-Dec",경남,창원시 마산회원구,156,105534,7454,113144,"2023-12-01",2023
"23-Dec",경남,창원시 성산구,616,169547,61863,232026,"2023-12-01",2023
"23-Dec",경남,창원시 의창구,508,119157,3786,123451,"2023-12-01",2023
"23-Dec",경남,창원시 진해구,230,96807,2093,99130,"2023-12-01",2023
"23-Dec",경남,통영시,315,53613,1362,55290,"2023-12-01",2023
"23-Dec",경남,하동군,242,24471,384,25097,"2023-12-01",2023
"23-Dec",경남,함안군,216,45044,35496,80756,"2023-12-01",2023
"23-Dec",경남,함양군,239,20381,508,21128,"2023-12-01",2023
"23-Dec",경남,합천군,287,24436,637,25360,"2023-12-01",2023
"23-Dec",경남,계,7522,1782876,153451,1943849,"2023-12-01",2023
"23-Dec",제주,서귀포시,766,107816,1880,110462,"2023-12-01",2023
"23-Dec",제주,제주시,1686,313929,277214,592829,"2023-12-01",2023
"23-Dec",제주,계,2452,421745,279094,703291,"2023-12-01",2023
"23-Dec",강원,강릉시,613,114164,4915,119692,"2023-12-01",2023
"23-Dec",강원,고성군,203,16170,234,16607,"2023-12-01",2023
"23-Dec",강원,동해시,329,47815,1553,49697,"2023-12-01",2023
"23-Dec",강원,삼척시,423,33797,841,35061,"2023-12-01",2023
"23-Dec",강원,속초시,317,40823,1495,42635,"2023-12-01",2023
"23-Dec",강원,양구군,228,12564,137,12929,"2023-12-01",2023
"23-Dec",강원,양양군,217,16990,298,17505,"2023-12-01",2023
"23-Dec",강원,영월군,350,21969,400,22719,"2023-12-01",2023
"23-Dec",강원,원주시,652,190032,5993,196677,"2023-12-01",2023
"23-Dec",강원,인제군,234,20007,292,20533,"2023-12-01",2023
"23-Dec",강원,정선군,365,21056,522,21943,"2023-12-01",2023
"23-Dec",강원,철원군,270,24768,337,25375,"2023-12-01",2023
"23-Dec",강원,춘천시,876,142667,6292,149835,"2023-12-01",2023
"23-Dec",강원,태백시,248,20262,667,21177,"2023-12-01",2023
"23-Dec",강원,평창군,328,27178,656,28162,"2023-12-01",2023
"23-Dec",강원,홍천군,451,40930,1026,42407,"2023-12-01",2023
"23-Dec",강원,화천군,230,13323,184,13737,"2023-12-01",2023
"23-Dec",강원,횡성군,286,28740,923,29949,"2023-12-01",2023
"23-Dec",강원,계,6620,833255,26765,866640,"2023-12-01",2023
"24-Jan",서울,강남구,409,233353,21041,254803,"2024-01-01",2024
"24-Jan",서울,강동구,311,145157,8610,154078,"2024-01-01",2024
"24-Jan",서울,강북구,318,69919,4240,74477,"2024-01-01",2024
"24-Jan",서울,강서구,367,189321,15841,205529,"2024-01-01",2024
"24-Jan",서울,관악구,295,112152,5831,118278,"2024-01-01",2024
"24-Jan",서울,광진구,324,92098,5152,97574,"2024-01-01",2024
"24-Jan",서울,구로구,305,134199,13277,147781,"2024-01-01",2024
"24-Jan",서울,금천구,172,85532,6355,92059,"2024-01-01",2024
"24-Jan",서울,노원구,326,143407,8675,152408,"2024-01-01",2024
"24-Jan",서울,도봉구,278,87340,7466,95084,"2024-01-01",2024
"24-Jan",서울,동대문구,306,97034,5355,102695,"2024-01-01",2024
"24-Jan",서울,동작구,297,103510,2710,106517,"2024-01-01",2024
"24-Jan",서울,마포구,341,114147,7714,122202,"2024-01-01",2024
"24-Jan",서울,서대문구,432,85652,5536,91620,"2024-01-01",2024
"24-Jan",서울,서초구,511,166656,9721,176888,"2024-01-01",2024
"24-Jan",서울,성동구,378,92806,11671,104855,"2024-01-01",2024
"24-Jan",서울,성북구,298,117066,4985,122349,"2024-01-01",2024
"24-Jan",서울,송파구,409,229322,14267,243998,"2024-01-01",2024
"24-Jan",서울,양천구,336,142804,8531,151671,"2024-01-01",2024
"24-Jan",서울,영등포구,363,136235,8180,144778,"2024-01-01",2024
"24-Jan",서울,용산구,539,71839,2172,74550,"2024-01-01",2024
"24-Jan",서울,은평구,300,127738,7046,135084,"2024-01-01",2024
"24-Jan",서울,종로구,3634,44730,2474,50838,"2024-01-01",2024
"24-Jan",서울,중구,1356,50038,3040,54434,"2024-01-01",2024
"24-Jan",서울,중랑구,251,106656,9647,116554,"2024-01-01",2024
"24-Jan",서울,계,12856,2978711,199537,3191104,"2024-01-01",2024
"24-Jan",부산,강서구,343,85317,5661,91321,"2024-01-01",2024
"24-Jan",부산,금정구,287,77530,7233,85050,"2024-01-01",2024
"24-Jan",부산,기장군,263,86707,2897,89867,"2024-01-01",2024
"24-Jan",부산,남구,231,91746,9672,101649,"2024-01-01",2024
"24-Jan",부산,동구,190,46264,5401,51855,"2024-01-01",2024
"24-Jan",부산,동래구,167,97165,3701,101033,"2024-01-01",2024
"24-Jan",부산,부산진구,370,131536,23487,155393,"2024-01-01",2024
"24-Jan",부산,북구,274,102087,3708,106069,"2024-01-01",2024
"24-Jan",부산,사상구,268,83833,5366,89467,"2024-01-01",2024
"24-Jan",부산,사하구,271,108275,6065,114611,"2024-01-01",2024
"24-Jan",부산,서구,138,30449,1411,31998,"2024-01-01",2024
"24-Jan",부산,수영구,167,64525,60731,125423,"2024-01-01",2024
"24-Jan",부산,연제구,1035,113264,16401,130700,"2024-01-01",2024
"24-Jan",부산,영도구,229,31874,2111,34214,"2024-01-01",2024
"24-Jan",부산,중구,312,33463,7094,40869,"2024-01-01",2024
"24-Jan",부산,해운대구,336,166103,13872,180311,"2024-01-01",2024
"24-Jan",부산,계,4881,1350138,174811,1529830,"2024-01-01",2024
"24-Jan",대구,군위군,129,15759,244,16132,"2024-01-01",2024
"24-Jan",대구,남구,409,55492,1586,57487,"2024-01-01",2024
"24-Jan",대구,달서구,505,275324,18131,293960,"2024-01-01",2024
"24-Jan",대구,달성군,601,141195,5215,147011,"2024-01-01",2024
"24-Jan",대구,동구,366,163170,10484,174020,"2024-01-01",2024
"24-Jan",대구,북구,551,202281,8035,210867,"2024-01-01",2024
"24-Jan",대구,서구,270,71565,4685,76520,"2024-01-01",2024
"24-Jan",대구,수성구,594,214934,5370,220898,"2024-01-01",2024
"24-Jan",대구,중구,315,59705,2262,62282,"2024-01-01",2024
"24-Jan",대구,계,3740,1199425,56012,1259177,"2024-01-01",2024
"24-Jan",인천,강화군,346,38482,13952,52780,"2024-01-01",2024
"24-Jan",인천,계양구,311,123807,142363,266481,"2024-01-01",2024
"24-Jan",인천,남동구,960,257654,30115,288729,"2024-01-01",2024
"24-Jan",인천,동구,110,24496,2917,27523,"2024-01-01",2024
"24-Jan",인천,미추홀구,445,164424,9238,174107,"2024-01-01",2024
"24-Jan",인천,부평구,354,232453,41019,273826,"2024-01-01",2024
"24-Jan",인천,서구,514,304004,13084,317602,"2024-01-01",2024
"24-Jan",인천,연수구,436,218337,9916,228689,"2024-01-01",2024
"24-Jan",인천,옹진군,256,13208,284,13748,"2024-01-01",2024
"24-Jan",인천,중구,659,77372,12070,90101,"2024-01-01",2024
"24-Jan",인천,계,4391,1454237,274958,1733586,"2024-01-01",2024
"24-Jan",광주,광산구,563,204936,13196,218695,"2024-01-01",2024
"24-Jan",광주,남구,240,93624,2889,96753,"2024-01-01",2024
"24-Jan",광주,동구,256,47398,1003,48657,"2024-01-01",2024
"24-Jan",광주,북구,621,197607,9501,207729,"2024-01-01",2024
"24-Jan",광주,서구,752,145675,6247,152674,"2024-01-01",2024
"24-Jan",광주,계,2432,689240,32836,724508,"2024-01-01",2024
"24-Jan",대전,대덕구,246,87900,7491,95637,"2024-01-01",2024
"24-Jan",대전,동구,257,92789,5105,98151,"2024-01-01",2024
"24-Jan",대전,서구,826,210229,17741,228796,"2024-01-01",2024
"24-Jan",대전,유성구,677,194513,6041,201231,"2024-01-01",2024
"24-Jan",대전,중구,230,96428,5328,101986,"2024-01-01",2024
"24-Jan",대전,계,2236,681859,41706,725801,"2024-01-01",2024
"24-Jan",울산,남구,747,157109,7157,165013,"2024-01-01",2024
"24-Jan",울산,동구,194,64113,1265,65572,"2024-01-01",2024
"24-Jan",울산,북구,228,122423,3788,126439,"2024-01-01",2024
"24-Jan",울산,울주군,452,130480,7045,137977,"2024-01-01",2024
"24-Jan",울산,중구,329,102552,2708,105589,"2024-01-01",2024
"24-Jan",울산,계,1950,576677,21963,600590,"2024-01-01",2024
"24-Jan",세종,세종특별자치시,927,193893,3764,198584,"2024-01-01",2024
"24-Jan",세종,계,927,193893,3764,198584,"2024-01-01",2024
"24-Jan",경기,가평군,409,33130,623,34162,"2024-01-01",2024
"24-Jan",경기,고양시 덕양구,675,197761,5144,203580,"2024-01-01",2024
"24-Jan",경기,고양시 일산동구,270,128996,6464,135730,"2024-01-01",2024
"24-Jan",경기,고양시 일산서구,131,117690,4773,122594,"2024-01-01",2024
"24-Jan",경기,과천시,699,31303,752,32754,"2024-01-01",2024
"24-Jan",경기,광명시,311,101157,4781,106249,"2024-01-01",2024
"24-Jan",경기,광주시,422,205240,9167,214829,"2024-01-01",2024
"24-Jan",경기,구리시,274,71274,3022,74570,"2024-01-01",2024
"24-Jan",경기,군포시,306,99458,5358,105122,"2024-01-01",2024
"24-Jan",경기,김포시,576,237409,9227,247212,"2024-01-01",2024
"24-Jan",경기,남양주시,808,319090,10042,329940,"2024-01-01",2024
"24-Jan",경기,동두천시,227,38737,1559,40523,"2024-01-01",2024
"24-Jan",경기,부천시,22,328,263,613,"2024-01-01",2024
"24-Jan",경기,부천시 소사구,85,83754,3215,87054,"2024-01-01",2024
"24-Jan",경기,부천시 오정구,105,64549,3205,67859,"2024-01-01",2024
"24-Jan",경기,부천시 원미구,518,148802,6973,156293,"2024-01-01",2024
"24-Jan",경기,성남시 분당구,368,189187,8146,197701,"2024-01-01",2024
"24-Jan",경기,성남시 수정구,307,81468,2993,84768,"2024-01-01",2024
"24-Jan",경기,성남시 중원구,398,74686,4009,79093,"2024-01-01",2024
"24-Jan",경기,수원시 권선구,475,206531,9774,216780,"2024-01-01",2024
"24-Jan",경기,수원시 영통구,467,151730,3676,155873,"2024-01-01",2024
"24-Jan",경기,수원시 장안구,489,106966,3781,111236,"2024-01-01",2024
"24-Jan",경기,수원시 팔달구,333,82410,3218,85961,"2024-01-01",2024
"24-Jan",경기,시흥시,461,269482,9139,279082,"2024-01-01",2024
"24-Jan",경기,안산시 단원구,594,164048,7978,172620,"2024-01-01",2024
"24-Jan",경기,안산시 상록구,155,145266,5985,151406,"2024-01-01",2024
"24-Jan",경기,안성시,405,114194,4814,119413,"2024-01-01",2024
"24-Jan",경기,안양시 동안구,402,125456,6954,132812,"2024-01-01",2024
"24-Jan",경기,안양시 만안구,163,85431,3972,89566,"2024-01-01",2024
"24-Jan",경기,양주시,445,132465,4363,137273,"2024-01-01",2024
"24-Jan",경기,양평군,623,66591,1955,69169,"2024-01-01",2024
"24-Jan",경기,여주시,477,69090,7706,77273,"2024-01-01",2024
"24-Jan",경기,연천군,332,24768,4946,30046,"2024-01-01",2024
"24-Jan",경기,오산시,232,114087,4321,118640,"2024-01-01",2024
"24-Jan",경기,용인시 기흥구,124,198932,7823,206879,"2024-01-01",2024
"24-Jan",경기,용인시 수지구,60,151073,2380,153513,"2024-01-01",2024
"24-Jan",경기,용인시 처인구,850,142853,8155,151858,"2024-01-01",2024
"24-Jan",경기,의왕시,308,66699,2992,69999,"2024-01-01",2024
"24-Jan",경기,의정부시,754,174747,5728,181229,"2024-01-01",2024
"24-Jan",경기,이천시,438,123604,6581,130623,"2024-01-01",2024
"24-Jan",경기,파주시,561,243682,12170,256413,"2024-01-01",2024
"24-Jan",경기,평택시,792,328893,14338,344023,"2024-01-01",2024
"24-Jan",경기,포천시,428,89890,9520,99838,"2024-01-01",2024
"24-Jan",경기,하남시,447,140524,3785,144756,"2024-01-01",2024
"24-Jan",경기,화성시,993,516209,14461,531663,"2024-01-01",2024
"24-Jan",경기,계,18719,6259640,260231,6538590,"2024-01-01",2024
"24-Jan",충북,괴산군,223,24157,477,24857,"2024-01-01",2024
"24-Jan",충북,단양군,237,16401,853,17491,"2024-01-01",2024
"24-Jan",충북,보은군,247,19026,902,20175,"2024-01-01",2024
"24-Jan",충북,영동군,266,26247,439,26952,"2024-01-01",2024
"24-Jan",충북,옥천군,218,28894,1095,30207,"2024-01-01",2024
"24-Jan",충북,음성군,276,62703,2055,65034,"2024-01-01",2024
"24-Jan",충북,제천시,350,70144,3500,73994,"2024-01-01",2024
"24-Jan",충북,증평군,101,20998,822,21921,"2024-01-01",2024
"24-Jan",충북,진천군,229,55040,1534,56803,"2024-01-01",2024
"24-Jan",충북,청원군,1,19,0,20,"2024-01-01",2024
"24-Jan",충북,청주시 상당구,513,102240,2795,105548,"2024-01-01",2024
"24-Jan",충북,청주시 서원구,251,99369,4616,104236,"2024-01-01",2024
"24-Jan",충북,청주시 청원구,425,108172,4958,113555,"2024-01-01",2024
"24-Jan",충북,청주시 흥덕구,370,143012,7986,151368,"2024-01-01",2024
"24-Jan",충북,충주시,641,116861,8600,126102,"2024-01-01",2024
"24-Jan",충북,계,4348,893283,40632,938263,"2024-01-01",2024
"24-Jan",충남,계룡시,173,26070,613,26856,"2024-01-01",2024
"24-Jan",충남,공주시,609,56455,2637,59701,"2024-01-01",2024
"24-Jan",충남,금산군,211,30215,2399,32825,"2024-01-01",2024
"24-Jan",충남,논산시,417,62707,2367,65491,"2024-01-01",2024
"24-Jan",충남,당진시,428,105723,4256,110407,"2024-01-01",2024
"24-Jan",충남,보령시,424,54401,1403,56228,"2024-01-01",2024
"24-Jan",충남,부여군,326,35399,977,36702,"2024-01-01",2024
"24-Jan",충남,서산시,443,102693,3746,106882,"2024-01-01",2024
"24-Jan",충남,서천군,238,28060,796,29094,"2024-01-01",2024
"24-Jan",충남,아산시,554,196744,7160,204458,"2024-01-01",2024
"24-Jan",충남,예산군,444,47046,1464,48954,"2024-01-01",2024
"24-Jan",충남,천안시 동남구,308,140662,5613,146583,"2024-01-01",2024
"24-Jan",충남,천안시 서북구,566,205666,5527,211759,"2024-01-01",2024
"24-Jan",충남,청양군,267,17934,708,18909,"2024-01-01",2024
"24-Jan",충남,태안군,342,36247,585,37174,"2024-01-01",2024
"24-Jan",충남,홍성군,416,55534,1444,57394,"2024-01-01",2024
"24-Jan",충남,계,6166,1201556,41695,1249417,"2024-01-01",2024
"24-Jan",전남,강진군,255,19490,1031,20776,"2024-01-01",2024
"24-Jan",전남,고흥군,320,34255,556,35131,"2024-01-01",2024
"24-Jan",전남,곡성군,186,15916,639,16741,"2024-01-01",2024
"24-Jan",전남,광양시,263,92558,6261,99082,"2024-01-01",2024
"24-Jan",전남,구례군,176,13537,717,14430,"2024-01-01",2024
"24-Jan",전남,나주시,498,69946,3172,73616,"2024-01-01",2024
"24-Jan",전남,담양군,220,28866,1783,30869,"2024-01-01",2024
"24-Jan",전남,목포시,421,98733,5435,104589,"2024-01-01",2024
"24-Jan",전남,무안군,604,52311,1261,54176,"2024-01-01",2024
"24-Jan",전남,보성군,247,22523,627,23397,"2024-01-01",2024
"24-Jan",전남,순천시,521,148677,5425,154623,"2024-01-01",2024
"24-Jan",전남,신안군,385,23780,100582,124747,"2024-01-01",2024
"24-Jan",전남,여수시,568,137999,7401,145968,"2024-01-01",2024
"24-Jan",전남,영광군,240,29752,792,30784,"2024-01-01",2024
"24-Jan",전남,영암군,280,36668,1108,38056,"2024-01-01",2024
"24-Jan",전남,완도군,304,26549,515,27368,"2024-01-01",2024
"24-Jan",전남,장성군,216,28022,1285,29523,"2024-01-01",2024
"24-Jan",전남,장흥군,281,20805,451,21537,"2024-01-01",2024
"24-Jan",전남,진도군,227,17874,304,18405,"2024-01-01",2024
"24-Jan",전남,함평군,223,19318,8118,27659,"2024-01-01",2024
"24-Jan",전남,해남군,351,41478,82472,124301,"2024-01-01",2024
"24-Jan",전남,화순군,260,34505,2057,36822,"2024-01-01",2024
"24-Jan",전남,계,7046,1013562,231992,1252600,"2024-01-01",2024
"24-Jan",경북,경산시,389,143965,4453,148807,"2024-01-01",2024
"24-Jan",경북,경주시,610,148073,4561,153244,"2024-01-01",2024
"24-Jan",경북,고령군,185,21253,822,22260,"2024-01-01",2024
"24-Jan",경북,구미시,562,221467,7448,229477,"2024-01-01",2024
"24-Jan",경북,군위군,0,52,5,57,"2024-01-01",2024
"24-Jan",경북,김천시,411,78426,2138,80975,"2024-01-01",2024
"24-Jan",경북,문경시,303,38719,888,39910,"2024-01-01",2024
"24-Jan",경북,봉화군,257,18615,197,19069,"2024-01-01",2024
"24-Jan",경북,상주시,415,55928,1859,58202,"2024-01-01",2024
"24-Jan",경북,성주군,225,32243,1347,33815,"2024-01-01",2024
"24-Jan",경북,안동시,782,85574,2624,88980,"2024-01-01",2024
"24-Jan",경북,영덕군,262,19635,304,20201,"2024-01-01",2024
"24-Jan",경북,영양군,148,10225,116,10489,"2024-01-01",2024
"24-Jan",경북,영주시,372,57466,1521,59359,"2024-01-01",2024
"24-Jan",경북,영천시,361,63419,2515,66295,"2024-01-01",2024
"24-Jan",경북,예천군,285,32171,489,32945,"2024-01-01",2024
"24-Jan",경북,울릉군,152,5878,590,6620,"2024-01-01",2024
"24-Jan",경북,울진군,337,27614,367,28318,"2024-01-01",2024
"24-Jan",경북,의성군,305,32830,1126,34261,"2024-01-01",2024
"24-Jan",경북,청도군,226,26236,960,27422,"2024-01-01",2024
"24-Jan",경북,청송군,228,16401,210,16839,"2024-01-01",2024
"24-Jan",경북,칠곡군,318,71292,2472,74082,"2024-01-01",2024
"24-Jan",경북,포항시 남구,447,127074,8198,135719,"2024-01-01",2024
"24-Jan",경북,포항시 북구,386,145636,3631,149653,"2024-01-01",2024
"24-Jan",경북,계,7966,1480192,48841,1536999,"2024-01-01",2024
"24-Jan",경남,거제시,364,109780,2106,112250,"2024-01-01",2024
"24-Jan",경남,거창군,292,34511,795,35598,"2024-01-01",2024
"24-Jan",경남,고성군,235,28061,559,28855,"2024-01-01",2024
"24-Jan",경남,김해시,686,289609,8084,298379,"2024-01-01",2024
"24-Jan",경남,남해군,306,20881,454,21641,"2024-01-01",2024
"24-Jan",경남,밀양시,330,58619,3920,62869,"2024-01-01",2024
"24-Jan",경남,사천시,338,59542,1550,61430,"2024-01-01",2024
"24-Jan",경남,산청군,260,21447,756,22463,"2024-01-01",2024
"24-Jan",경남,양산시,429,177331,10747,188507,"2024-01-01",2024
"24-Jan",경남,의령군,224,15412,760,16396,"2024-01-01",2024
"24-Jan",경남,진주시,663,173293,6681,180637,"2024-01-01",2024
"24-Jan",경남,창녕군,247,36521,752,37520,"2024-01-01",2024
"24-Jan",경남,창원시 마산합포구,349,101220,2903,104472,"2024-01-01",2024
"24-Jan",경남,창원시 마산회원구,156,106262,7409,113827,"2024-01-01",2024
"24-Jan",경남,창원시 성산구,615,169915,62620,233150,"2024-01-01",2024
"24-Jan",경남,창원시 의창구,534,119123,3793,123450,"2024-01-01",2024
"24-Jan",경남,창원시 진해구,230,96901,2113,99244,"2024-01-01",2024
"24-Jan",경남,통영시,318,53677,1361,55356,"2024-01-01",2024
"24-Jan",경남,하동군,239,24504,385,25128,"2024-01-01",2024
"24-Jan",경남,함안군,217,44975,34609,79801,"2024-01-01",2024
"24-Jan",경남,함양군,239,20432,516,21187,"2024-01-01",2024
"24-Jan",경남,합천군,290,24433,639,25362,"2024-01-01",2024
"24-Jan",경남,계,7561,1786449,153512,1947522,"2024-01-01",2024
"24-Jan",제주,서귀포시,773,107801,1885,110459,"2024-01-01",2024
"24-Jan",제주,제주시,1690,314510,276827,593027,"2024-01-01",2024
"24-Jan",제주,계,2463,422311,278712,703486,"2024-01-01",2024
"24-Jan",강원,강릉시,613,114390,4915,119918,"2024-01-01",2024
"24-Jan",강원,고성군,203,16229,231,16663,"2024-01-01",2024
"24-Jan",강원,동해시,331,47867,1542,49740,"2024-01-01",2024
"24-Jan",강원,삼척시,422,33798,844,35064,"2024-01-01",2024
"24-Jan",강원,속초시,318,40867,1489,42674,"2024-01-01",2024
"24-Jan",강원,양구군,229,12521,138,12888,"2024-01-01",2024
"24-Jan",강원,양양군,218,17018,290,17526,"2024-01-01",2024
"24-Jan",강원,영월군,351,22005,400,22756,"2024-01-01",2024
"24-Jan",강원,원주시,647,190587,5984,197218,"2024-01-01",2024
"24-Jan",강원,인제군,232,20049,290,20571,"2024-01-01",2024
"24-Jan",강원,정선군,359,21053,524,21936,"2024-01-01",2024
"24-Jan",강원,철원군,274,24800,388,25462,"2024-01-01",2024
"24-Jan",강원,춘천시,882,142844,6291,150017,"2024-01-01",2024
"24-Jan",강원,태백시,250,20307,666,21223,"2024-01-01",2024
"24-Jan",강원,평창군,326,27250,667,28243,"2024-01-01",2024
"24-Jan",강원,홍천군,451,41041,1030,42522,"2024-01-01",2024
"24-Jan",강원,화천군,229,13337,184,13750,"2024-01-01",2024
"24-Jan",강원,횡성군,285,28774,904,29963,"2024-01-01",2024
"24-Jan",강원,계,6620,834737,26777,868134,"2024-01-01",2024
"24-Jan",전북,고창군,341,31944,588,32873,"2024-01-01",2024
"24-Jan",전북,군산시,558,137760,6433,144751,"2024-01-01",2024
"24-Jan",전북,김제시,338,48668,1970,50976,"2024-01-01",2024
"24-Jan",전북,남원시,437,42939,1331,44707,"2024-01-01",2024
"24-Jan",전북,무주군,223,13742,410,14375,"2024-01-01",2024
"24-Jan",전북,부안군,289,28449,609,29347,"2024-01-01",2024
"24-Jan",전북,순창군,238,15711,155,16104,"2024-01-01",2024
"24-Jan",전북,완주군,467,59391,3166,63024,"2024-01-01",2024
"24-Jan",전북,익산시,562,141434,5910,147906,"2024-01-01",2024
"24-Jan",전북,임실군,259,15026,425,15710,"2024-01-01",2024
"24-Jan",전북,장수군,234,12647,147,13028,"2024-01-01",2024
"24-Jan",전북,전주시 덕진구,400,176236,7168,183804,"2024-01-01",2024
"24-Jan",전북,전주시 완산구,763,155903,4310,160976,"2024-01-01",2024
"24-Jan",전북,정읍시,386,57619,3493,61498,"2024-01-01",2024
"24-Jan",전북,진안군,283,14933,254,15470,"2024-01-01",2024
"24-Jan",전북,계,5778,952402,36369,994549,"2024-01-01",2024
"24-Feb",서울,강남구,408,235233,20548,256189,"2024-02-01",2024
"24-Feb",서울,강동구,304,145450,8594,154348,"2024-02-01",2024
"24-Feb",서울,강북구,319,69850,4229,74398,"2024-02-01",2024
"24-Feb",서울,강서구,362,188689,15737,204788,"2024-02-01",2024
"24-Feb",서울,관악구,293,111983,5823,118099,"2024-02-01",2024
"24-Feb",서울,광진구,324,91930,5118,97372,"2024-02-01",2024
"24-Feb",서울,구로구,305,134067,13245,147617,"2024-02-01",2024
"24-Feb",서울,금천구,173,85506,6338,92017,"2024-02-01",2024
"24-Feb",서울,노원구,329,143323,8668,152320,"2024-02-01",2024
"24-Feb",서울,도봉구,277,87312,7455,95044,"2024-02-01",2024
"24-Feb",서울,동대문구,299,97035,5342,102676,"2024-02-01",2024
"24-Feb",서울,동작구,296,103392,2675,106363,"2024-02-01",2024
"24-Feb",서울,마포구,341,113957,7633,121931,"2024-02-01",2024
"24-Feb",서울,서대문구,433,85715,5536,91684,"2024-02-01",2024
"24-Feb",서울,서초구,502,166622,9601,176725,"2024-02-01",2024
"24-Feb",서울,성동구,375,92718,11691,104784,"2024-02-01",2024
"24-Feb",서울,성북구,296,116922,4980,122198,"2024-02-01",2024
"24-Feb",서울,송파구,407,229617,14241,244265,"2024-02-01",2024
"24-Feb",서울,양천구,338,143045,8507,151890,"2024-02-01",2024
"24-Feb",서울,영등포구,364,136197,8167,144728,"2024-02-01",2024
"24-Feb",서울,용산구,534,71597,2171,74302,"2024-02-01",2024
"24-Feb",서울,은평구,300,127626,7048,134974,"2024-02-01",2024
"24-Feb",서울,종로구,3639,44703,2465,50807,"2024-02-01",2024
"24-Feb",서울,중구,1351,49864,3011,54226,"2024-02-01",2024
"24-Feb",서울,중랑구,252,106737,9624,116613,"2024-02-01",2024
"24-Feb",서울,계,12821,2979090,198447,3190358,"2024-02-01",2024
"24-Feb",부산,강서구,342,85285,5638,91265,"2024-02-01",2024
"24-Feb",부산,금정구,284,77314,7085,84683,"2024-02-01",2024
"24-Feb",부산,기장군,263,86740,2933,89936,"2024-02-01",2024
"24-Feb",부산,남구,229,91998,9461,101688,"2024-02-01",2024
"24-Feb",부산,동구,190,46403,5404,51997,"2024-02-01",2024
"24-Feb",부산,동래구,164,97040,3724,100928,"2024-02-01",2024
"24-Feb",부산,부산진구,371,131954,23640,155965,"2024-02-01",2024
"24-Feb",부산,북구,304,102024,3683,106011,"2024-02-01",2024
"24-Feb",부산,사상구,267,83753,5361,89381,"2024-02-01",2024
"24-Feb",부산,사하구,270,108239,6038,114547,"2024-02-01",2024
"24-Feb",부산,서구,136,30415,1407,31958,"2024-02-01",2024
"24-Feb",부산,수영구,168,64365,61178,125711,"2024-02-01",2024
"24-Feb",부산,연제구,1053,113975,16895,131923,"2024-02-01",2024
"24-Feb",부산,영도구,225,31921,2105,34251,"2024-02-01",2024
"24-Feb",부산,중구,308,33538,7085,40931,"2024-02-01",2024
"24-Feb",부산,해운대구,336,165704,13791,179831,"2024-02-01",2024
"24-Feb",부산,계,4910,1350668,175428,1531006,"2024-02-01",2024
"24-Feb",대구,군위군,130,15747,246,16123,"2024-02-01",2024
"24-Feb",대구,남구,408,55440,1581,57429,"2024-02-01",2024
"24-Feb",대구,달서구,498,275025,18281,293804,"2024-02-01",2024
"24-Feb",대구,달성군,605,141258,5214,147077,"2024-02-01",2024
"24-Feb",대구,동구,366,163016,10336,173718,"2024-02-01",2024
"24-Feb",대구,북구,552,202390,8028,210970,"2024-02-01",2024
"24-Feb",대구,서구,267,71546,4791,76604,"2024-02-01",2024
"24-Feb",대구,수성구,612,215546,5235,221393,"2024-02-01",2024
"24-Feb",대구,중구,316,59667,2271,62254,"2024-02-01",2024
"24-Feb",대구,계,3754,1199635,55983,1259372,"2024-02-01",2024
"24-Feb",인천,강화군,342,38586,13355,52283,"2024-02-01",2024
"24-Feb",인천,계양구,307,123678,142255,266240,"2024-02-01",2024
"24-Feb",인천,남동구,952,257921,29906,288779,"2024-02-01",2024
"24-Feb",인천,동구,110,24544,2868,27522,"2024-02-01",2024
"24-Feb",인천,미추홀구,438,164560,9362,174360,"2024-02-01",2024
"24-Feb",인천,부평구,350,232525,40686,273561,"2024-02-01",2024
"24-Feb",인천,서구,511,304458,13136,318105,"2024-02-01",2024
"24-Feb",인천,연수구,434,219185,9854,229473,"2024-02-01",2024
"24-Feb",인천,옹진군,249,13266,285,13800,"2024-02-01",2024
"24-Feb",인천,중구,746,78417,12064,91227,"2024-02-01",2024
"24-Feb",인천,계,4439,1457140,273771,1735350,"2024-02-01",2024
"24-Feb",광주,광산구,582,205249,13195,219026,"2024-02-01",2024
"24-Feb",광주,남구,238,93783,2872,96893,"2024-02-01",2024
"24-Feb",광주,동구,254,47418,1018,48690,"2024-02-01",2024
"24-Feb",광주,북구,676,197700,9459,207835,"2024-02-01",2024
"24-Feb",광주,서구,749,145736,6184,152669,"2024-02-01",2024
"24-Feb",광주,계,2499,689886,32728,725113,"2024-02-01",2024
"24-Feb",대전,대덕구,244,87978,6912,95134,"2024-02-01",2024
"24-Feb",대전,동구,257,92748,5115,98120,"2024-02-01",2024
"24-Feb",대전,서구,848,210463,18882,230193,"2024-02-01",2024
"24-Feb",대전,유성구,679,194647,5907,201233,"2024-02-01",2024
"24-Feb",대전,중구,228,96497,5322,102047,"2024-02-01",2024
"24-Feb",대전,계,2256,682333,42138,726727,"2024-02-01",2024
"24-Feb",울산,남구,748,157122,7150,165020,"2024-02-01",2024
"24-Feb",울산,동구,192,64169,1263,65624,"2024-02-01",2024
"24-Feb",울산,북구,228,122596,3787,126611,"2024-02-01",2024
"24-Feb",울산,울주군,448,130944,7059,138451,"2024-02-01",2024
"24-Feb",울산,중구,349,102626,2721,105696,"2024-02-01",2024
"24-Feb",울산,계,1965,577457,21980,601402,"2024-02-01",2024
"24-Feb",세종,세종특별자치시,927,194361,3786,199074,"2024-02-01",2024
"24-Feb",세종,계,927,194361,3786,199074,"2024-02-01",2024
"24-Feb",경기,가평군,412,33181,623,34216,"2024-02-01",2024
"24-Feb",경기,고양시 덕양구,676,197667,5169,203512,"2024-02-01",2024
"24-Feb",경기,고양시 일산동구,272,129072,6457,135801,"2024-02-01",2024
"24-Feb",경기,고양시 일산서구,130,117771,4760,122661,"2024-02-01",2024
"24-Feb",경기,과천시,699,31490,754,32943,"2024-02-01",2024
"24-Feb",경기,광명시,311,101150,4790,106251,"2024-02-01",2024
"24-Feb",경기,광주시,421,205581,9158,215160,"2024-02-01",2024
"24-Feb",경기,구리시,273,71333,2998,74604,"2024-02-01",2024
"24-Feb",경기,군포시,303,99428,5357,105088,"2024-02-01",2024
"24-Feb",경기,김포시,575,237491,9215,247281,"2024-02-01",2024
"24-Feb",경기,남양주시,810,319601,10030,330441,"2024-02-01",2024
"24-Feb",경기,동두천시,223,38762,1550,40535,"2024-02-01",2024
"24-Feb",경기,부천시,22,323,259,604,"2024-02-01",2024
"24-Feb",경기,부천시 소사구,84,83838,3223,87145,"2024-02-01",2024
"24-Feb",경기,부천시 오정구,108,64136,3199,67443,"2024-02-01",2024
"24-Feb",경기,부천시 원미구,511,148673,6945,156129,"2024-02-01",2024
"24-Feb",경기,성남시 분당구,372,189238,8177,197787,"2024-02-01",2024
"24-Feb",경기,성남시 수정구,308,81592,3286,85186,"2024-02-01",2024
"24-Feb",경기,성남시 중원구,393,74625,4014,79032,"2024-02-01",2024
"24-Feb",경기,수원시 권선구,466,204635,9775,214876,"2024-02-01",2024
"24-Feb",경기,수원시 영통구,454,151964,3666,156084,"2024-02-01",2024
"24-Feb",경기,수원시 장안구,502,107225,3743,111470,"2024-02-01",2024
"24-Feb",경기,수원시 팔달구,332,82415,3423,86170,"2024-02-01",2024
"24-Feb",경기,시흥시,459,269470,9098,279027,"2024-02-01",2024
"24-Feb",경기,안산시 단원구,589,163996,7966,172551,"2024-02-01",2024
"24-Feb",경기,안산시 상록구,165,144982,5948,151095,"2024-02-01",2024
"24-Feb",경기,안성시,411,114489,4864,119764,"2024-02-01",2024
"24-Feb",경기,안양시 동안구,398,125821,6955,133174,"2024-02-01",2024
"24-Feb",경기,안양시 만안구,157,85430,3922,89509,"2024-02-01",2024
"24-Feb",경기,양주시,446,133788,4367,138601,"2024-02-01",2024
"24-Feb",경기,양평군,625,66854,1953,69432,"2024-02-01",2024
"24-Feb",경기,여주시,477,69240,7676,77393,"2024-02-01",2024
"24-Feb",경기,연천군,332,24752,4975,30059,"2024-02-01",2024
"24-Feb",경기,오산시,232,114934,4341,119507,"2024-02-01",2024
"24-Feb",경기,용인시 기흥구,124,198750,7821,206695,"2024-02-01",2024
"24-Feb",경기,용인시 수지구,56,151269,2386,153711,"2024-02-01",2024
"24-Feb",경기,용인시 처인구,849,143569,8167,152585,"2024-02-01",2024
"24-Feb",경기,의왕시,307,66627,2973,69907,"2024-02-01",2024
"24-Feb",경기,의정부시,774,174807,5733,181314,"2024-02-01",2024
"24-Feb",경기,이천시,439,123767,6565,130771,"2024-02-01",2024
"24-Feb",경기,파주시,552,245023,12113,257688,"2024-02-01",2024
"24-Feb",경기,평택시,793,329609,14344,344746,"2024-02-01",2024
"24-Feb",경기,포천시,428,89967,9201,99596,"2024-02-01",2024
"24-Feb",경기,하남시,448,140679,3749,144876,"2024-02-01",2024
"24-Feb",경기,화성시,989,517660,14372,533021,"2024-02-01",2024
"24-Feb",경기,계,18707,6266674,260060,6545441,"2024-02-01",2024
"24-Feb",충북,괴산군,223,24194,480,24897,"2024-02-01",2024
"24-Feb",충북,단양군,236,16431,857,17524,"2024-02-01",2024
"24-Feb",충북,보은군,245,19068,897,20210,"2024-02-01",2024
"24-Feb",충북,영동군,266,26267,435,26968,"2024-02-01",2024
"24-Feb",충북,옥천군,220,28953,1079,30252,"2024-02-01",2024
"24-Feb",충북,음성군,273,62743,2048,65064,"2024-02-01",2024
"24-Feb",충북,제천시,352,70233,3501,74086,"2024-02-01",2024
"24-Feb",충북,증평군,101,21032,825,21958,"2024-02-01",2024
"24-Feb",충북,진천군,231,55148,1537,56916,"2024-02-01",2024
"24-Feb",충북,청원군,1,19,0,20,"2024-02-01",2024
"24-Feb",충북,청주시 상당구,513,102471,2792,105776,"2024-02-01",2024
"24-Feb",충북,청주시 서원구,247,99075,4594,103916,"2024-02-01",2024
"24-Feb",충북,청주시 청원구,423,108344,4950,113717,"2024-02-01",2024
"24-Feb",충북,청주시 흥덕구,368,143400,7998,151766,"2024-02-01",2024
"24-Feb",충북,충주시,648,117037,8514,126199,"2024-02-01",2024
"24-Feb",충북,계,4347,894415,40507,939269,"2024-02-01",2024
"24-Feb",충남,계룡시,173,26233,612,27018,"2024-02-01",2024
"24-Feb",충남,공주시,608,56556,2633,59797,"2024-02-01",2024
"24-Feb",충남,금산군,210,30230,2395,32835,"2024-02-01",2024
"24-Feb",충남,논산시,415,62816,2360,65591,"2024-02-01",2024
"24-Feb",충남,당진시,434,105862,4236,110532,"2024-02-01",2024
"24-Feb",충남,보령시,422,54487,1395,56304,"2024-02-01",2024
"24-Feb",충남,부여군,323,35439,976,36738,"2024-02-01",2024
"24-Feb",충남,서산시,443,102924,3748,107115,"2024-02-01",2024
"24-Feb",충남,서천군,238,28086,801,29125,"2024-02-01",2024
"24-Feb",충남,아산시,556,197889,7109,205554,"2024-02-01",2024
"24-Feb",충남,예산군,455,47074,1450,48979,"2024-02-01",2024
"24-Feb",충남,천안시 동남구,307,141446,5591,147344,"2024-02-01",2024
"24-Feb",충남,천안시 서북구,560,205535,5572,211667,"2024-02-01",2024
"24-Feb",충남,청양군,267,17944,708,18919,"2024-02-01",2024
"24-Feb",충남,태안군,341,36320,609,37270,"2024-02-01",2024
"24-Feb",충남,홍성군,413,55804,1437,57654,"2024-02-01",2024
"24-Feb",충남,계,6165,1204645,41632,1252442,"2024-02-01",2024
"24-Feb",전남,강진군,253,19494,1030,20777,"2024-02-01",2024
"24-Feb",전남,고흥군,315,34313,560,35188,"2024-02-01",2024
"24-Feb",전남,곡성군,185,15948,636,16769,"2024-02-01",2024
"24-Feb",전남,광양시,260,92851,6233,99344,"2024-02-01",2024
"24-Feb",전남,구례군,175,13557,713,14445,"2024-02-01",2024
"24-Feb",전남,나주시,490,70048,3184,73722,"2024-02-01",2024
"24-Feb",전남,담양군,219,28908,1792,30919,"2024-02-01",2024
"24-Feb",전남,목포시,415,98915,5439,104769,"2024-02-01",2024
"24-Feb",전남,무안군,612,52326,1204,54142,"2024-02-01",2024
"24-Feb",전남,보성군,242,22544,629,23415,"2024-02-01",2024
"24-Feb",전남,순천시,511,148826,5466,154803,"2024-02-01",2024
"24-Feb",전남,신안군,383,23935,101239,125557,"2024-02-01",2024
"24-Feb",전남,여수시,560,138282,7428,146270,"2024-02-01",2024
"24-Feb",전남,영광군,239,29833,792,30864,"2024-02-01",2024
"24-Feb",전남,영암군,276,36761,1110,38147,"2024-02-01",2024
"24-Feb",전남,완도군,301,26550,513,27364,"2024-02-01",2024
"24-Feb",전남,장성군,214,28094,1256,29564,"2024-02-01",2024
"24-Feb",전남,장흥군,279,20885,452,21616,"2024-02-01",2024
"24-Feb",전남,진도군,225,17926,307,18458,"2024-02-01",2024
"24-Feb",전남,함평군,219,19343,7462,27024,"2024-02-01",2024
"24-Feb",전남,해남군,344,41533,82516,124393,"2024-02-01",2024
"24-Feb",전남,화순군,259,34557,2063,36879,"2024-02-01",2024
"24-Feb",전남,계,6976,1015429,232024,1254429,"2024-02-01",2024
"24-Feb",경북,경산시,388,143839,4445,148672,"2024-02-01",2024
"24-Feb",경북,경주시,608,148321,4564,153493,"2024-02-01",2024
"24-Feb",경북,고령군,186,21274,823,22283,"2024-02-01",2024
"24-Feb",경북,구미시,558,222062,7415,230035,"2024-02-01",2024
"24-Feb",경북,군위군,0,51,5,56,"2024-02-01",2024
"24-Feb",경북,김천시,411,78451,2149,81011,"2024-02-01",2024
"24-Feb",경북,문경시,298,38741,885,39924,"2024-02-01",2024
"24-Feb",경북,봉화군,256,18637,197,19090,"2024-02-01",2024
"24-Feb",경북,상주시,414,56001,1876,58291,"2024-02-01",2024
"24-Feb",경북,성주군,222,32321,1343,33886,"2024-02-01",2024
"24-Feb",경북,안동시,825,85787,2619,89231,"2024-02-01",2024
"24-Feb",경북,영덕군,261,19624,309,20194,"2024-02-01",2024
"24-Feb",경북,영양군,148,10237,115,10500,"2024-02-01",2024
"24-Feb",경북,영주시,374,57569,1523,59466,"2024-02-01",2024
"24-Feb",경북,영천시,360,63665,2520,66545,"2024-02-01",2024
"24-Feb",경북,예천군,286,32288,486,33060,"2024-02-01",2024
"24-Feb",경북,울릉군,152,5923,560,6635,"2024-02-01",2024
"24-Feb",경북,울진군,339,27646,367,28352,"2024-02-01",2024
"24-Feb",경북,의성군,303,32885,1126,34314,"2024-02-01",2024
"24-Feb",경북,청도군,226,26294,965,27485,"2024-02-01",2024
"24-Feb",경북,청송군,226,16446,209,16881,"2024-02-01",2024
"24-Feb",경북,칠곡군,316,71353,2479,74148,"2024-02-01",2024
"24-Feb",경북,포항시 남구,449,127332,8139,135920,"2024-02-01",2024
"24-Feb",경북,포항시 북구,383,145938,3711,150032,"2024-02-01",2024
"24-Feb",경북,계,7989,1482685,48830,1539504,"2024-02-01",2024
"24-Feb",경남,거제시,359,109973,2111,112443,"2024-02-01",2024
"24-Feb",경남,거창군,292,34614,796,35702,"2024-02-01",2024
"24-Feb",경남,고성군,232,28071,557,28860,"2024-02-01",2024
"24-Feb",경남,김해시,675,290497,8060,299232,"2024-02-01",2024
"24-Feb",경남,남해군,303,20874,450,21627,"2024-02-01",2024
"24-Feb",경남,밀양시,320,58769,3918,63007,"2024-02-01",2024
"24-Feb",경남,사천시,329,59684,1546,61559,"2024-02-01",2024
"24-Feb",경남,산청군,256,21435,757,22448,"2024-02-01",2024
"24-Feb",경남,양산시,428,177773,10711,188912,"2024-02-01",2024
"24-Feb",경남,의령군,222,15467,765,16454,"2024-02-01",2024
"24-Feb",경남,진주시,654,173514,6663,180831,"2024-02-01",2024
"24-Feb",경남,창녕군,243,36535,757,37535,"2024-02-01",2024
"24-Feb",경남,창원시 마산합포구,346,101293,2904,104543,"2024-02-01",2024
"24-Feb",경남,창원시 마산회원구,153,106729,7399,114281,"2024-02-01",2024
"24-Feb",경남,창원시 성산구,611,170039,63202,233852,"2024-02-01",2024
"24-Feb",경남,창원시 의창구,553,119411,3793,123757,"2024-02-01",2024
"24-Feb",경남,창원시 진해구,228,96909,2111,99248,"2024-02-01",2024
"24-Feb",경남,통영시,315,53625,1349,55289,"2024-02-01",2024
"24-Feb",경남,하동군,237,24526,383,25146,"2024-02-01",2024
"24-Feb",경남,함안군,213,44948,35071,80232,"2024-02-01",2024
"24-Feb",경남,함양군,237,20473,513,21223,"2024-02-01",2024
"24-Feb",경남,합천군,287,24478,652,25417,"2024-02-01",2024
"24-Feb",경남,계,7493,1789637,154468,1951598,"2024-02-01",2024
"24-Feb",제주,서귀포시,768,107901,1879,110548,"2024-02-01",2024
"24-Feb",제주,제주시,1699,315122,275922,592743,"2024-02-01",2024
"24-Feb",제주,계,2467,423023,277801,703291,"2024-02-01",2024
"24-Feb",강원,강릉시,609,114691,4954,120254,"2024-02-01",2024
"24-Feb",강원,고성군,204,16276,230,16710,"2024-02-01",2024
"24-Feb",강원,동해시,328,47934,1544,49806,"2024-02-01",2024
"24-Feb",강원,삼척시,418,33758,842,35018,"2024-02-01",2024
"24-Feb",강원,속초시,318,40870,1483,42671,"2024-02-01",2024
"24-Feb",강원,양구군,228,12566,137,12931,"2024-02-01",2024
"24-Feb",강원,양양군,219,17080,287,17586,"2024-02-01",2024
"24-Feb",강원,영월군,352,22060,395,22807,"2024-02-01",2024
"24-Feb",강원,원주시,652,190801,5996,197449,"2024-02-01",2024
"24-Feb",강원,인제군,233,20037,292,20562,"2024-02-01",2024
"24-Feb",강원,정선군,358,21087,519,21964,"2024-02-01",2024
"24-Feb",강원,철원군,273,24810,396,25479,"2024-02-01",2024
"24-Feb",강원,춘천시,890,143077,6275,150242,"2024-02-01",2024
"24-Feb",강원,태백시,248,20316,662,21226,"2024-02-01",2024
"24-Feb",강원,평창군,327,27294,654,28275,"2024-02-01",2024
"24-Feb",강원,홍천군,443,41075,1031,42549,"2024-02-01",2024
"24-Feb",강원,화천군,230,13307,184,13721,"2024-02-01",2024
"24-Feb",강원,횡성군,285,28830,901,30016,"2024-02-01",2024
"24-Feb",강원,계,6615,835869,26782,869266,"2024-02-01",2024
"24-Feb",전북,고창군,338,32023,586,32947,"2024-02-01",2024
"24-Feb",전북,군산시,556,137998,6424,144978,"2024-02-01",2024
"24-Feb",전북,김제시,332,48848,1975,51155,"2024-02-01",2024
"24-Feb",전북,남원시,433,43045,1303,44781,"2024-02-01",2024
"24-Feb",전북,무주군,222,13761,408,14391,"2024-02-01",2024
"24-Feb",전북,부안군,289,28484,605,29378,"2024-02-01",2024
"24-Feb",전북,순창군,237,15769,154,16160,"2024-02-01",2024
"24-Feb",전북,완주군,460,59681,3176,63317,"2024-02-01",2024
"24-Feb",전북,익산시,559,141591,5895,148045,"2024-02-01",2024
"24-Feb",전북,임실군,257,15039,424,15720,"2024-02-01",2024
"24-Feb",전북,장수군,235,12678,148,13061,"2024-02-01",2024
"24-Feb",전북,전주시 덕진구,411,176206,7147,183764,"2024-02-01",2024
"24-Feb",전북,전주시 완산구,784,156050,4297,161131,"2024-02-01",2024
"24-Feb",전북,정읍시,385,57730,3430,61545,"2024-02-01",2024
"24-Feb",전북,진안군,283,14993,256,15532,"2024-02-01",2024
"24-Feb",전북,계,5781,953896,36228,995905,"2024-02-01",2024
"24-Mar",서울,강남구,409,235535,20155,256099,"2024-03-01",2024
"24-Mar",서울,강동구,303,145684,8535,154522,"2024-03-01",2024
"24-Mar",서울,강북구,320,69628,4221,74169,"2024-03-01",2024
"24-Mar",서울,강서구,361,188619,15620,204600,"2024-03-01",2024
"24-Mar",서울,관악구,290,111846,5800,117936,"2024-03-01",2024
"24-Mar",서울,광진구,323,91792,5103,97218,"2024-03-01",2024
"24-Mar",서울,구로구,304,134001,13373,147678,"2024-03-01",2024
"24-Mar",서울,금천구,174,85499,6302,91975,"2024-03-01",2024
"24-Mar",서울,노원구,329,143182,8644,152155,"2024-03-01",2024
"24-Mar",서울,도봉구,276,87254,7416,94946,"2024-03-01",2024
"24-Mar",서울,동대문구,297,97111,5341,102749,"2024-03-01",2024
"24-Mar",서울,동작구,296,103415,2651,106362,"2024-03-01",2024
"24-Mar",서울,마포구,338,114010,7595,121943,"2024-03-01",2024
"24-Mar",서울,서대문구,432,85681,5537,91650,"2024-03-01",2024
"24-Mar",서울,서초구,500,166507,9621,176628,"2024-03-01",2024
"24-Mar",서울,성동구,375,92690,11576,104641,"2024-03-01",2024
"24-Mar",서울,성북구,293,116875,4967,122135,"2024-03-01",2024
"24-Mar",서울,송파구,407,229414,14258,244079,"2024-03-01",2024
"24-Mar",서울,양천구,336,142366,8487,151189,"2024-03-01",2024
"24-Mar",서울,영등포구,365,136121,8179,144665,"2024-03-01",2024
"24-Mar",서울,용산구,532,71291,2178,74001,"2024-03-01",2024
"24-Mar",서울,은평구,300,127717,7030,135047,"2024-03-01",2024
"24-Mar",서울,종로구,3657,44680,2145,50482,"2024-03-01",2024
"24-Mar",서울,중구,1352,49708,3272,54332,"2024-03-01",2024
"24-Mar",서울,중랑구,253,106657,9665,116575,"2024-03-01",2024
"24-Mar",서울,계,12822,2977283,197671,3187776,"2024-03-01",2024
"24-Mar",부산,강서구,345,85396,5622,91363,"2024-03-01",2024
"24-Mar",부산,금정구,285,77255,7072,84612,"2024-03-01",2024
"24-Mar",부산,기장군,263,86817,2924,90004,"2024-03-01",2024
"24-Mar",부산,남구,228,92144,9443,101815,"2024-03-01",2024
"24-Mar",부산,동구,191,46758,5390,52339,"2024-03-01",2024
"24-Mar",부산,동래구,164,97006,3766,100936,"2024-03-01",2024
"24-Mar",부산,부산진구,369,132202,23918,156489,"2024-03-01",2024
"24-Mar",부산,북구,311,102055,3688,106054,"2024-03-01",2024
"24-Mar",부산,사상구,267,83804,5361,89432,"2024-03-01",2024
"24-Mar",부산,사하구,270,108113,5992,114375,"2024-03-01",2024
"24-Mar",부산,서구,137,30419,1401,31957,"2024-03-01",2024
"24-Mar",부산,수영구,168,64289,61532,125989,"2024-03-01",2024
"24-Mar",부산,연제구,1054,114439,17369,132862,"2024-03-01",2024
"24-Mar",부산,영도구,224,31975,2110,34309,"2024-03-01",2024
"24-Mar",부산,중구,313,33825,7110,41248,"2024-03-01",2024
"24-Mar",부산,해운대구,335,165548,13703,179586,"2024-03-01",2024
"24-Mar",부산,계,4924,1352045,176401,1533370,"2024-03-01",2024
"24-Mar",대구,군위군,128,15736,246,16110,"2024-03-01",2024
"24-Mar",대구,남구,410,55311,1570,57291,"2024-03-01",2024
"24-Mar",대구,달서구,525,275048,18326,293899,"2024-03-01",2024
"24-Mar",대구,달성군,601,141211,5170,146982,"2024-03-01",2024
"24-Mar",대구,동구,370,163053,10313,173736,"2024-03-01",2024
"24-Mar",대구,북구,556,202365,8080,211001,"2024-03-01",2024
"24-Mar",대구,서구,268,71730,4886,76884,"2024-03-01",2024
"24-Mar",대구,수성구,614,215941,5182,221737,"2024-03-01",2024
"24-Mar",대구,중구,316,59352,2255,61923,"2024-03-01",2024
"24-Mar",대구,계,3788,1199747,56028,1259563,"2024-03-01",2024
"24-Mar",인천,강화군,342,38677,12492,51511,"2024-03-01",2024
"24-Mar",인천,계양구,305,123864,143690,267859,"2024-03-01",2024
"24-Mar",인천,남동구,952,258111,29615,288678,"2024-03-01",2024
"24-Mar",인천,동구,110,24507,2878,27495,"2024-03-01",2024
"24-Mar",인천,미추홀구,443,164333,9545,174321,"2024-03-01",2024
"24-Mar",인천,부평구,353,231942,40327,272622,"2024-03-01",2024
"24-Mar",인천,서구,512,305091,13149,318752,"2024-03-01",2024
"24-Mar",인천,연수구,435,219742,9814,229991,"2024-03-01",2024
"24-Mar",인천,옹진군,248,13238,290,13776,"2024-03-01",2024
"24-Mar",인천,중구,705,79033,12041,91779,"2024-03-01",2024
"24-Mar",인천,계,4405,1458538,273841,1736784,"2024-03-01",2024
"24-Mar",광주,광산구,584,205256,13260,219100,"2024-03-01",2024
"24-Mar",광주,남구,239,93778,2848,96865,"2024-03-01",2024
"24-Mar",광주,동구,253,47368,1018,48639,"2024-03-01",2024
"24-Mar",광주,북구,648,198765,9504,208917,"2024-03-01",2024
"24-Mar",광주,서구,750,146005,6238,152993,"2024-03-01",2024
"24-Mar",광주,계,2474,691172,32868,726514,"2024-03-01",2024
"24-Mar",대전,대덕구,242,88221,6953,95416,"2024-03-01",2024
"24-Mar",대전,동구,252,92687,5099,98038,"2024-03-01",2024
"24-Mar",대전,서구,843,210306,19501,230650,"2024-03-01",2024
"24-Mar",대전,유성구,680,194552,5891,201123,"2024-03-01",2024
"24-Mar",대전,중구,223,96815,5310,102348,"2024-03-01",2024
"24-Mar",대전,계,2240,682581,42754,727575,"2024-03-01",2024
"24-Mar",울산,남구,752,157223,7155,165130,"2024-03-01",2024
"24-Mar",울산,동구,194,64169,1268,65631,"2024-03-01",2024
"24-Mar",울산,북구,228,122616,3786,126630,"2024-03-01",2024
"24-Mar",울산,울주군,449,131260,7073,138782,"2024-03-01",2024
"24-Mar",울산,중구,349,102716,2704,105769,"2024-03-01",2024
"24-Mar",울산,계,1972,577984,21986,601942,"2024-03-01",2024
"24-Mar",세종,세종특별자치시,929,194989,3716,199634,"2024-03-01",2024
"24-Mar",세종,계,929,194989,3716,199634,"2024-03-01",2024
"24-Mar",경기,가평군,421,33240,622,34283,"2024-03-01",2024
"24-Mar",경기,고양시 덕양구,679,197636,5213,203528,"2024-03-01",2024
"24-Mar",경기,고양시 일산동구,270,129213,6388,135871,"2024-03-01",2024
"24-Mar",경기,고양시 일산서구,131,117675,4781,122587,"2024-03-01",2024
"24-Mar",경기,과천시,698,32024,761,33483,"2024-03-01",2024
"24-Mar",경기,광명시,312,101270,4780,106362,"2024-03-01",2024
"24-Mar",경기,광주시,424,206094,9050,215568,"2024-03-01",2024
"24-Mar",경기,구리시,273,71345,3008,74626,"2024-03-01",2024
"24-Mar",경기,군포시,301,99481,5352,105134,"2024-03-01",2024
"24-Mar",경기,김포시,575,237811,9169,247555,"2024-03-01",2024
"24-Mar",경기,남양주시,812,320126,9961,330899,"2024-03-01",2024
"24-Mar",경기,동두천시,228,38605,1513,40346,"2024-03-01",2024
"24-Mar",경기,부천시,22,300,109,431,"2024-03-01",2024
"24-Mar",경기,부천시 소사구,85,83893,3211,87189,"2024-03-01",2024
"24-Mar",경기,부천시 오정구,109,63869,3261,67239,"2024-03-01",2024
"24-Mar",경기,부천시 원미구,514,148504,7026,156044,"2024-03-01",2024
"24-Mar",경기,성남시 분당구,371,189447,8039,197857,"2024-03-01",2024
"24-Mar",경기,성남시 수정구,307,81765,3301,85373,"2024-03-01",2024
"24-Mar",경기,성남시 중원구,392,74671,4033,79096,"2024-03-01",2024
"24-Mar",경기,수원시 권선구,486,204703,9700,214889,"2024-03-01",2024
"24-Mar",경기,수원시 영통구,452,152324,3693,156469,"2024-03-01",2024
"24-Mar",경기,수원시 장안구,497,107458,3750,111705,"2024-03-01",2024
"24-Mar",경기,수원시 팔달구,295,82376,3377,86048,"2024-03-01",2024
"24-Mar",경기,시흥시,459,270188,9106,279753,"2024-03-01",2024
"24-Mar",경기,안산시 단원구,587,164079,7961,172627,"2024-03-01",2024
"24-Mar",경기,안산시 상록구,164,144828,5907,150899,"2024-03-01",2024
"24-Mar",경기,안성시,413,114871,4877,120161,"2024-03-01",2024
"24-Mar",경기,안양시 동안구,398,126165,6917,133480,"2024-03-01",2024
"24-Mar",경기,안양시 만안구,154,85389,3911,89454,"2024-03-01",2024
"24-Mar",경기,양주시,446,135392,4394,140232,"2024-03-01",2024
"24-Mar",경기,양평군,630,67206,1947,69783,"2024-03-01",2024
"24-Mar",경기,여주시,477,69507,7786,77770,"2024-03-01",2024
"24-Mar",경기,연천군,331,24749,4961,30041,"2024-03-01",2024
"24-Mar",경기,오산시,229,116050,4344,120623,"2024-03-01",2024
"24-Mar",경기,용인시 기흥구,123,198566,7803,206492,"2024-03-01",2024
"24-Mar",경기,용인시 수지구,58,151304,2388,153750,"2024-03-01",2024
"24-Mar",경기,용인시 처인구,856,144027,8174,153057,"2024-03-01",2024
"24-Mar",경기,의왕시,312,66479,2978,69769,"2024-03-01",2024
"24-Mar",경기,의정부시,770,174888,5711,181369,"2024-03-01",2024
"24-Mar",경기,이천시,436,123830,6598,130864,"2024-03-01",2024
"24-Mar",경기,파주시,566,246056,12085,258707,"2024-03-01",2024
"24-Mar",경기,평택시,800,330866,14409,346075,"2024-03-01",2024
"24-Mar",경기,포천시,423,89923,8848,99194,"2024-03-01",2024
"24-Mar",경기,하남시,448,140839,3824,145111,"2024-03-01",2024
"24-Mar",경기,화성시,1000,519770,14377,535147,"2024-03-01",2024
"24-Mar",경기,계,18734,6278802,259404,6556940,"2024-03-01",2024
"24-Mar",충북,괴산군,220,24199,482,24901,"2024-03-01",2024
"24-Mar",충북,단양군,238,16452,859,17549,"2024-03-01",2024
"24-Mar",충북,보은군,248,19102,902,20252,"2024-03-01",2024
"24-Mar",충북,영동군,266,26366,430,27062,"2024-03-01",2024
"24-Mar",충북,옥천군,221,28983,1062,30266,"2024-03-01",2024
"24-Mar",충북,음성군,269,62744,2054,65067,"2024-03-01",2024
"24-Mar",충북,제천시,352,70345,3488,74185,"2024-03-01",2024
"24-Mar",충북,증평군,100,21073,821,21994,"2024-03-01",2024
"24-Mar",충북,진천군,230,55565,1549,57344,"2024-03-01",2024
"24-Mar",충북,청원군,1,19,0,20,"2024-03-01",2024
"24-Mar",충북,청주시 상당구,508,102729,2788,106025,"2024-03-01",2024
"24-Mar",충북,청주시 서원구,246,99032,4578,103856,"2024-03-01",2024
"24-Mar",충북,청주시 청원구,422,108598,4927,113947,"2024-03-01",2024
"24-Mar",충북,청주시 흥덕구,391,143993,7991,152375,"2024-03-01",2024
"24-Mar",충북,충주시,641,117290,8430,126361,"2024-03-01",2024
"24-Mar",충북,계,4353,896490,40361,941204,"2024-03-01",2024
"24-Mar",충남,계룡시,173,26240,609,27022,"2024-03-01",2024
"24-Mar",충남,공주시,610,56659,2576,59845,"2024-03-01",2024
"24-Mar",충남,금산군,209,30253,2395,32857,"2024-03-01",2024
"24-Mar",충남,논산시,413,62966,2369,65748,"2024-03-01",2024
"24-Mar",충남,당진시,437,106259,4257,110953,"2024-03-01",2024
"24-Mar",충남,보령시,421,54532,1405,56358,"2024-03-01",2024
"24-Mar",충남,부여군,325,35472,980,36777,"2024-03-01",2024
"24-Mar",충남,서산시,441,103096,3749,107286,"2024-03-01",2024
"24-Mar",충남,서천군,241,28122,800,29163,"2024-03-01",2024
"24-Mar",충남,아산시,555,199244,7070,206869,"2024-03-01",2024
"24-Mar",충남,예산군,460,47165,1455,49080,"2024-03-01",2024
"24-Mar",충남,천안시 동남구,308,142094,5605,148007,"2024-03-01",2024
"24-Mar",충남,천안시 서북구,561,205836,5538,211935,"2024-03-01",2024
"24-Mar",충남,청양군,265,17967,710,18942,"2024-03-01",2024
"24-Mar",충남,태안군,341,36403,605,37349,"2024-03-01",2024
"24-Mar",충남,홍성군,417,56226,1417,58060,"2024-03-01",2024
"24-Mar",충남,계,6177,1208534,41540,1256251,"2024-03-01",2024
"24-Mar",전남,강진군,254,19459,1031,20744,"2024-03-01",2024
"24-Mar",전남,고흥군,316,34451,558,35325,"2024-03-01",2024
"24-Mar",전남,곡성군,186,16020,633,16839,"2024-03-01",2024
"24-Mar",전남,광양시,262,93194,6255,99711,"2024-03-01",2024
"24-Mar",전남,구례군,177,13575,691,14443,"2024-03-01",2024
"24-Mar",전남,나주시,488,70182,3115,73785,"2024-03-01",2024
"24-Mar",전남,담양군,220,28902,1810,30932,"2024-03-01",2024
"24-Mar",전남,목포시,411,99038,5410,104859,"2024-03-01",2024
"24-Mar",전남,무안군,615,52433,1211,54259,"2024-03-01",2024
"24-Mar",전남,보성군,246,22614,636,23496,"2024-03-01",2024
"24-Mar",전남,순천시,510,149279,5455,155244,"2024-03-01",2024
"24-Mar",전남,신안군,385,24080,101896,126361,"2024-03-01",2024
"24-Mar",전남,여수시,559,138556,7429,146544,"2024-03-01",2024
"24-Mar",전남,영광군,240,29910,794,30944,"2024-03-01",2024
"24-Mar",전남,영암군,279,36923,1110,38312,"2024-03-01",2024
"24-Mar",전남,완도군,301,26504,515,27320,"2024-03-01",2024
"24-Mar",전남,장성군,218,28155,1252,29625,"2024-03-01",2024
"24-Mar",전남,장흥군,280,20877,446,21603,"2024-03-01",2024
"24-Mar",전남,진도군,224,17978,309,18511,"2024-03-01",2024
"24-Mar",전남,함평군,221,19379,7078,26678,"2024-03-01",2024
"24-Mar",전남,해남군,342,41631,82151,124124,"2024-03-01",2024
"24-Mar",전남,화순군,259,34593,2052,36904,"2024-03-01",2024
"24-Mar",전남,계,6993,1017733,231837,1256563,"2024-03-01",2024
"24-Mar",경북,경산시,385,144006,4443,148834,"2024-03-01",2024
"24-Mar",경북,경주시,604,148742,4559,153905,"2024-03-01",2024
"24-Mar",경북,고령군,188,21358,826,22372,"2024-03-01",2024
"24-Mar",경북,구미시,556,222710,7411,230677,"2024-03-01",2024
"24-Mar",경북,군위군,0,51,5,56,"2024-03-01",2024
"24-Mar",경북,김천시,408,78521,2144,81073,"2024-03-01",2024
"24-Mar",경북,문경시,297,38856,888,40041,"2024-03-01",2024
"24-Mar",경북,봉화군,257,18659,198,19114,"2024-03-01",2024
"24-Mar",경북,상주시,413,56112,1871,58396,"2024-03-01",2024
"24-Mar",경북,성주군,224,32384,1340,33948,"2024-03-01",2024
"24-Mar",경북,안동시,811,85853,2624,89288,"2024-03-01",2024
"24-Mar",경북,영덕군,261,19618,310,20189,"2024-03-01",2024
"24-Mar",경북,영양군,147,10248,116,10511,"2024-03-01",2024
"24-Mar",경북,영주시,377,57687,1525,59589,"2024-03-01",2024
"24-Mar",경북,영천시,360,63821,2508,66689,"2024-03-01",2024
"24-Mar",경북,예천군,288,32402,481,33171,"2024-03-01",2024
"24-Mar",경북,울릉군,152,5975,564,6691,"2024-03-01",2024
"24-Mar",경북,울진군,336,27641,365,28342,"2024-03-01",2024
"24-Mar",경북,의성군,300,32944,1124,34368,"2024-03-01",2024
"24-Mar",경북,청도군,225,26346,963,27534,"2024-03-01",2024
"24-Mar",경북,청송군,227,16537,210,16974,"2024-03-01",2024
"24-Mar",경북,칠곡군,306,71377,2482,74165,"2024-03-01",2024
"24-Mar",경북,포항시 남구,442,127437,8126,136005,"2024-03-01",2024
"24-Mar",경북,포항시 북구,385,146573,3711,150669,"2024-03-01",2024
"24-Mar",경북,계,7949,1485858,48794,1542601,"2024-03-01",2024
"24-Mar",경남,거제시,357,110286,2114,112757,"2024-03-01",2024
"24-Mar",경남,거창군,290,34802,796,35888,"2024-03-01",2024
"24-Mar",경남,고성군,228,28100,557,28885,"2024-03-01",2024
"24-Mar",경남,김해시,679,290738,8068,299485,"2024-03-01",2024
"24-Mar",경남,남해군,301,20920,446,21667,"2024-03-01",2024
"24-Mar",경남,밀양시,321,58866,3918,63105,"2024-03-01",2024
"24-Mar",경남,사천시,333,59806,1550,61689,"2024-03-01",2024
"24-Mar",경남,산청군,258,21443,755,22456,"2024-03-01",2024
"24-Mar",경남,양산시,433,178127,10631,189191,"2024-03-01",2024
"24-Mar",경남,의령군,222,15461,761,16444,"2024-03-01",2024
"24-Mar",경남,진주시,658,173827,6666,181151,"2024-03-01",2024
"24-Mar",경남,창녕군,244,36650,760,37654,"2024-03-01",2024
"24-Mar",경남,창원시 마산합포구,347,101469,2910,104726,"2024-03-01",2024
"24-Mar",경남,창원시 마산회원구,154,107233,7412,114799,"2024-03-01",2024
"24-Mar",경남,창원시 성산구,613,170410,63720,234743,"2024-03-01",2024
"24-Mar",경남,창원시 의창구,552,119652,3792,123996,"2024-03-01",2024
"24-Mar",경남,창원시 진해구,228,97100,2111,99439,"2024-03-01",2024
"24-Mar",경남,통영시,316,53692,1345,55353,"2024-03-01",2024
"24-Mar",경남,하동군,238,24588,384,25210,"2024-03-01",2024
"24-Mar",경남,함안군,216,44921,35408,80545,"2024-03-01",2024
"24-Mar",경남,함양군,237,20486,635,21358,"2024-03-01",2024
"24-Mar",경남,합천군,292,24545,651,25488,"2024-03-01",2024
"24-Mar",경남,계,7517,1793122,155390,1956029,"2024-03-01",2024
"24-Mar",제주,서귀포시,776,107993,1875,110644,"2024-03-01",2024
"24-Mar",제주,제주시,1702,315678,276430,593810,"2024-03-01",2024
"24-Mar",제주,계,2478,423671,278305,704454,"2024-03-01",2024
"24-Mar",강원,강릉시,611,114813,4944,120368,"2024-03-01",2024
"24-Mar",강원,고성군,205,16300,230,16735,"2024-03-01",2024
"24-Mar",강원,동해시,330,47927,1551,49808,"2024-03-01",2024
"24-Mar",강원,삼척시,415,33884,839,35138,"2024-03-01",2024
"24-Mar",강원,속초시,318,40886,1488,42692,"2024-03-01",2024
"24-Mar",강원,양구군,228,12596,139,12963,"2024-03-01",2024
"24-Mar",강원,양양군,219,17103,287,17609,"2024-03-01",2024
"24-Mar",강원,영월군,349,22110,396,22855,"2024-03-01",2024
"24-Mar",강원,원주시,653,191017,5993,197663,"2024-03-01",2024
"24-Mar",강원,인제군,231,20004,291,20526,"2024-03-01",2024
"24-Mar",강원,정선군,358,21095,516,21969,"2024-03-01",2024
"24-Mar",강원,철원군,276,24845,404,25525,"2024-03-01",2024
"24-Mar",강원,춘천시,893,143085,6277,150255,"2024-03-01",2024
"24-Mar",강원,태백시,248,20320,658,21226,"2024-03-01",2024
"24-Mar",강원,평창군,326,27285,650,28261,"2024-03-01",2024
"24-Mar",강원,홍천군,441,41182,1029,42652,"2024-03-01",2024
"24-Mar",강원,화천군,230,13315,182,13727,"2024-03-01",2024
"24-Mar",강원,횡성군,285,28815,906,30006,"2024-03-01",2024
"24-Mar",강원,계,6616,836582,26780,869978,"2024-03-01",2024
"24-Mar",전북,고창군,340,32154,586,33080,"2024-03-01",2024
"24-Mar",전북,군산시,556,138285,6402,145243,"2024-03-01",2024
"24-Mar",전북,김제시,331,48920,1971,51222,"2024-03-01",2024
"24-Mar",전북,남원시,433,43131,1273,44837,"2024-03-01",2024
"24-Mar",전북,무주군,220,13807,401,14428,"2024-03-01",2024
"24-Mar",전북,부안군,288,28495,606,29389,"2024-03-01",2024
"24-Mar",전북,순창군,234,15786,159,16179,"2024-03-01",2024
"24-Mar",전북,완주군,457,60034,3193,63684,"2024-03-01",2024
"24-Mar",전북,익산시,555,141907,5882,148344,"2024-03-01",2024
"24-Mar",전북,임실군,262,15044,424,15730,"2024-03-01",2024
"24-Mar",전북,장수군,237,12696,149,13082,"2024-03-01",2024
"24-Mar",전북,전주시 덕진구,394,176151,7212,183757,"2024-03-01",2024
"24-Mar",전북,전주시 완산구,788,156241,4277,161306,"2024-03-01",2024
"24-Mar",전북,정읍시,389,57537,3383,61309,"2024-03-01",2024
"24-Mar",전북,진안군,285,15051,262,15598,"2024-03-01",2024
"24-Mar",전북,계,5769,955239,36180,997188,"2024-03-01",2024
"24-Apr",서울,강남구,410,235759,19921,256090,"2024-04-01",2024
"24-Apr",서울,강동구,303,145984,8452,154739,"2024-04-01",2024
"24-Apr",서울,강북구,321,69565,4203,74089,"2024-04-01",2024
"24-Apr",서울,강서구,363,188608,15396,204367,"2024-04-01",2024
"24-Apr",서울,관악구,290,111790,5782,117862,"2024-04-01",2024
"24-Apr",서울,광진구,321,91795,5117,97233,"2024-04-01",2024
"24-Apr",서울,구로구,302,133910,13396,147608,"2024-04-01",2024
"24-Apr",서울,금천구,174,85461,6282,91917,"2024-04-01",2024
"24-Apr",서울,노원구,326,143224,8639,152189,"2024-04-01",2024
"24-Apr",서울,도봉구,277,87181,7481,94939,"2024-04-01",2024
"24-Apr",서울,동대문구,295,97166,5325,102786,"2024-04-01",2024
"24-Apr",서울,동작구,297,103492,2635,106424,"2024-04-01",2024
"24-Apr",서울,마포구,345,114029,7580,121954,"2024-04-01",2024
"24-Apr",서울,서대문구,434,85704,5560,91698,"2024-04-01",2024
"24-Apr",서울,서초구,504,166527,9556,176587,"2024-04-01",2024
"24-Apr",서울,성동구,373,92686,11649,104708,"2024-04-01",2024
"24-Apr",서울,성북구,288,116874,4965,122127,"2024-04-01",2024
"24-Apr",서울,송파구,405,229344,14193,243942,"2024-04-01",2024
"24-Apr",서울,양천구,338,141928,8483,150749,"2024-04-01",2024
"24-Apr",서울,영등포구,369,136187,8164,144720,"2024-04-01",2024
"24-Apr",서울,용산구,531,70964,2191,73686,"2024-04-01",2024
"24-Apr",서울,은평구,301,127658,7046,135005,"2024-04-01",2024
"24-Apr",서울,종로구,3659,44594,2144,50397,"2024-04-01",2024
"24-Apr",서울,중구,1352,49474,3248,54074,"2024-04-01",2024
"24-Apr",서울,중랑구,253,106691,9636,116580,"2024-04-01",2024
"24-Apr",서울,계,12831,2976595,197044,3186470,"2024-04-01",2024
"24-Apr",부산,강서구,347,85565,5671,91583,"2024-04-01",2024
"24-Apr",부산,금정구,286,77129,7075,84490,"2024-04-01",2024
"24-Apr",부산,기장군,265,86817,2931,90013,"2024-04-01",2024
"24-Apr",부산,남구,229,92254,9427,101910,"2024-04-01",2024
"24-Apr",부산,동구,192,47388,5402,52982,"2024-04-01",2024
"24-Apr",부산,동래구,165,97094,3781,101040,"2024-04-01",2024
"24-Apr",부산,부산진구,371,132383,24285,157039,"2024-04-01",2024
"24-Apr",부산,북구,306,102025,3705,106036,"2024-04-01",2024
"24-Apr",부산,사상구,269,83661,5324,89254,"2024-04-01",2024
"24-Apr",부산,사하구,271,108050,5977,114298,"2024-04-01",2024
"24-Apr",부산,서구,136,30432,1396,31964,"2024-04-01",2024
"24-Apr",부산,수영구,168,64138,62220,126526,"2024-04-01",2024
"24-Apr",부산,연제구,1057,114499,17817,133373,"2024-04-01",2024
"24-Apr",부산,영도구,222,31931,2120,34273,"2024-04-01",2024
"24-Apr",부산,중구,315,34126,7093,41534,"2024-04-01",2024
"24-Apr",부산,해운대구,338,165691,13527,179556,"2024-04-01",2024
"24-Apr",부산,계,4937,1353183,177751,1535871,"2024-04-01",2024
"24-Apr",대구,군위군,129,15685,244,16058,"2024-04-01",2024
"24-Apr",대구,남구,384,55021,1564,56969,"2024-04-01",2024
"24-Apr",대구,달서구,501,274613,18513,293627,"2024-04-01",2024
"24-Apr",대구,달성군,595,140990,5168,146753,"2024-04-01",2024
"24-Apr",대구,동구,368,163284,10087,173739,"2024-04-01",2024
"24-Apr",대구,북구,556,202100,8087,210743,"2024-04-01",2024
"24-Apr",대구,서구,269,71492,4897,76658,"2024-04-01",2024
"24-Apr",대구,수성구,605,215868,5295,221768,"2024-04-01",2024
"24-Apr",대구,중구,318,59281,2248,61847,"2024-04-01",2024
"24-Apr",대구,계,3725,1198334,56103,1258162,"2024-04-01",2024
"24-Apr",인천,강화군,343,38713,11563,50619,"2024-04-01",2024
"24-Apr",인천,계양구,297,124386,144887,269570,"2024-04-01",2024
"24-Apr",인천,남동구,951,258219,29334,288504,"2024-04-01",2024
"24-Apr",인천,동구,111,24460,2852,27423,"2024-04-01",2024
"24-Apr",인천,미추홀구,441,164659,9949,175049,"2024-04-01",2024
"24-Apr",인천,부평구,353,231268,39890,271511,"2024-04-01",2024
"24-Apr",인천,서구,511,305425,13219,319155,"2024-04-01",2024
"24-Apr",인천,연수구,436,220340,9867,230643,"2024-04-01",2024
"24-Apr",인천,옹진군,247,13211,288,13746,"2024-04-01",2024
"24-Apr",인천,중구,724,79231,11950,91905,"2024-04-01",2024
"24-Apr",인천,계,4414,1459912,273799,1738125,"2024-04-01",2024
"24-Apr",광주,광산구,583,205202,13332,219117,"2024-04-01",2024
"24-Apr",광주,남구,239,93644,2768,96651,"2024-04-01",2024
"24-Apr",광주,동구,252,47326,1020,48598,"2024-04-01",2024
"24-Apr",광주,북구,613,199397,9478,209488,"2024-04-01",2024
"24-Apr",광주,서구,754,145299,6233,152286,"2024-04-01",2024
"24-Apr",광주,계,2441,690868,32831,726140,"2024-04-01",2024
"24-Apr",대전,대덕구,240,88533,6916,95689,"2024-04-01",2024
"24-Apr",대전,동구,250,92497,5097,97844,"2024-04-01",2024
"24-Apr",대전,서구,838,210036,20115,230989,"2024-04-01",2024
"24-Apr",대전,유성구,678,194386,5868,200932,"2024-04-01",2024
"24-Apr",대전,중구,223,97155,5318,102696,"2024-04-01",2024
"24-Apr",대전,계,2229,682607,43314,728150,"2024-04-01",2024
"24-Apr",울산,남구,764,157196,7131,165091,"2024-04-01",2024
"24-Apr",울산,동구,193,64317,1256,65766,"2024-04-01",2024
"24-Apr",울산,북구,227,122693,3811,126731,"2024-04-01",2024
"24-Apr",울산,울주군,450,131504,7059,139013,"2024-04-01",2024
"24-Apr",울산,중구,349,102867,2697,105913,"2024-04-01",2024
"24-Apr",울산,계,1983,578577,21954,602514,"2024-04-01",2024
"24-Apr",세종,세종특별자치시,930,195054,3745,199729,"2024-04-01",2024
"24-Apr",세종,계,930,195054,3745,199729,"2024-04-01",2024
"24-Apr",경기,가평군,421,33263,621,34305,"2024-04-01",2024
"24-Apr",경기,고양시 덕양구,686,197467,5202,203355,"2024-04-01",2024
"24-Apr",경기,고양시 일산동구,273,130042,6249,136564,"2024-04-01",2024
"24-Apr",경기,고양시 일산서구,131,117469,4776,122376,"2024-04-01",2024
"24-Apr",경기,과천시,698,32202,808,33708,"2024-04-01",2024
"24-Apr",경기,광명시,315,101169,4762,106246,"2024-04-01",2024
"24-Apr",경기,광주시,430,206497,9015,215942,"2024-04-01",2024
"24-Apr",경기,구리시,272,71232,3000,74504,"2024-04-01",2024
"24-Apr",경기,군포시,302,99478,5350,105130,"2024-04-01",2024
"24-Apr",경기,김포시,572,237640,9201,247413,"2024-04-01",2024
"24-Apr",경기,남양주시,816,320503,9994,331313,"2024-04-01",2024
"24-Apr",경기,동두천시,229,38577,1510,40316,"2024-04-01",2024
"24-Apr",경기,부천시,6,268,22,296,"2024-04-01",2024
"24-Apr",경기,부천시 소사구,85,83789,3219,87093,"2024-04-01",2024
"24-Apr",경기,부천시 오정구,110,63766,3290,67166,"2024-04-01",2024
"24-Apr",경기,부천시 원미구,529,148499,7066,156094,"2024-04-01",2024
"24-Apr",경기,성남시 분당구,366,189296,8004,197666,"2024-04-01",2024
"24-Apr",경기,성남시 수정구,311,81816,3296,85423,"2024-04-01",2024
"24-Apr",경기,성남시 중원구,391,74656,4026,79073,"2024-04-01",2024
"24-Apr",경기,수원시 권선구,484,204448,9715,214647,"2024-04-01",2024
"24-Apr",경기,수원시 영통구,456,152095,3696,156247,"2024-04-01",2024
"24-Apr",경기,수원시 장안구,497,108328,3750,112575,"2024-04-01",2024
"24-Apr",경기,수원시 팔달구,295,82156,3376,85827,"2024-04-01",2024
"24-Apr",경기,시흥시,457,270208,9124,279789,"2024-04-01",2024
"24-Apr",경기,안산시 단원구,581,164241,7994,172816,"2024-04-01",2024
"24-Apr",경기,안산시 상록구,160,144773,5850,150783,"2024-04-01",2024
"24-Apr",경기,안성시,409,115412,4874,120695,"2024-04-01",2024
"24-Apr",경기,안양시 동안구,405,126262,6943,133610,"2024-04-01",2024
"24-Apr",경기,안양시 만안구,159,85320,3878,89357,"2024-04-01",2024
"24-Apr",경기,양주시,443,136157,4340,140940,"2024-04-01",2024
"24-Apr",경기,양평군,623,67362,1944,69929,"2024-04-01",2024
"24-Apr",경기,여주시,474,69556,7839,77869,"2024-04-01",2024
"24-Apr",경기,연천군,330,24750,4917,29997,"2024-04-01",2024
"24-Apr",경기,오산시,226,117092,4366,121684,"2024-04-01",2024
"24-Apr",경기,용인시 기흥구,119,198501,7794,206414,"2024-04-01",2024
"24-Apr",경기,용인시 수지구,58,151198,2370,153626,"2024-04-01",2024
"24-Apr",경기,용인시 처인구,849,144908,8191,153948,"2024-04-01",2024
"24-Apr",경기,의왕시,309,66358,2977,69644,"2024-04-01",2024
"24-Apr",경기,의정부시,772,174521,5736,181029,"2024-04-01",2024
"24-Apr",경기,이천시,440,123911,6603,130954,"2024-04-01",2024
"24-Apr",경기,파주시,562,247090,11915,259567,"2024-04-01",2024
"24-Apr",경기,평택시,795,331016,14436,346247,"2024-04-01",2024
"24-Apr",경기,포천시,424,89898,8631,98953,"2024-04-01",2024
"24-Apr",경기,하남시,446,140968,3682,145096,"2024-04-01",2024
"24-Apr",경기,화성시,993,521318,14461,536772,"2024-04-01",2024
"24-Apr",경기,계,18709,6285476,258813,6562998,"2024-04-01",2024
"24-Apr",충북,괴산군,220,24175,475,24870,"2024-04-01",2024
"24-Apr",충북,단양군,237,16481,859,17577,"2024-04-01",2024
"24-Apr",충북,보은군,248,19114,893,20255,"2024-04-01",2024
"24-Apr",충북,영동군,264,26361,431,27056,"2024-04-01",2024
"24-Apr",충북,옥천군,221,29042,1051,30314,"2024-04-01",2024
"24-Apr",충북,음성군,272,62840,2050,65162,"2024-04-01",2024
"24-Apr",충북,제천시,353,70259,3496,74108,"2024-04-01",2024
"24-Apr",충북,증평군,96,21023,821,21940,"2024-04-01",2024
"24-Apr",충북,진천군,231,55753,1555,57539,"2024-04-01",2024
"24-Apr",충북,청원군,1,19,0,20,"2024-04-01",2024
"24-Apr",충북,청주시 상당구,509,102740,2785,106034,"2024-04-01",2024
"24-Apr",충북,청주시 서원구,248,98833,4566,103647,"2024-04-01",2024
"24-Apr",충북,청주시 청원구,421,108591,5154,114166,"2024-04-01",2024
"24-Apr",충북,청주시 흥덕구,381,145008,7743,153132,"2024-04-01",2024
"24-Apr",충북,충주시,640,117364,8307,126311,"2024-04-01",2024
"24-Apr",충북,계,4342,897603,40186,942131,"2024-04-01",2024
"24-Apr",충남,계룡시,175,26238,612,27025,"2024-04-01",2024
"24-Apr",충남,공주시,603,56668,2551,59822,"2024-04-01",2024
"24-Apr",충남,금산군,209,30291,2417,32917,"2024-04-01",2024
"24-Apr",충남,논산시,414,63011,2357,65782,"2024-04-01",2024
"24-Apr",충남,당진시,437,106390,4249,111076,"2024-04-01",2024
"24-Apr",충남,보령시,420,54604,1404,56428,"2024-04-01",2024
"24-Apr",충남,부여군,329,35403,976,36708,"2024-04-01",2024
"24-Apr",충남,서산시,446,103365,3792,107603,"2024-04-01",2024
"24-Apr",충남,서천군,240,28096,792,29128,"2024-04-01",2024
"24-Apr",충남,아산시,559,199888,7053,207500,"2024-04-01",2024
"24-Apr",충남,예산군,464,47269,1442,49175,"2024-04-01",2024
"24-Apr",충남,천안시 동남구,307,142217,5613,148137,"2024-04-01",2024
"24-Apr",충남,천안시 서북구,561,206295,5554,212410,"2024-04-01",2024
"24-Apr",충남,청양군,268,17969,710,18947,"2024-04-01",2024
"24-Apr",충남,태안군,343,36471,610,37424,"2024-04-01",2024
"24-Apr",충남,홍성군,416,56338,1422,58176,"2024-04-01",2024
"24-Apr",충남,계,6191,1210513,41554,1258258,"2024-04-01",2024
"24-Apr",전남,강진군,256,19434,1026,20716,"2024-04-01",2024
"24-Apr",전남,고흥군,318,34416,555,35289,"2024-04-01",2024
"24-Apr",전남,곡성군,186,16013,624,16823,"2024-04-01",2024
"24-Apr",전남,광양시,263,93185,6264,99712,"2024-04-01",2024
"24-Apr",전남,구례군,176,13575,688,14439,"2024-04-01",2024
"24-Apr",전남,나주시,490,70149,3127,73766,"2024-04-01",2024
"24-Apr",전남,담양군,217,28928,1822,30967,"2024-04-01",2024
"24-Apr",전남,목포시,404,99171,5388,104963,"2024-04-01",2024
"24-Apr",전남,무안군,631,52565,1195,54391,"2024-04-01",2024
"24-Apr",전남,보성군,248,22638,636,23522,"2024-04-01",2024
"24-Apr",전남,순천시,511,149207,5467,155185,"2024-04-01",2024
"24-Apr",전남,신안군,384,24077,103113,127574,"2024-04-01",2024
"24-Apr",전남,여수시,557,138639,7430,146626,"2024-04-01",2024
"24-Apr",전남,영광군,242,29955,791,30988,"2024-04-01",2024
"24-Apr",전남,영암군,279,37004,1117,38400,"2024-04-01",2024
"24-Apr",전남,완도군,300,26554,515,27369,"2024-04-01",2024
"24-Apr",전남,장성군,219,28135,1312,29666,"2024-04-01",2024
"24-Apr",전남,장흥군,279,20908,459,21646,"2024-04-01",2024
"24-Apr",전남,진도군,226,18001,314,18541,"2024-04-01",2024
"24-Apr",전남,함평군,218,19395,6790,26403,"2024-04-01",2024
"24-Apr",전남,해남군,341,41669,82825,124835,"2024-04-01",2024
"24-Apr",전남,화순군,259,34626,2011,36896,"2024-04-01",2024
"24-Apr",전남,계,7004,1018244,233469,1258717,"2024-04-01",2024
"24-Apr",경북,경산시,384,144069,4428,148881,"2024-04-01",2024
"24-Apr",경북,경주시,607,148680,4556,153843,"2024-04-01",2024
"24-Apr",경북,고령군,184,21530,818,22532,"2024-04-01",2024
"24-Apr",경북,구미시,552,222873,7445,230870,"2024-04-01",2024
"24-Apr",경북,군위군,0,51,5,56,"2024-04-01",2024
"24-Apr",경북,김천시,411,78519,2136,81066,"2024-04-01",2024
"24-Apr",경북,문경시,297,38868,883,40048,"2024-04-01",2024
"24-Apr",경북,봉화군,249,18647,200,19096,"2024-04-01",2024
"24-Apr",경북,상주시,412,56020,1876,58308,"2024-04-01",2024
"24-Apr",경북,성주군,223,32466,1296,33985,"2024-04-01",2024
"24-Apr",경북,안동시,810,85900,2633,89343,"2024-04-01",2024
"24-Apr",경북,영덕군,259,19518,310,20087,"2024-04-01",2024
"24-Apr",경북,영양군,147,10229,116,10492,"2024-04-01",2024
"24-Apr",경북,영주시,383,57637,1532,59552,"2024-04-01",2024
"24-Apr",경북,영천시,361,63762,2544,66667,"2024-04-01",2024
"24-Apr",경북,예천군,287,32433,486,33206,"2024-04-01",2024
"24-Apr",경북,울릉군,150,5999,562,6711,"2024-04-01",2024
"24-Apr",경북,울진군,334,27686,364,28384,"2024-04-01",2024
"24-Apr",경북,의성군,296,32803,1124,34223,"2024-04-01",2024
"24-Apr",경북,청도군,223,26355,963,27541,"2024-04-01",2024
"24-Apr",경북,청송군,225,16476,209,16910,"2024-04-01",2024
"24-Apr",경북,칠곡군,314,71231,2482,74027,"2024-04-01",2024
"24-Apr",경북,포항시 남구,442,126817,8133,135392,"2024-04-01",2024
"24-Apr",경북,포항시 북구,385,147462,3732,151579,"2024-04-01",2024
"24-Apr",경북,계,7935,1486031,48833,1542799,"2024-04-01",2024
"24-Apr",경남,거제시,365,110253,2118,112736,"2024-04-01",2024
"24-Apr",경남,거창군,288,34759,789,35836,"2024-04-01",2024
"24-Apr",경남,고성군,231,28082,560,28873,"2024-04-01",2024
"24-Apr",경남,김해시,701,291012,7974,299687,"2024-04-01",2024
"24-Apr",경남,남해군,302,20858,447,21607,"2024-04-01",2024
"24-Apr",경남,밀양시,323,58824,3916,63063,"2024-04-01",2024
"24-Apr",경남,사천시,341,59910,1537,61788,"2024-04-01",2024
"24-Apr",경남,산청군,256,21504,751,22511,"2024-04-01",2024
"24-Apr",경남,양산시,441,178349,10636,189426,"2024-04-01",2024
"24-Apr",경남,의령군,221,15474,760,16455,"2024-04-01",2024
"24-Apr",경남,진주시,667,173674,6666,181007,"2024-04-01",2024
"24-Apr",경남,창녕군,244,36536,764,37544,"2024-04-01",2024
"24-Apr",경남,창원시 마산합포구,354,101807,2895,105056,"2024-04-01",2024
"24-Apr",경남,창원시 마산회원구,155,107293,7449,114897,"2024-04-01",2024
"24-Apr",경남,창원시 성산구,617,170542,63967,235126,"2024-04-01",2024
"24-Apr",경남,창원시 의창구,555,119611,3817,123983,"2024-04-01",2024
"24-Apr",경남,창원시 진해구,234,97117,2097,99448,"2024-04-01",2024
"24-Apr",경남,통영시,316,53756,1343,55415,"2024-04-01",2024
"24-Apr",경남,하동군,236,24584,390,25210,"2024-04-01",2024
"24-Apr",경남,함안군,226,44732,35253,80211,"2024-04-01",2024
"24-Apr",경남,함양군,242,20536,633,21411,"2024-04-01",2024
"24-Apr",경남,합천군,293,24540,655,25488,"2024-04-01",2024
"24-Apr",경남,계,7608,1793753,155417,1956778,"2024-04-01",2024
"24-Apr",제주,서귀포시,778,107828,1871,110477,"2024-04-01",2024
"24-Apr",제주,제주시,1704,316291,277939,595934,"2024-04-01",2024
"24-Apr",제주,계,2482,424119,279810,706411,"2024-04-01",2024
"24-Apr",강원,강릉시,618,114829,4944,120391,"2024-04-01",2024
"24-Apr",강원,고성군,205,16343,233,16781,"2024-04-01",2024
"24-Apr",강원,동해시,329,47996,1559,49884,"2024-04-01",2024
"24-Apr",강원,삼척시,418,33929,843,35190,"2024-04-01",2024
"24-Apr",강원,속초시,320,40817,1488,42625,"2024-04-01",2024
"24-Apr",강원,양구군,226,12565,141,12932,"2024-04-01",2024
"24-Apr",강원,양양군,219,17081,287,17587,"2024-04-01",2024
"24-Apr",강원,영월군,349,22088,396,22833,"2024-04-01",2024
"24-Apr",강원,원주시,651,191176,5976,197803,"2024-04-01",2024
"24-Apr",강원,인제군,232,20069,287,20588,"2024-04-01",2024
"24-Apr",강원,정선군,364,21100,502,21966,"2024-04-01",2024
"24-Apr",강원,철원군,279,24862,394,25535,"2024-04-01",2024
"24-Apr",강원,춘천시,904,143224,6252,150380,"2024-04-01",2024
"24-Apr",강원,태백시,249,20286,663,21198,"2024-04-01",2024
"24-Apr",강원,평창군,329,27224,588,28141,"2024-04-01",2024
"24-Apr",강원,홍천군,435,41204,1031,42670,"2024-04-01",2024
"24-Apr",강원,화천군,230,13359,179,13768,"2024-04-01",2024
"24-Apr",강원,횡성군,290,28850,909,30049,"2024-04-01",2024
"24-Apr",강원,계,6647,837002,26672,870321,"2024-04-01",2024
"24-Apr",전북,고창군,338,32126,586,33050,"2024-04-01",2024
"24-Apr",전북,군산시,560,138248,6387,145195,"2024-04-01",2024
"24-Apr",전북,김제시,328,48939,1952,51219,"2024-04-01",2024
"24-Apr",전북,남원시,437,43152,1253,44842,"2024-04-01",2024
"24-Apr",전북,무주군,220,13779,402,14401,"2024-04-01",2024
"24-Apr",전북,부안군,289,28491,615,29395,"2024-04-01",2024
"24-Apr",전북,순창군,233,15810,178,16221,"2024-04-01",2024
"24-Apr",전북,완주군,459,60177,3201,63837,"2024-04-01",2024
"24-Apr",전북,익산시,556,141933,5906,148395,"2024-04-01",2024
"24-Apr",전북,임실군,262,15058,424,15744,"2024-04-01",2024
"24-Apr",전북,장수군,237,12702,148,13087,"2024-04-01",2024
"24-Apr",전북,전주시 덕진구,384,175589,7227,183200,"2024-04-01",2024
"24-Apr",전북,전주시 완산구,785,156216,4277,161278,"2024-04-01",2024
"24-Apr",전북,정읍시,384,57571,3318,61273,"2024-04-01",2024
"24-Apr",전북,진안군,286,15089,272,15647,"2024-04-01",2024
"24-Apr",전북,계,5758,954880,36146,996784,"2024-04-01",2024
"24-May",서울,강남구,409,236199,19725,256333,"2024-05-01",2024
"24-May",서울,강동구,302,146197,8426,154925,"2024-05-01",2024
"24-May",서울,강북구,323,69538,4193,74054,"2024-05-01",2024
"24-May",서울,강서구,359,188839,15171,204369,"2024-05-01",2024
"24-May",서울,관악구,290,111799,5779,117868,"2024-05-01",2024
"24-May",서울,광진구,320,91736,5119,97175,"2024-05-01",2024
"24-May",서울,구로구,303,133829,13235,147367,"2024-05-01",2024
"24-May",서울,금천구,174,85411,6275,91860,"2024-05-01",2024
"24-May",서울,노원구,326,143150,8644,152120,"2024-05-01",2024
"24-May",서울,도봉구,276,87101,7455,94832,"2024-05-01",2024
"24-May",서울,동대문구,294,97131,5365,102790,"2024-05-01",2024
"24-May",서울,동작구,298,103628,2611,106537,"2024-05-01",2024
"24-May",서울,마포구,349,114053,7596,121998,"2024-05-01",2024
"24-May",서울,서대문구,454,85772,5602,91828,"2024-05-01",2024
"24-May",서울,서초구,533,166465,9519,176517,"2024-05-01",2024
"24-May",서울,성동구,375,92698,11710,104783,"2024-05-01",2024
"24-May",서울,성북구,288,116871,4937,122096,"2024-05-01",2024
"24-May",서울,송파구,402,229358,14191,243951,"2024-05-01",2024
"24-May",서울,양천구,339,141890,8476,150705,"2024-05-01",2024
"24-May",서울,영등포구,371,136142,8189,144702,"2024-05-01",2024
"24-May",서울,용산구,539,70758,2220,73517,"2024-05-01",2024
"24-May",서울,은평구,301,127659,7059,135019,"2024-05-01",2024
"24-May",서울,종로구,3658,44591,2140,50389,"2024-05-01",2024
"24-May",서울,중구,1351,49231,3224,53806,"2024-05-01",2024
"24-May",서울,중랑구,246,106814,9618,116678,"2024-05-01",2024
"24-May",서울,계,12880,2976860,196479,3186219,"2024-05-01",2024
"24-May",부산,강서구,346,85795,5807,91948,"2024-05-01",2024
"24-May",부산,금정구,286,76997,7085,84368,"2024-05-01",2024
"24-May",부산,기장군,264,86998,2891,90153,"2024-05-01",2024
"24-May",부산,남구,229,92348,9458,102035,"2024-05-01",2024
"24-May",부산,동구,193,48183,5217,53593,"2024-05-01",2024
"24-May",부산,동래구,165,97081,3781,101027,"2024-05-01",2024
"24-May",부산,부산진구,368,132612,24630,157610,"2024-05-01",2024
"24-May",부산,북구,295,101974,3701,105970,"2024-05-01",2024
"24-May",부산,사상구,265,83708,5325,89298,"2024-05-01",2024
"24-May",부산,사하구,272,108043,5993,114308,"2024-05-01",2024
"24-May",부산,서구,135,30439,1394,31968,"2024-05-01",2024
"24-May",부산,수영구,165,64065,63239,127469,"2024-05-01",2024
"24-May",부산,연제구,1055,114675,18197,133927,"2024-05-01",2024
"24-May",부산,영도구,222,31886,2021,34129,"2024-05-01",2024
"24-May",부산,중구,313,34434,7078,41825,"2024-05-01",2024
"24-May",부산,해운대구,338,165643,13252,179233,"2024-05-01",2024
"24-May",부산,계,4911,1354881,179069,1538861,"2024-05-01",2024
"24-May",대구,군위군,130,15695,246,16071,"2024-05-01",2024
"24-May",대구,남구,385,54811,1557,56753,"2024-05-01",2024
"24-May",대구,달서구,487,274161,18735,293383,"2024-05-01",2024
"24-May",대구,달성군,596,140752,5172,146520,"2024-05-01",2024
"24-May",대구,동구,368,163967,10060,174395,"2024-05-01",2024
"24-May",대구,북구,563,202380,8088,211031,"2024-05-01",2024
"24-May",대구,서구,262,71329,4891,76482,"2024-05-01",2024
"24-May",대구,수성구,603,215622,5265,221490,"2024-05-01",2024
"24-May",대구,중구,318,59271,2231,61820,"2024-05-01",2024
"24-May",대구,계,3712,1197988,56245,1257945,"2024-05-01",2024
"24-May",인천,강화군,345,38735,10914,49994,"2024-05-01",2024
"24-May",인천,계양구,300,124742,147976,273018,"2024-05-01",2024
"24-May",인천,남동구,954,258128,27531,286613,"2024-05-01",2024
"24-May",인천,동구,110,24480,2849,27439,"2024-05-01",2024
"24-May",인천,미추홀구,439,164852,11507,176798,"2024-05-01",2024
"24-May",인천,부평구,352,231585,39599,271536,"2024-05-01",2024
"24-May",인천,서구,506,305495,13187,319188,"2024-05-01",2024
"24-May",인천,연수구,436,221067,9950,231453,"2024-05-01",2024
"24-May",인천,옹진군,247,13192,291,13730,"2024-05-01",2024
"24-May",인천,중구,716,79473,12120,92309,"2024-05-01",2024
"24-May",인천,계,4405,1461749,275924,1742078,"2024-05-01",2024
"24-May",광주,광산구,576,205382,13373,219331,"2024-05-01",2024
"24-May",광주,남구,236,93360,2768,96364,"2024-05-01",2024
"24-May",광주,동구,250,47306,1015,48571,"2024-05-01",2024
"24-May",광주,북구,624,200083,9405,210112,"2024-05-01",2024
"24-May",광주,서구,753,145072,6312,152137,"2024-05-01",2024
"24-May",광주,계,2439,691203,32873,726515,"2024-05-01",2024
"24-May",대전,대덕구,239,88571,6889,95699,"2024-05-01",2024
"24-May",대전,동구,251,92479,5089,97819,"2024-05-01",2024
"24-May",대전,서구,838,209804,20880,231522,"2024-05-01",2024
"24-May",대전,유성구,670,195237,5810,201717,"2024-05-01",2024
"24-May",대전,중구,225,97111,5338,102674,"2024-05-01",2024
"24-May",대전,계,2223,683202,44006,729431,"2024-05-01",2024
"24-May",울산,남구,763,157275,7166,165204,"2024-05-01",2024
"24-May",울산,동구,193,64369,1258,65820,"2024-05-01",2024
"24-May",울산,북구,227,122985,3748,126960,"2024-05-01",2024
"24-May",울산,울주군,450,131698,7027,139175,"2024-05-01",2024
"24-May",울산,중구,347,102962,2693,106002,"2024-05-01",2024
"24-May",울산,계,1980,579289,21892,603161,"2024-05-01",2024
"24-May",세종,세종특별자치시,943,195227,3789,199959,"2024-05-01",2024
"24-May",세종,계,943,195227,3789,199959,"2024-05-01",2024
"24-May",경기,가평군,420,33354,619,34393,"2024-05-01",2024
"24-May",경기,고양시 덕양구,694,197479,5185,203358,"2024-05-01",2024
"24-May",경기,고양시 일산동구,270,130496,6235,137001,"2024-05-01",2024
"24-May",경기,고양시 일산서구,129,117330,4737,122196,"2024-05-01",2024
"24-May",경기,과천시,708,32638,813,34159,"2024-05-01",2024
"24-May",경기,광명시,313,101163,4762,106238,"2024-05-01",2024
"24-May",경기,광주시,434,206502,9017,215953,"2024-05-01",2024
"24-May",경기,구리시,276,71207,2997,74480,"2024-05-01",2024
"24-May",경기,군포시,304,99411,5312,105027,"2024-05-01",2024
"24-May",경기,김포시,579,238079,9160,247818,"2024-05-01",2024
"24-May",경기,남양주시,805,320419,10065,331289,"2024-05-01",2024
"24-May",경기,동두천시,228,38510,1519,40257,"2024-05-01",2024
"24-May",경기,부천시,6,267,22,295,"2024-05-01",2024
"24-May",경기,부천시 소사구,85,83790,3232,87107,"2024-05-01",2024
"24-May",경기,부천시 오정구,112,63760,3302,67174,"2024-05-01",2024
"24-May",경기,부천시 원미구,529,148521,7078,156128,"2024-05-01",2024
"24-May",경기,성남시 분당구,365,189205,7996,197566,"2024-05-01",2024
"24-May",경기,성남시 수정구,309,81906,3343,85558,"2024-05-01",2024
"24-May",경기,성남시 중원구,393,74607,4014,79014,"2024-05-01",2024
"24-May",경기,수원시 권선구,484,205434,9828,215746,"2024-05-01",2024
"24-May",경기,수원시 영통구,456,152132,3673,156261,"2024-05-01",2024
"24-May",경기,수원시 장안구,495,109060,3806,113361,"2024-05-01",2024
"24-May",경기,수원시 팔달구,298,82143,3339,85780,"2024-05-01",2024
"24-May",경기,시흥시,450,270285,9148,279883,"2024-05-01",2024
"24-May",경기,안산시 단원구,592,164753,7962,173307,"2024-05-01",2024
"24-May",경기,안산시 상록구,160,144810,5824,150794,"2024-05-01",2024
"24-May",경기,안성시,409,115764,4878,121051,"2024-05-01",2024
"24-May",경기,안양시 동안구,398,126302,6925,133625,"2024-05-01",2024
"24-May",경기,안양시 만안구,157,85362,3886,89405,"2024-05-01",2024
"24-May",경기,양주시,451,136966,4382,141799,"2024-05-01",2024
"24-May",경기,양평군,620,67474,1941,70035,"2024-05-01",2024
"24-May",경기,여주시,481,69655,7868,78004,"2024-05-01",2024
"24-May",경기,연천군,327,24718,4918,29963,"2024-05-01",2024
"24-May",경기,오산시,227,117602,4377,122206,"2024-05-01",2024
"24-May",경기,용인시 기흥구,118,198843,7778,206739,"2024-05-01",2024
"24-May",경기,용인시 수지구,59,151165,2347,153571,"2024-05-01",2024
"24-May",경기,용인시 처인구,852,145954,8238,155044,"2024-05-01",2024
"24-May",경기,의왕시,310,66182,2973,69465,"2024-05-01",2024
"24-May",경기,의정부시,773,174574,5744,181091,"2024-05-01",2024
"24-May",경기,이천시,442,124233,6623,131298,"2024-05-01",2024
"24-May",경기,파주시,560,247590,11859,260009,"2024-05-01",2024
"24-May",경기,평택시,799,331188,14438,346425,"2024-05-01",2024
"24-May",경기,포천시,420,89887,8396,98703,"2024-05-01",2024
"24-May",경기,하남시,450,141115,3667,145232,"2024-05-01",2024
"24-May",경기,화성시,993,522244,14595,537832,"2024-05-01",2024
"24-May",경기,계,18740,6294079,258821,6571640,"2024-05-01",2024
"24-May",충북,괴산군,222,24152,475,24849,"2024-05-01",2024
"24-May",충북,단양군,238,16511,862,17611,"2024-05-01",2024
"24-May",충북,보은군,250,19163,888,20301,"2024-05-01",2024
"24-May",충북,영동군,264,26415,428,27107,"2024-05-01",2024
"24-May",충북,옥천군,224,29129,1045,30398,"2024-05-01",2024
"24-May",충북,음성군,271,62761,2070,65102,"2024-05-01",2024
"24-May",충북,제천시,352,70306,3494,74152,"2024-05-01",2024
"24-May",충북,증평군,96,21073,822,21991,"2024-05-01",2024
"24-May",충북,진천군,232,55966,1556,57754,"2024-05-01",2024
"24-May",충북,청원군,1,19,0,20,"2024-05-01",2024
"24-May",충북,청주시 상당구,508,102437,2809,105754,"2024-05-01",2024
"24-May",충북,청주시 서원구,248,98246,4559,103053,"2024-05-01",2024
"24-May",충북,청주시 청원구,422,108246,5163,113831,"2024-05-01",2024
"24-May",충북,청주시 흥덕구,364,146033,7711,154108,"2024-05-01",2024
"24-May",충북,충주시,634,117389,8198,126221,"2024-05-01",2024
"24-May",충북,계,4326,897846,40080,942252,"2024-05-01",2024
"24-May",충남,계룡시,177,26249,614,27040,"2024-05-01",2024
"24-May",충남,공주시,601,56764,2511,59876,"2024-05-01",2024
"24-May",충남,금산군,209,30300,2448,32957,"2024-05-01",2024
"24-May",충남,논산시,415,63074,2369,65858,"2024-05-01",2024
"24-May",충남,당진시,434,106640,4271,111345,"2024-05-01",2024
"24-May",충남,보령시,418,54610,1404,56432,"2024-05-01",2024
"24-May",충남,부여군,328,35410,975,36713,"2024-05-01",2024
"24-May",충남,서산시,444,103446,3844,107734,"2024-05-01",2024
"24-May",충남,서천군,240,28152,801,29193,"2024-05-01",2024
"24-May",충남,아산시,563,200374,7030,207967,"2024-05-01",2024
"24-May",충남,예산군,468,47384,1436,49288,"2024-05-01",2024
"24-May",충남,천안시 동남구,308,142523,5635,148466,"2024-05-01",2024
"24-May",충남,천안시 서북구,557,206736,5516,212809,"2024-05-01",2024
"24-May",충남,청양군,269,17977,695,18941,"2024-05-01",2024
"24-May",충남,태안군,344,36557,611,37512,"2024-05-01",2024
"24-May",충남,홍성군,417,56377,1407,58201,"2024-05-01",2024
"24-May",충남,계,6192,1212573,41567,1260332,"2024-05-01",2024
"24-May",전남,강진군,255,19469,1018,20742,"2024-05-01",2024
"24-May",전남,고흥군,318,34472,552,35342,"2024-05-01",2024
"24-May",전남,곡성군,186,16033,625,16844,"2024-05-01",2024
"24-May",전남,광양시,263,93386,6237,99886,"2024-05-01",2024
"24-May",전남,구례군,178,13602,686,14466,"2024-05-01",2024
"24-May",전남,나주시,490,70145,3135,73770,"2024-05-01",2024
"24-May",전남,담양군,217,28957,1826,31000,"2024-05-01",2024
"24-May",전남,목포시,401,99312,5396,105109,"2024-05-01",2024
"24-May",전남,무안군,624,52617,1193,54434,"2024-05-01",2024
"24-May",전남,보성군,246,22676,628,23550,"2024-05-01",2024
"24-May",전남,순천시,511,149382,5481,155374,"2024-05-01",2024
"24-May",전남,신안군,387,24116,103689,128192,"2024-05-01",2024
"24-May",전남,여수시,562,138663,7479,146704,"2024-05-01",2024
"24-May",전남,영광군,246,29886,793,30925,"2024-05-01",2024
"24-May",전남,영암군,280,37005,1113,38398,"2024-05-01",2024
"24-May",전남,완도군,300,26573,510,27383,"2024-05-01",2024
"24-May",전남,장성군,220,28089,1293,29602,"2024-05-01",2024
"24-May",전남,장흥군,277,20920,458,21655,"2024-05-01",2024
"24-May",전남,진도군,226,18009,313,18548,"2024-05-01",2024
"24-May",전남,함평군,220,19443,6687,26350,"2024-05-01",2024
"24-May",전남,해남군,341,41673,83546,125560,"2024-05-01",2024
"24-May",전남,화순군,260,34666,2026,36952,"2024-05-01",2024
"24-May",전남,계,7008,1019094,234684,1260786,"2024-05-01",2024
"24-May",경북,경산시,383,144223,4439,149045,"2024-05-01",2024
"24-May",경북,경주시,606,148828,4552,153986,"2024-05-01",2024
"24-May",경북,고령군,181,21639,820,22640,"2024-05-01",2024
"24-May",경북,구미시,550,222920,7438,230908,"2024-05-01",2024
"24-May",경북,군위군,0,51,5,56,"2024-05-01",2024
"24-May",경북,김천시,410,78536,2139,81085,"2024-05-01",2024
"24-May",경북,문경시,295,38880,882,40057,"2024-05-01",2024
"24-May",경북,봉화군,248,18618,200,19066,"2024-05-01",2024
"24-May",경북,상주시,411,56037,1875,58323,"2024-05-01",2024
"24-May",경북,성주군,209,32439,1293,33941,"2024-05-01",2024
"24-May",경북,안동시,806,86012,2632,89450,"2024-05-01",2024
"24-May",경북,영덕군,256,19546,310,20112,"2024-05-01",2024
"24-May",경북,영양군,147,10247,117,10511,"2024-05-01",2024
"24-May",경북,영주시,381,57669,1541,59591,"2024-05-01",2024
"24-May",경북,영천시,360,63805,2534,66699,"2024-05-01",2024
"24-May",경북,예천군,296,32451,486,33233,"2024-05-01",2024
"24-May",경북,울릉군,150,6058,570,6778,"2024-05-01",2024
"24-May",경북,울진군,331,27704,365,28400,"2024-05-01",2024
"24-May",경북,의성군,296,32736,1124,34156,"2024-05-01",2024
"24-May",경북,청도군,226,26330,966,27522,"2024-05-01",2024
"24-May",경북,청송군,224,16433,210,16867,"2024-05-01",2024
"24-May",경북,칠곡군,314,71304,2486,74104,"2024-05-01",2024
"24-May",경북,포항시 남구,443,126411,8128,134982,"2024-05-01",2024
"24-May",경북,포항시 북구,383,148156,3738,152277,"2024-05-01",2024
"24-May",경북,계,7906,1487033,48850,1543789,"2024-05-01",2024
"24-May",경남,거제시,366,110376,2139,112881,"2024-05-01",2024
"24-May",경남,거창군,290,34807,793,35890,"2024-05-01",2024
"24-May",경남,고성군,232,28041,558,28831,"2024-05-01",2024
"24-May",경남,김해시,700,291410,8007,300117,"2024-05-01",2024
"24-May",경남,남해군,303,20847,446,21596,"2024-05-01",2024
"24-May",경남,밀양시,324,58797,3906,63027,"2024-05-01",2024
"24-May",경남,사천시,341,60002,1558,61901,"2024-05-01",2024
"24-May",경남,산청군,255,21506,752,22513,"2024-05-01",2024
"24-May",경남,양산시,439,178797,10654,189890,"2024-05-01",2024
"24-May",경남,의령군,221,15479,762,16462,"2024-05-01",2024
"24-May",경남,진주시,667,173756,6694,181117,"2024-05-01",2024
"24-May",경남,창녕군,245,36585,765,37595,"2024-05-01",2024
"24-May",경남,창원시 마산합포구,353,101841,2893,105087,"2024-05-01",2024
"24-May",경남,창원시 마산회원구,155,107486,7760,115401,"2024-05-01",2024
"24-May",경남,창원시 성산구,616,171007,62307,233930,"2024-05-01",2024
"24-May",경남,창원시 의창구,551,119731,3812,124094,"2024-05-01",2024
"24-May",경남,창원시 진해구,231,97120,2105,99456,"2024-05-01",2024
"24-May",경남,통영시,316,53776,1357,55449,"2024-05-01",2024
"24-May",경남,하동군,239,24578,387,25204,"2024-05-01",2024
"24-May",경남,함안군,223,44979,36122,81324,"2024-05-01",2024
"24-May",경남,함양군,245,20565,635,21445,"2024-05-01",2024
"24-May",경남,합천군,295,24519,665,25479,"2024-05-01",2024
"24-May",경남,계,7607,1796005,155077,1958689,"2024-05-01",2024
"24-May",제주,서귀포시,777,107708,1870,110355,"2024-05-01",2024
"24-May",제주,제주시,1701,316704,277775,596180,"2024-05-01",2024
"24-May",제주,계,2478,424412,279645,706535,"2024-05-01",2024
"24-May",강원,강릉시,613,114943,4903,120459,"2024-05-01",2024
"24-May",강원,고성군,208,16357,231,16796,"2024-05-01",2024
"24-May",강원,동해시,328,48106,1568,50002,"2024-05-01",2024
"24-May",강원,삼척시,416,33939,839,35194,"2024-05-01",2024
"24-May",강원,속초시,320,40791,1491,42602,"2024-05-01",2024
"24-May",강원,양구군,225,12548,142,12915,"2024-05-01",2024
"24-May",강원,양양군,219,17079,280,17578,"2024-05-01",2024
"24-May",강원,영월군,353,22103,399,22855,"2024-05-01",2024
"24-May",강원,원주시,649,191272,5985,197906,"2024-05-01",2024
"24-May",강원,인제군,235,20138,283,20656,"2024-05-01",2024
"24-May",강원,정선군,368,21060,498,21926,"2024-05-01",2024
"24-May",강원,철원군,278,24875,398,25551,"2024-05-01",2024
"24-May",강원,춘천시,896,143264,6260,150420,"2024-05-01",2024
"24-May",강원,태백시,250,20274,663,21187,"2024-05-01",2024
"24-May",강원,평창군,330,27262,624,28216,"2024-05-01",2024
"24-May",강원,홍천군,436,41276,1034,42746,"2024-05-01",2024
"24-May",강원,화천군,231,13394,180,13805,"2024-05-01",2024
"24-May",강원,횡성군,294,28863,909,30066,"2024-05-01",2024
"24-May",강원,계,6649,837544,26687,870880,"2024-05-01",2024
"24-May",전북,고창군,339,32167,583,33089,"2024-05-01",2024
"24-May",전북,군산시,563,138326,6400,145289,"2024-05-01",2024
"24-May",전북,김제시,331,48972,1914,51217,"2024-05-01",2024
"24-May",전북,남원시,438,43193,1240,44871,"2024-05-01",2024
"24-May",전북,무주군,218,13814,403,14435,"2024-05-01",2024
"24-May",전북,부안군,289,28517,612,29418,"2024-05-01",2024
"24-May",전북,순창군,234,15869,188,16291,"2024-05-01",2024
"24-May",전북,완주군,462,60165,3212,63839,"2024-05-01",2024
"24-May",전북,익산시,557,141952,5900,148409,"2024-05-01",2024
"24-May",전북,임실군,263,15110,428,15801,"2024-05-01",2024
"24-May",전북,장수군,237,12710,150,13097,"2024-05-01",2024
"24-May",전북,전주시 덕진구,376,175807,7198,183381,"2024-05-01",2024
"24-May",전북,전주시 완산구,786,156167,4263,161216,"2024-05-01",2024
"24-May",전북,정읍시,388,57631,3302,61321,"2024-05-01",2024
"24-May",전북,진안군,285,15109,270,15664,"2024-05-01",2024
"24-May",전북,계,5766,955509,36063,997338,"2024-05-01",2024
"24-Jun",서울,강남구,409,236474,20463,257346,"2024-06-01",2024
"24-Jun",서울,강동구,302,146535,8400,155237,"2024-06-01",2024
"24-Jun",서울,강북구,322,69422,4176,73920,"2024-06-01",2024
"24-Jun",서울,강서구,362,188982,15131,204475,"2024-06-01",2024
"24-Jun",서울,관악구,290,111705,5783,117778,"2024-06-01",2024
"24-Jun",서울,광진구,318,91582,5181,97081,"2024-06-01",2024
"24-Jun",서울,구로구,303,133784,13102,147189,"2024-06-01",2024
"24-Jun",서울,금천구,173,85339,6260,91772,"2024-06-01",2024
"24-Jun",서울,노원구,326,143047,8697,152070,"2024-06-01",2024
"24-Jun",서울,도봉구,277,87040,7416,94733,"2024-06-01",2024
"24-Jun",서울,동대문구,296,97093,5386,102775,"2024-06-01",2024
"24-Jun",서울,동작구,300,103686,2590,106576,"2024-06-01",2024
"24-Jun",서울,마포구,350,113950,7633,121933,"2024-06-01",2024
"24-Jun",서울,서대문구,459,85790,5692,91941,"2024-06-01",2024
"24-Jun",서울,서초구,506,166764,9518,176788,"2024-06-01",2024
"24-Jun",서울,성동구,373,92753,11943,105069,"2024-06-01",2024
"24-Jun",서울,성북구,289,116885,4927,122101,"2024-06-01",2024
"24-Jun",서울,송파구,400,229283,14284,243967,"2024-06-01",2024
"24-Jun",서울,양천구,341,141753,8438,150532,"2024-06-01",2024
"24-Jun",서울,영등포구,370,136257,8187,144814,"2024-06-01",2024
"24-Jun",서울,용산구,542,70767,2281,73590,"2024-06-01",2024
"24-Jun",서울,은평구,301,127445,7048,134794,"2024-06-01",2024
"24-Jun",서울,종로구,3611,44498,2138,50247,"2024-06-01",2024
"24-Jun",서울,중구,1352,49034,3211,53597,"2024-06-01",2024
"24-Jun",서울,중랑구,246,106814,9670,116730,"2024-06-01",2024
"24-Jun",서울,계,12818,2976682,197555,3187055,"2024-06-01",2024
"24-Jun",부산,강서구,346,85904,5759,92009,"2024-06-01",2024
"24-Jun",부산,금정구,285,76863,7081,84229,"2024-06-01",2024
"24-Jun",부산,기장군,263,87291,2892,90446,"2024-06-01",2024
"24-Jun",부산,남구,230,92593,9470,102293,"2024-06-01",2024
"24-Jun",부산,동구,193,48683,5276,54152,"2024-06-01",2024
"24-Jun",부산,동래구,165,97220,3780,101165,"2024-06-01",2024
"24-Jun",부산,부산진구,369,133088,25234,158691,"2024-06-01",2024
"24-Jun",부산,북구,292,101920,3700,105912,"2024-06-01",2024
"24-Jun",부산,사상구,265,83664,5302,89231,"2024-06-01",2024
"24-Jun",부산,사하구,271,108009,5973,114253,"2024-06-01",2024
"24-Jun",부산,서구,137,30427,1395,31959,"2024-06-01",2024
"24-Jun",부산,수영구,166,63981,63895,128042,"2024-06-01",2024
"24-Jun",부산,연제구,1051,114857,18452,134360,"2024-06-01",2024
"24-Jun",부산,영도구,222,31830,2013,34065,"2024-06-01",2024
"24-Jun",부산,중구,312,34701,7131,42144,"2024-06-01",2024
"24-Jun",부산,해운대구,337,165863,13047,179247,"2024-06-01",2024
"24-Jun",부산,계,4904,1356894,180400,1542198,"2024-06-01",2024
"24-Jun",대구,군위군,132,15660,245,16037,"2024-06-01",2024
"24-Jun",대구,남구,385,54740,1550,56675,"2024-06-01",2024
"24-Jun",대구,달서구,491,274168,19005,293664,"2024-06-01",2024
"24-Jun",대구,달성군,598,140671,5164,146433,"2024-06-01",2024
"24-Jun",대구,동구,365,164909,10220,175494,"2024-06-01",2024
"24-Jun",대구,북구,562,202721,8083,211366,"2024-06-01",2024
"24-Jun",대구,서구,264,71624,4848,76736,"2024-06-01",2024
"24-Jun",대구,수성구,604,215597,5272,221473,"2024-06-01",2024
"24-Jun",대구,중구,336,59282,2229,61847,"2024-06-01",2024
"24-Jun",대구,계,3737,1199372,56616,1259725,"2024-06-01",2024
"24-Jun",인천,강화군,345,38814,10266,49425,"2024-06-01",2024
"24-Jun",인천,계양구,300,124951,147975,273226,"2024-06-01",2024
"24-Jun",인천,남동구,958,258567,27087,286612,"2024-06-01",2024
"24-Jun",인천,동구,109,24482,2840,27431,"2024-06-01",2024
"24-Jun",인천,미추홀구,443,165164,11866,177473,"2024-06-01",2024
"24-Jun",인천,부평구,345,230208,39276,269829,"2024-06-01",2024
"24-Jun",인천,서구,539,307075,13332,320946,"2024-06-01",2024
"24-Jun",인천,연수구,409,221804,10019,232232,"2024-06-01",2024
"24-Jun",인천,옹진군,247,13239,293,13779,"2024-06-01",2024
"24-Jun",인천,중구,689,80052,12127,92868,"2024-06-01",2024
"24-Jun",인천,계,4384,1464356,275081,1743821,"2024-06-01",2024
"24-Jun",광주,광산구,575,205530,13344,219449,"2024-06-01",2024
"24-Jun",광주,남구,235,93421,2767,96423,"2024-06-01",2024
"24-Jun",광주,동구,252,47284,1006,48542,"2024-06-01",2024
"24-Jun",광주,북구,613,200472,9579,210664,"2024-06-01",2024
"24-Jun",광주,서구,751,145488,6232,152471,"2024-06-01",2024
"24-Jun",광주,계,2426,692195,32928,727549,"2024-06-01",2024
"24-Jun",대전,대덕구,242,88769,6906,95917,"2024-06-01",2024
"24-Jun",대전,동구,251,92336,5113,97700,"2024-06-01",2024
"24-Jun",대전,서구,854,209585,22163,232602,"2024-06-01",2024
"24-Jun",대전,유성구,665,195973,5850,202488,"2024-06-01",2024
"24-Jun",대전,중구,229,97083,5328,102640,"2024-06-01",2024
"24-Jun",대전,계,2241,683746,45360,731347,"2024-06-01",2024
"24-Jun",울산,남구,767,157439,7188,165394,"2024-06-01",2024
"24-Jun",울산,동구,192,64410,1263,65865,"2024-06-01",2024
"24-Jun",울산,북구,227,123175,3754,127156,"2024-06-01",2024
"24-Jun",울산,울주군,445,131890,7021,139356,"2024-06-01",2024
"24-Jun",울산,중구,346,103061,2693,106100,"2024-06-01",2024
"24-Jun",울산,계,1977,579975,21919,603871,"2024-06-01",2024
"24-Jun",세종,세종특별자치시,941,195470,3931,200342,"2024-06-01",2024
"24-Jun",세종,계,941,195470,3931,200342,"2024-06-01",2024
"24-Jun",경기,가평군,423,33359,618,34400,"2024-06-01",2024
"24-Jun",경기,고양시 덕양구,689,197659,5184,203532,"2024-06-01",2024
"24-Jun",경기,고양시 일산동구,272,130773,6227,137272,"2024-06-01",2024
"24-Jun",경기,고양시 일산서구,129,117257,4734,122120,"2024-06-01",2024
"24-Jun",경기,과천시,713,32935,815,34463,"2024-06-01",2024
"24-Jun",경기,광명시,317,101125,4783,106225,"2024-06-01",2024
"24-Jun",경기,광주시,434,206832,9029,216295,"2024-06-01",2024
"24-Jun",경기,구리시,276,71367,2969,74612,"2024-06-01",2024
"24-Jun",경기,군포시,306,99276,5344,104926,"2024-06-01",2024
"24-Jun",경기,김포시,578,238543,9320,248441,"2024-06-01",2024
"24-Jun",경기,남양주시,807,320634,10074,331515,"2024-06-01",2024
"24-Jun",경기,동두천시,229,38469,1485,40183,"2024-06-01",2024
"24-Jun",경기,부천시,6,267,22,295,"2024-06-01",2024
"24-Jun",경기,부천시 소사구,97,83838,3240,87175,"2024-06-01",2024
"24-Jun",경기,부천시 오정구,103,63818,3310,67231,"2024-06-01",2024
"24-Jun",경기,부천시 원미구,521,148779,7043,156343,"2024-06-01",2024
"24-Jun",경기,성남시 분당구,368,189310,7973,197651,"2024-06-01",2024
"24-Jun",경기,성남시 수정구,308,81869,3385,85562,"2024-06-01",2024
"24-Jun",경기,성남시 중원구,393,74638,4014,79045,"2024-06-01",2024
"24-Jun",경기,수원시 권선구,482,206897,9886,217265,"2024-06-01",2024
"24-Jun",경기,수원시 영통구,451,152182,3678,156311,"2024-06-01",2024
"24-Jun",경기,수원시 장안구,495,109335,3796,113626,"2024-06-01",2024
"24-Jun",경기,수원시 팔달구,296,82079,3371,85746,"2024-06-01",2024
"24-Jun",경기,시흥시,452,270654,9143,280249,"2024-06-01",2024
"24-Jun",경기,안산시 단원구,593,165323,7979,173895,"2024-06-01",2024
"24-Jun",경기,안산시 상록구,161,144729,5791,150681,"2024-06-01",2024
"24-Jun",경기,안성시,414,116465,4889,121768,"2024-06-01",2024
"24-Jun",경기,안양시 동안구,398,126597,6910,133905,"2024-06-01",2024
"24-Jun",경기,안양시 만안구,158,85399,3874,89431,"2024-06-01",2024
"24-Jun",경기,양주시,455,137981,4340,142776,"2024-06-01",2024
"24-Jun",경기,양평군,616,67610,1946,70172,"2024-06-01",2024
"24-Jun",경기,여주시,481,69762,7860,78103,"2024-06-01",2024
"24-Jun",경기,연천군,326,24721,4921,29968,"2024-06-01",2024
"24-Jun",경기,오산시,228,118520,4408,123156,"2024-06-01",2024
"24-Jun",경기,용인시 기흥구,154,199754,7736,207644,"2024-06-01",2024
"24-Jun",경기,용인시 수지구,62,151116,2310,153488,"2024-06-01",2024
"24-Jun",경기,용인시 처인구,816,146395,8285,155496,"2024-06-01",2024
"24-Jun",경기,의왕시,305,66122,2977,69404,"2024-06-01",2024
"24-Jun",경기,의정부시,772,174592,5723,181087,"2024-06-01",2024
"24-Jun",경기,이천시,443,124605,6625,131673,"2024-06-01",2024
"24-Jun",경기,파주시,558,248217,11841,260616,"2024-06-01",2024
"24-Jun",경기,평택시,799,331649,14507,346955,"2024-06-01",2024
"24-Jun",경기,포천시,421,89994,8189,98604,"2024-06-01",2024
"24-Jun",경기,하남시,456,141322,3676,145454,"2024-06-01",2024
"24-Jun",경기,화성시,988,523429,14601,539018,"2024-06-01",2024
"24-Jun",경기,계,18749,6306197,258831,6583777,"2024-06-01",2024
"24-Jun",충북,괴산군,223,24180,468,24871,"2024-06-01",2024
"24-Jun",충북,단양군,239,16549,854,17642,"2024-06-01",2024
"24-Jun",충북,보은군,251,19124,887,20262,"2024-06-01",2024
"24-Jun",충북,영동군,272,26462,427,27161,"2024-06-01",2024
"24-Jun",충북,옥천군,224,29144,1041,30409,"2024-06-01",2024
"24-Jun",충북,음성군,276,62861,2076,65213,"2024-06-01",2024
"24-Jun",충북,제천시,353,70320,3499,74172,"2024-06-01",2024
"24-Jun",충북,증평군,97,21077,832,22006,"2024-06-01",2024
"24-Jun",충북,진천군,235,56115,1550,57900,"2024-06-01",2024
"24-Jun",충북,청원군,1,19,0,20,"2024-06-01",2024
"24-Jun",충북,청주시 상당구,514,102352,2803,105669,"2024-06-01",2024
"24-Jun",충북,청주시 서원구,249,97736,4567,102552,"2024-06-01",2024
"24-Jun",충북,청주시 청원구,424,108351,5171,113946,"2024-06-01",2024
"24-Jun",충북,청주시 흥덕구,364,147369,7656,155389,"2024-06-01",2024
"24-Jun",충북,충주시,635,117550,8092,126277,"2024-06-01",2024
"24-Jun",충북,계,4357,899209,39923,943489,"2024-06-01",2024
"24-Jun",충남,계룡시,179,26311,609,27099,"2024-06-01",2024
"24-Jun",충남,공주시,597,56809,2516,59922,"2024-06-01",2024
"24-Jun",충남,금산군,216,30325,2480,33021,"2024-06-01",2024
"24-Jun",충남,논산시,416,63073,2373,65862,"2024-06-01",2024
"24-Jun",충남,당진시,439,106804,4275,111518,"2024-06-01",2024
"24-Jun",충남,보령시,420,54732,1408,56560,"2024-06-01",2024
"24-Jun",충남,부여군,326,35418,978,36722,"2024-06-01",2024
"24-Jun",충남,서산시,447,103657,3793,107897,"2024-06-01",2024
"24-Jun",충남,서천군,242,28140,780,29162,"2024-06-01",2024
"24-Jun",충남,아산시,568,200956,7006,208530,"2024-06-01",2024
"24-Jun",충남,예산군,468,47518,1434,49420,"2024-06-01",2024
"24-Jun",충남,천안시 동남구,313,142984,5662,148959,"2024-06-01",2024
"24-Jun",충남,천안시 서북구,550,206993,5371,212914,"2024-06-01",2024
"24-Jun",충남,청양군,269,18002,690,18961,"2024-06-01",2024
"24-Jun",충남,태안군,343,36542,620,37505,"2024-06-01",2024
"24-Jun",충남,홍성군,428,56530,1403,58361,"2024-06-01",2024
"24-Jun",충남,계,6221,1214794,41398,1262413,"2024-06-01",2024
"24-Jun",전남,강진군,257,19495,1017,20769,"2024-06-01",2024
"24-Jun",전남,고흥군,324,34555,556,35435,"2024-06-01",2024
"24-Jun",전남,곡성군,189,16049,620,16858,"2024-06-01",2024
"24-Jun",전남,광양시,263,93811,6232,100306,"2024-06-01",2024
"24-Jun",전남,구례군,180,13631,682,14493,"2024-06-01",2024
"24-Jun",전남,나주시,495,70190,3135,73820,"2024-06-01",2024
"24-Jun",전남,담양군,218,29005,1859,31082,"2024-06-01",2024
"24-Jun",전남,목포시,398,99229,5366,104993,"2024-06-01",2024
"24-Jun",전남,무안군,627,52851,1188,54666,"2024-06-01",2024
"24-Jun",전남,보성군,248,22694,636,23578,"2024-06-01",2024
"24-Jun",전남,순천시,514,149497,5502,155513,"2024-06-01",2024
"24-Jun",전남,신안군,391,24166,103475,128032,"2024-06-01",2024
"24-Jun",전남,여수시,562,138845,7535,146942,"2024-06-01",2024
"24-Jun",전남,영광군,248,29942,795,30985,"2024-06-01",2024
"24-Jun",전남,영암군,279,37051,1116,38446,"2024-06-01",2024
"24-Jun",전남,완도군,298,26603,508,27409,"2024-06-01",2024
"24-Jun",전남,장성군,224,28132,1311,29667,"2024-06-01",2024
"24-Jun",전남,장흥군,277,20955,457,21689,"2024-06-01",2024
"24-Jun",전남,진도군,228,17984,315,18527,"2024-06-01",2024
"24-Jun",전남,함평군,224,19477,6536,26237,"2024-06-01",2024
"24-Jun",전남,해남군,342,41625,83909,125876,"2024-06-01",2024
"24-Jun",전남,화순군,259,34693,2033,36985,"2024-06-01",2024
"24-Jun",전남,계,7045,1020480,234783,1262308,"2024-06-01",2024
"24-Jun",경북,경산시,386,144622,4448,149456,"2024-06-01",2024
"24-Jun",경북,경주시,603,148930,4605,154138,"2024-06-01",2024
"24-Jun",경북,고령군,181,21623,820,22624,"2024-06-01",2024
"24-Jun",경북,구미시,546,223277,7407,231230,"2024-06-01",2024
"24-Jun",경북,군위군,0,50,5,55,"2024-06-01",2024
"24-Jun",경북,김천시,409,78482,2140,81031,"2024-06-01",2024
"24-Jun",경북,문경시,295,38928,879,40102,"2024-06-01",2024
"24-Jun",경북,봉화군,250,18624,196,19070,"2024-06-01",2024
"24-Jun",경북,상주시,413,56079,1874,58366,"2024-06-01",2024
"24-Jun",경북,성주군,214,32487,1298,33999,"2024-06-01",2024
"24-Jun",경북,안동시,807,86159,2644,89610,"2024-06-01",2024
"24-Jun",경북,영덕군,260,19572,309,20141,"2024-06-01",2024
"24-Jun",경북,영양군,147,10261,117,10525,"2024-06-01",2024
"24-Jun",경북,영주시,385,57751,1531,59667,"2024-06-01",2024
"24-Jun",경북,영천시,357,63883,2516,66756,"2024-06-01",2024
"24-Jun",경북,예천군,298,32471,488,33257,"2024-06-01",2024
"24-Jun",경북,울릉군,150,6075,569,6794,"2024-06-01",2024
"24-Jun",경북,울진군,329,27713,366,28408,"2024-06-01",2024
"24-Jun",경북,의성군,294,32791,1120,34205,"2024-06-01",2024
"24-Jun",경북,청도군,226,26342,971,27539,"2024-06-01",2024
"24-Jun",경북,청송군,220,16436,209,16865,"2024-06-01",2024
"24-Jun",경북,칠곡군,314,71225,2496,74035,"2024-06-01",2024
"24-Jun",경북,포항시 남구,443,126341,8126,134910,"2024-06-01",2024
"24-Jun",경북,포항시 북구,381,148713,3786,152880,"2024-06-01",2024
"24-Jun",경북,계,7908,1488835,48920,1545663,"2024-06-01",2024
"24-Jun",경남,거제시,366,110557,2152,113075,"2024-06-01",2024
"24-Jun",경남,거창군,290,34800,788,35878,"2024-06-01",2024
"24-Jun",경남,고성군,233,28043,559,28835,"2024-06-01",2024
"24-Jun",경남,김해시,701,291566,8024,300291,"2024-06-01",2024
"24-Jun",경남,남해군,305,20860,444,21609,"2024-06-01",2024
"24-Jun",경남,밀양시,324,58874,3904,63102,"2024-06-01",2024
"24-Jun",경남,사천시,335,60072,1569,61976,"2024-06-01",2024
"24-Jun",경남,산청군,258,21514,756,22528,"2024-06-01",2024
"24-Jun",경남,양산시,435,179455,10638,190528,"2024-06-01",2024
"24-Jun",경남,의령군,220,15467,754,16441,"2024-06-01",2024
"24-Jun",경남,진주시,660,174162,6685,181507,"2024-06-01",2024
"24-Jun",경남,창녕군,248,36570,769,37587,"2024-06-01",2024
"24-Jun",경남,창원시 마산합포구,356,102025,2881,105262,"2024-06-01",2024
"24-Jun",경남,창원시 마산회원구,155,107618,7831,115604,"2024-06-01",2024
"24-Jun",경남,창원시 성산구,616,172082,62614,235312,"2024-06-01",2024
"24-Jun",경남,창원시 의창구,551,119512,3827,123890,"2024-06-01",2024
"24-Jun",경남,창원시 진해구,232,97198,2123,99553,"2024-06-01",2024
"24-Jun",경남,통영시,318,53797,1345,55460,"2024-06-01",2024
"24-Jun",경남,하동군,241,24612,382,25235,"2024-06-01",2024
"24-Jun",경남,함안군,223,44947,36475,81645,"2024-06-01",2024
"24-Jun",경남,함양군,245,20603,638,21486,"2024-06-01",2024
"24-Jun",경남,합천군,296,24541,669,25506,"2024-06-01",2024
"24-Jun",경남,계,7608,1798875,155827,1962310,"2024-06-01",2024
"24-Jun",제주,서귀포시,776,107613,1876,110265,"2024-06-01",2024
"24-Jun",제주,제주시,1709,317583,278758,598050,"2024-06-01",2024
"24-Jun",제주,계,2485,425196,280634,708315,"2024-06-01",2024
"24-Jun",강원,강릉시,610,115098,4925,120633,"2024-06-01",2024
"24-Jun",강원,고성군,206,16393,234,16833,"2024-06-01",2024
"24-Jun",강원,동해시,325,48087,1565,49977,"2024-06-01",2024
"24-Jun",강원,삼척시,415,34001,830,35246,"2024-06-01",2024
"24-Jun",강원,속초시,317,40794,1499,42610,"2024-06-01",2024
"24-Jun",강원,양구군,224,12539,159,12922,"2024-06-01",2024
"24-Jun",강원,양양군,221,17111,282,17614,"2024-06-01",2024
"24-Jun",강원,영월군,352,22148,393,22893,"2024-06-01",2024
"24-Jun",강원,원주시,644,191766,6009,198419,"2024-06-01",2024
"24-Jun",강원,인제군,238,20158,294,20690,"2024-06-01",2024
"24-Jun",강원,정선군,367,21044,492,21903,"2024-06-01",2024
"24-Jun",강원,철원군,275,24825,417,25517,"2024-06-01",2024
"24-Jun",강원,춘천시,924,143314,6267,150505,"2024-06-01",2024
"24-Jun",강원,태백시,251,20245,678,21174,"2024-06-01",2024
"24-Jun",강원,평창군,329,27257,578,28164,"2024-06-01",2024
"24-Jun",강원,홍천군,436,41290,1044,42770,"2024-06-01",2024
"24-Jun",강원,화천군,231,13500,179,13910,"2024-06-01",2024
"24-Jun",강원,횡성군,296,28920,908,30124,"2024-06-01",2024
"24-Jun",강원,계,6661,838490,26753,871904,"2024-06-01",2024
"24-Jun",전북,고창군,340,32198,587,33125,"2024-06-01",2024
"24-Jun",전북,군산시,568,138508,6409,145485,"2024-06-01",2024
"24-Jun",전북,김제시,337,49103,1901,51341,"2024-06-01",2024
"24-Jun",전북,남원시,441,43215,1227,44883,"2024-06-01",2024
"24-Jun",전북,무주군,219,13839,401,14459,"2024-06-01",2024
"24-Jun",전북,부안군,290,28514,619,29423,"2024-06-01",2024
"24-Jun",전북,순창군,237,15899,189,16325,"2024-06-01",2024
"24-Jun",전북,완주군,465,60260,3206,63931,"2024-06-01",2024
"24-Jun",전북,익산시,556,142123,5900,148579,"2024-06-01",2024
"24-Jun",전북,임실군,264,15166,426,15856,"2024-06-01",2024
"24-Jun",전북,장수군,236,12702,151,13089,"2024-06-01",2024
"24-Jun",전북,전주시 덕진구,378,176080,7177,183635,"2024-06-01",2024
"24-Jun",전북,전주시 완산구,804,156182,4278,161264,"2024-06-01",2024
"24-Jun",전북,정읍시,390,57696,3262,61348,"2024-06-01",2024
"24-Jun",전북,진안군,285,15088,272,15645,"2024-06-01",2024
"24-Jun",전북,계,5810,956573,36005,998388,"2024-06-01",2024
"24-Jul",서울,강남구,408,236411,20319,257138,"2024-07-01",2024
"24-Jul",서울,강동구,303,146936,8369,155608,"2024-07-01",2024
"24-Jul",서울,강북구,320,69268,4190,73778,"2024-07-01",2024
"24-Jul",서울,강서구,362,188529,15128,204019,"2024-07-01",2024
"24-Jul",서울,관악구,289,111544,5773,117606,"2024-07-01",2024
"24-Jul",서울,광진구,320,91383,5163,96866,"2024-07-01",2024
"24-Jul",서울,구로구,304,133636,13018,146958,"2024-07-01",2024
"24-Jul",서울,금천구,177,85388,6247,91812,"2024-07-01",2024
"24-Jul",서울,노원구,327,142994,8803,152124,"2024-07-01",2024
"24-Jul",서울,도봉구,281,86896,7448,94625,"2024-07-01",2024
"24-Jul",서울,동대문구,297,97098,5342,102737,"2024-07-01",2024
"24-Jul",서울,동작구,310,103667,2554,106531,"2024-07-01",2024
"24-Jul",서울,마포구,352,113942,7641,121935,"2024-07-01",2024
"24-Jul",서울,서대문구,462,85690,5724,91876,"2024-07-01",2024
"24-Jul",서울,서초구,523,166878,9452,176853,"2024-07-01",2024
"24-Jul",서울,성동구,373,92592,11851,104816,"2024-07-01",2024
"24-Jul",서울,성북구,292,116860,4920,122072,"2024-07-01",2024
"24-Jul",서울,송파구,406,228973,14353,243732,"2024-07-01",2024
"24-Jul",서울,양천구,344,141715,8459,150518,"2024-07-01",2024
"24-Jul",서울,영등포구,372,136099,8176,144647,"2024-07-01",2024
"24-Jul",서울,용산구,541,70613,2311,73465,"2024-07-01",2024
"24-Jul",서울,은평구,302,127287,7043,134632,"2024-07-01",2024
"24-Jul",서울,종로구,3633,44585,2142,50360,"2024-07-01",2024
"24-Jul",서울,중구,1351,48799,3174,53324,"2024-07-01",2024
"24-Jul",서울,중랑구,247,106789,9675,116711,"2024-07-01",2024
"24-Jul",서울,계,12896,2974572,197275,3184743,"2024-07-01",2024
"24-Jul",부산,강서구,342,86167,5859,92368,"2024-07-01",2024
"24-Jul",부산,금정구,277,76745,7075,84097,"2024-07-01",2024
"24-Jul",부산,기장군,262,87326,2885,90473,"2024-07-01",2024
"24-Jul",부산,남구,224,92637,9467,102328,"2024-07-01",2024
"24-Jul",부산,동구,194,48862,5279,54335,"2024-07-01",2024
"24-Jul",부산,동래구,164,97268,3785,101217,"2024-07-01",2024
"24-Jul",부산,부산진구,367,133254,25792,159413,"2024-07-01",2024
"24-Jul",부산,북구,288,101827,3704,105819,"2024-07-01",2024
"24-Jul",부산,사상구,262,83679,5299,89240,"2024-07-01",2024
"24-Jul",부산,사하구,268,107991,5991,114250,"2024-07-01",2024
"24-Jul",부산,서구,137,30443,1399,31979,"2024-07-01",2024
"24-Jul",부산,수영구,167,63784,64705,128656,"2024-07-01",2024
"24-Jul",부산,연제구,1052,115022,18719,134793,"2024-07-01",2024
"24-Jul",부산,영도구,222,31792,2021,34035,"2024-07-01",2024
"24-Jul",부산,중구,312,35008,7149,42469,"2024-07-01",2024
"24-Jul",부산,해운대구,330,166181,12839,179350,"2024-07-01",2024
"24-Jul",부산,계,4868,1357986,181968,1544822,"2024-07-01",2024
"24-Jul",대구,군위군,131,15673,247,16051,"2024-07-01",2024
"24-Jul",대구,남구,404,54649,1545,56598,"2024-07-01",2024
"24-Jul",대구,달서구,493,274318,19280,294091,"2024-07-01",2024
"24-Jul",대구,달성군,604,140698,5172,146474,"2024-07-01",2024
"24-Jul",대구,동구,367,165030,10200,175597,"2024-07-01",2024
"24-Jul",대구,북구,561,202703,8086,211350,"2024-07-01",2024
"24-Jul",대구,서구,265,71163,4878,76306,"2024-07-01",2024
"24-Jul",대구,수성구,608,215487,5261,221356,"2024-07-01",2024
"24-Jul",대구,중구,317,59300,2223,61840,"2024-07-01",2024
"24-Jul",대구,계,3750,1199021,56892,1259663,"2024-07-01",2024
"24-Jul",인천,강화군,353,38902,9511,48766,"2024-07-01",2024
"24-Jul",인천,계양구,299,125124,147221,272644,"2024-07-01",2024
"24-Jul",인천,남동구,960,258804,26320,286084,"2024-07-01",2024
"24-Jul",인천,동구,108,24523,2837,27468,"2024-07-01",2024
"24-Jul",인천,미추홀구,437,165525,13510,179472,"2024-07-01",2024
"24-Jul",인천,부평구,351,229896,38884,269131,"2024-07-01",2024
"24-Jul",인천,서구,563,307236,13313,321112,"2024-07-01",2024
"24-Jul",인천,연수구,414,223000,9990,233404,"2024-07-01",2024
"24-Jul",인천,옹진군,251,13323,287,13861,"2024-07-01",2024
"24-Jul",인천,중구,665,80476,12215,93356,"2024-07-01",2024
"24-Jul",인천,계,4401,1466809,274088,1745298,"2024-07-01",2024
"24-Jul",광주,광산구,578,205774,13226,219578,"2024-07-01",2024
"24-Jul",광주,남구,235,93454,2754,96443,"2024-07-01",2024
"24-Jul",광주,동구,260,47276,1008,48544,"2024-07-01",2024
"24-Jul",광주,북구,625,200824,9615,211064,"2024-07-01",2024
"24-Jul",광주,서구,757,145507,6271,152535,"2024-07-01",2024
"24-Jul",광주,계,2455,692835,32874,728164,"2024-07-01",2024
"24-Jul",대전,대덕구,245,88695,6821,95761,"2024-07-01",2024
"24-Jul",대전,동구,253,92254,5109,97616,"2024-07-01",2024
"24-Jul",대전,서구,846,209399,22753,232998,"2024-07-01",2024
"24-Jul",대전,유성구,680,196299,5833,202812,"2024-07-01",2024
"24-Jul",대전,중구,227,97143,5306,102676,"2024-07-01",2024
"24-Jul",대전,계,2251,683790,45822,731863,"2024-07-01",2024
"24-Jul",울산,남구,763,157581,7227,165571,"2024-07-01",2024
"24-Jul",울산,동구,193,64455,1280,65928,"2024-07-01",2024
"24-Jul",울산,북구,228,123291,3755,127274,"2024-07-01",2024
"24-Jul",울산,울주군,449,132156,7033,139638,"2024-07-01",2024
"24-Jul",울산,중구,351,103136,2643,106130,"2024-07-01",2024
"24-Jul",울산,계,1984,580619,21938,604541,"2024-07-01",2024
"24-Jul",세종,세종특별자치시,947,195804,3927,200678,"2024-07-01",2024
"24-Jul",세종,계,947,195804,3927,200678,"2024-07-01",2024
"24-Jul",경기,가평군,420,33372,620,34412,"2024-07-01",2024
"24-Jul",경기,고양시 덕양구,688,197791,5194,203673,"2024-07-01",2024
"24-Jul",경기,고양시 일산동구,273,130963,6230,137466,"2024-07-01",2024
"24-Jul",경기,고양시 일산서구,128,117121,4723,121972,"2024-07-01",2024
"24-Jul",경기,과천시,712,33022,812,34546,"2024-07-01",2024
"24-Jul",경기,광명시,317,100973,4767,106057,"2024-07-01",2024
"24-Jul",경기,광주시,431,207218,9062,216711,"2024-07-01",2024
"24-Jul",경기,구리시,277,71463,2983,74723,"2024-07-01",2024
"24-Jul",경기,군포시,308,99236,5158,104702,"2024-07-01",2024
"24-Jul",경기,김포시,580,238823,9357,248760,"2024-07-01",2024
"24-Jul",경기,남양주시,811,320844,10104,331759,"2024-07-01",2024
"24-Jul",경기,동두천시,226,38441,1485,40152,"2024-07-01",2024
"24-Jul",경기,부천시,6,266,22,294,"2024-07-01",2024
"24-Jul",경기,부천시 소사구,98,83772,3289,87159,"2024-07-01",2024
"24-Jul",경기,부천시 오정구,104,63753,3265,67122,"2024-07-01",2024
"24-Jul",경기,부천시 원미구,524,148642,6980,156146,"2024-07-01",2024
"24-Jul",경기,성남시 분당구,370,189304,7875,197549,"2024-07-01",2024
"24-Jul",경기,성남시 수정구,311,81904,3489,85704,"2024-07-01",2024
"24-Jul",경기,성남시 중원구,395,74660,4054,79109,"2024-07-01",2024
"24-Jul",경기,수원시 권선구,484,207285,9981,217750,"2024-07-01",2024
"24-Jul",경기,수원시 영통구,460,152208,3694,156362,"2024-07-01",2024
"24-Jul",경기,수원시 장안구,512,109656,3799,113967,"2024-07-01",2024
"24-Jul",경기,수원시 팔달구,295,82106,3479,85880,"2024-07-01",2024
"24-Jul",경기,시흥시,463,270630,9196,280289,"2024-07-01",2024
"24-Jul",경기,안산시 단원구,594,165635,8040,174269,"2024-07-01",2024
"24-Jul",경기,안산시 상록구,162,144867,5769,150798,"2024-07-01",2024
"24-Jul",경기,안성시,414,116987,4897,122298,"2024-07-01",2024
"24-Jul",경기,안양시 동안구,398,127476,6870,134744,"2024-07-01",2024
"24-Jul",경기,안양시 만안구,158,85263,3906,89327,"2024-07-01",2024
"24-Jul",경기,양주시,460,138980,4357,143797,"2024-07-01",2024
"24-Jul",경기,양평군,614,67795,1937,70346,"2024-07-01",2024
"24-Jul",경기,여주시,489,69913,7856,78258,"2024-07-01",2024
"24-Jul",경기,연천군,323,24708,4917,29948,"2024-07-01",2024
"24-Jul",경기,오산시,228,119114,4429,123771,"2024-07-01",2024
"24-Jul",경기,용인시 기흥구,154,200531,7889,208574,"2024-07-01",2024
"24-Jul",경기,용인시 수지구,63,151350,2304,153717,"2024-07-01",2024
"24-Jul",경기,용인시 처인구,814,146655,8310,155779,"2024-07-01",2024
"24-Jul",경기,의왕시,307,66038,2975,69320,"2024-07-01",2024
"24-Jul",경기,의정부시,778,174724,5714,181216,"2024-07-01",2024
"24-Jul",경기,이천시,444,124820,6631,131895,"2024-07-01",2024
"24-Jul",경기,파주시,559,249245,11797,261601,"2024-07-01",2024
"24-Jul",경기,평택시,804,332191,14502,347497,"2024-07-01",2024
"24-Jul",경기,포천시,429,90033,7953,98415,"2024-07-01",2024
"24-Jul",경기,하남시,458,141467,3733,145658,"2024-07-01",2024
"24-Jul",경기,화성시,999,525202,14486,540687,"2024-07-01",2024
"24-Jul",경기,계,18842,6316447,258890,6594179,"2024-07-01",2024
"24-Jul",충북,괴산군,221,24209,465,24895,"2024-07-01",2024
"24-Jul",충북,단양군,241,16540,849,17630,"2024-07-01",2024
"24-Jul",충북,보은군,254,19154,883,20291,"2024-07-01",2024
"24-Jul",충북,영동군,279,26405,430,27114,"2024-07-01",2024
"24-Jul",충북,옥천군,224,29208,1044,30476,"2024-07-01",2024
"24-Jul",충북,음성군,277,63062,2064,65403,"2024-07-01",2024
"24-Jul",충북,제천시,353,70318,3497,74168,"2024-07-01",2024
"24-Jul",충북,증평군,98,21046,835,21979,"2024-07-01",2024
"24-Jul",충북,진천군,237,56216,1554,58007,"2024-07-01",2024
"24-Jul",충북,청원군,1,19,0,20,"2024-07-01",2024
"24-Jul",충북,청주시 상당구,518,102340,2856,105714,"2024-07-01",2024
"24-Jul",충북,청주시 서원구,254,97238,4532,102024,"2024-07-01",2024
"24-Jul",충북,청주시 청원구,430,108742,5200,114372,"2024-07-01",2024
"24-Jul",충북,청주시 흥덕구,367,148340,7780,156487,"2024-07-01",2024
"24-Jul",충북,충주시,640,117633,7890,126163,"2024-07-01",2024
"24-Jul",충북,계,4394,900470,39879,944743,"2024-07-01",2024
"24-Jul",충남,계룡시,181,26332,617,27130,"2024-07-01",2024
"24-Jul",충남,공주시,601,56796,2444,59841,"2024-07-01",2024
"24-Jul",충남,금산군,217,30349,2546,33112,"2024-07-01",2024
"24-Jul",충남,논산시,414,63070,2359,65843,"2024-07-01",2024
"24-Jul",충남,당진시,443,107178,4275,111896,"2024-07-01",2024
"24-Jul",충남,보령시,419,54749,1394,56562,"2024-07-01",2024
"24-Jul",충남,부여군,329,35506,971,36806,"2024-07-01",2024
"24-Jul",충남,서산시,451,103749,3837,108037,"2024-07-01",2024
"24-Jul",충남,서천군,240,28036,781,29057,"2024-07-01",2024
"24-Jul",충남,아산시,570,201917,6957,209444,"2024-07-01",2024
"24-Jul",충남,예산군,466,47557,1437,49460,"2024-07-01",2024
"24-Jul",충남,천안시 동남구,321,142662,5704,148687,"2024-07-01",2024
"24-Jul",충남,천안시 서북구,566,207345,5402,213313,"2024-07-01",2024
"24-Jul",충남,청양군,267,17994,693,18954,"2024-07-01",2024
"24-Jul",충남,태안군,346,36578,614,37538,"2024-07-01",2024
"24-Jul",충남,홍성군,432,56656,1404,58492,"2024-07-01",2024
"24-Jul",충남,계,6263,1216474,41435,1264172,"2024-07-01",2024
"24-Jul",전남,강진군,258,19535,1008,20801,"2024-07-01",2024
"24-Jul",전남,고흥군,333,34592,560,35485,"2024-07-01",2024
"24-Jul",전남,곡성군,189,16070,622,16881,"2024-07-01",2024
"24-Jul",전남,광양시,265,94231,6199,100695,"2024-07-01",2024
"24-Jul",전남,구례군,179,13630,677,14486,"2024-07-01",2024
"24-Jul",전남,나주시,497,70237,3139,73873,"2024-07-01",2024
"24-Jul",전남,담양군,217,29016,1897,31130,"2024-07-01",2024
"24-Jul",전남,목포시,401,99260,5347,105008,"2024-07-01",2024
"24-Jul",전남,무안군,631,53121,1196,54948,"2024-07-01",2024
"24-Jul",전남,보성군,246,22669,632,23547,"2024-07-01",2024
"24-Jul",전남,순천시,513,149790,5501,155804,"2024-07-01",2024
"24-Jul",전남,신안군,394,24222,102967,127583,"2024-07-01",2024
"24-Jul",전남,여수시,571,138843,7532,146946,"2024-07-01",2024
"24-Jul",전남,영광군,249,30034,792,31075,"2024-07-01",2024
"24-Jul",전남,영암군,280,37119,1100,38499,"2024-07-01",2024
"24-Jul",전남,완도군,299,26642,510,27451,"2024-07-01",2024
"24-Jul",전남,장성군,223,28249,1312,29784,"2024-07-01",2024
"24-Jul",전남,장흥군,278,20956,463,21697,"2024-07-01",2024
"24-Jul",전남,진도군,233,17982,314,18529,"2024-07-01",2024
"24-Jul",전남,함평군,222,19451,6356,26029,"2024-07-01",2024
"24-Jul",전남,해남군,348,41600,85342,127290,"2024-07-01",2024
"24-Jul",전남,화순군,259,34697,2037,36993,"2024-07-01",2024
"24-Jul",전남,계,7085,1021946,235503,1264534,"2024-07-01",2024
"24-Jul",경북,경산시,386,144817,4462,149665,"2024-07-01",2024
"24-Jul",경북,경주시,602,149170,4632,154404,"2024-07-01",2024
"24-Jul",경북,고령군,181,21703,821,22705,"2024-07-01",2024
"24-Jul",경북,구미시,549,223573,7435,231557,"2024-07-01",2024
"24-Jul",경북,군위군,0,47,5,52,"2024-07-01",2024
"24-Jul",경북,김천시,413,78571,2153,81137,"2024-07-01",2024
"24-Jul",경북,문경시,297,38901,883,40081,"2024-07-01",2024
"24-Jul",경북,봉화군,249,18635,191,19075,"2024-07-01",2024
"24-Jul",경북,상주시,418,56221,1875,58514,"2024-07-01",2024
"24-Jul",경북,성주군,214,32491,1296,34001,"2024-07-01",2024
"24-Jul",경북,안동시,823,86229,2655,89707,"2024-07-01",2024
"24-Jul",경북,영덕군,262,19558,309,20129,"2024-07-01",2024
"24-Jul",경북,영양군,147,10263,117,10527,"2024-07-01",2024
"24-Jul",경북,영주시,394,57839,1530,59763,"2024-07-01",2024
"24-Jul",경북,영천시,359,63812,2514,66685,"2024-07-01",2024
"24-Jul",경북,예천군,299,32508,491,33298,"2024-07-01",2024
"24-Jul",경북,울릉군,151,6091,572,6814,"2024-07-01",2024
"24-Jul",경북,울진군,329,27782,366,28477,"2024-07-01",2024
"24-Jul",경북,의성군,294,32846,1117,34257,"2024-07-01",2024
"24-Jul",경북,청도군,227,26371,980,27578,"2024-07-01",2024
"24-Jul",경북,청송군,217,16442,207,16866,"2024-07-01",2024
"24-Jul",경북,칠곡군,318,71285,2497,74100,"2024-07-01",2024
"24-Jul",경북,포항시 남구,444,126265,8105,134814,"2024-07-01",2024
"24-Jul",경북,포항시 북구,386,149141,3856,153383,"2024-07-01",2024
"24-Jul",경북,계,7959,1490561,49069,1547589,"2024-07-01",2024
"24-Jul",경남,거제시,376,110748,2155,113279,"2024-07-01",2024
"24-Jul",경남,거창군,291,34853,792,35936,"2024-07-01",2024
"24-Jul",경남,고성군,233,28053,561,28847,"2024-07-01",2024
"24-Jul",경남,김해시,698,292199,8023,300920,"2024-07-01",2024
"24-Jul",경남,남해군,306,20929,442,21677,"2024-07-01",2024
"24-Jul",경남,밀양시,322,58940,3919,63181,"2024-07-01",2024
"24-Jul",경남,사천시,333,60221,1577,62131,"2024-07-01",2024
"24-Jul",경남,산청군,259,21537,753,22549,"2024-07-01",2024
"24-Jul",경남,양산시,437,180111,10650,191198,"2024-07-01",2024
"24-Jul",경남,의령군,221,15482,760,16463,"2024-07-01",2024
"24-Jul",경남,진주시,661,174309,6676,181646,"2024-07-01",2024
"24-Jul",경남,창녕군,249,36582,780,37611,"2024-07-01",2024
"24-Jul",경남,창원시 마산합포구,359,101827,2886,105072,"2024-07-01",2024
"24-Jul",경남,창원시 마산회원구,155,107908,8212,116275,"2024-07-01",2024
"24-Jul",경남,창원시 성산구,622,172978,61812,235412,"2024-07-01",2024
"24-Jul",경남,창원시 의창구,558,119298,3832,123688,"2024-07-01",2024
"24-Jul",경남,창원시 진해구,233,97287,2135,99655,"2024-07-01",2024
"24-Jul",경남,통영시,321,53786,1340,55447,"2024-07-01",2024
"24-Jul",경남,하동군,243,24649,380,25272,"2024-07-01",2024
"24-Jul",경남,함안군,229,44912,37698,82839,"2024-07-01",2024
"24-Jul",경남,함양군,248,20609,642,21499,"2024-07-01",2024
"24-Jul",경남,합천군,300,24603,672,25575,"2024-07-01",2024
"24-Jul",경남,계,7654,1801821,156697,1966172,"2024-07-01",2024
"24-Jul",제주,서귀포시,772,107565,1885,110222,"2024-07-01",2024
"24-Jul",제주,제주시,1712,318368,279615,599695,"2024-07-01",2024
"24-Jul",제주,계,2484,425933,281500,709917,"2024-07-01",2024
"24-Jul",강원,강릉시,611,115112,4928,120651,"2024-07-01",2024
"24-Jul",강원,고성군,211,16386,234,16831,"2024-07-01",2024
"24-Jul",강원,동해시,329,48002,1582,49913,"2024-07-01",2024
"24-Jul",강원,삼척시,417,34085,828,35330,"2024-07-01",2024
"24-Jul",강원,속초시,322,40884,1505,42711,"2024-07-01",2024
"24-Jul",강원,양구군,225,12549,158,12932,"2024-07-01",2024
"24-Jul",강원,양양군,221,17137,279,17637,"2024-07-01",2024
"24-Jul",강원,영월군,353,22142,389,22884,"2024-07-01",2024
"24-Jul",강원,원주시,644,192110,5967,198721,"2024-07-01",2024
"24-Jul",강원,인제군,242,20150,296,20688,"2024-07-01",2024
"24-Jul",강원,정선군,381,21019,494,21894,"2024-07-01",2024
"24-Jul",강원,철원군,276,24807,419,25502,"2024-07-01",2024
"24-Jul",강원,춘천시,897,143379,6281,150557,"2024-07-01",2024
"24-Jul",강원,태백시,253,20270,672,21195,"2024-07-01",2024
"24-Jul",강원,평창군,334,27237,576,28147,"2024-07-01",2024
"24-Jul",강원,홍천군,443,41339,1056,42838,"2024-07-01",2024
"24-Jul",강원,화천군,231,13553,178,13962,"2024-07-01",2024
"24-Jul",강원,횡성군,294,28969,906,30169,"2024-07-01",2024
"24-Jul",강원,계,6684,839130,26748,872562,"2024-07-01",2024
"24-Jul",전북,고창군,343,32244,584,33171,"2024-07-01",2024
"24-Jul",전북,군산시,570,138596,6416,145582,"2024-07-01",2024
"24-Jul",전북,김제시,341,49167,1882,51390,"2024-07-01",2024
"24-Jul",전북,남원시,436,43259,1217,44912,"2024-07-01",2024
"24-Jul",전북,무주군,219,13866,404,14489,"2024-07-01",2024
"24-Jul",전북,부안군,294,28574,618,29486,"2024-07-01",2024
"24-Jul",전북,순창군,238,15988,192,16418,"2024-07-01",2024
"24-Jul",전북,완주군,464,60489,3201,64154,"2024-07-01",2024
"24-Jul",전북,익산시,559,142269,5907,148735,"2024-07-01",2024
"24-Jul",전북,임실군,266,15160,424,15850,"2024-07-01",2024
"24-Jul",전북,장수군,236,12723,152,13111,"2024-07-01",2024
"24-Jul",전북,전주시 덕진구,382,176117,7286,183785,"2024-07-01",2024
"24-Jul",전북,전주시 완산구,847,156280,4261,161388,"2024-07-01",2024
"24-Jul",전북,정읍시,391,57762,3198,61351,"2024-07-01",2024
"24-Jul",전북,진안군,287,15139,274,15700,"2024-07-01",2024
"24-Jul",전북,계,5873,957633,36016,999522,"2024-07-01",2024
"24-Aug",서울,강남구,431,236637,20116,257184,"2024-08-01",2024
"24-Aug",서울,강동구,303,147432,8374,156109,"2024-08-01",2024
"24-Aug",서울,강북구,320,69176,4201,73697,"2024-08-01",2024
"24-Aug",서울,강서구,364,187971,15046,203381,"2024-08-01",2024
"24-Aug",서울,관악구,284,111401,5775,117460,"2024-08-01",2024
"24-Aug",서울,광진구,319,91243,5138,96700,"2024-08-01",2024
"24-Aug",서울,구로구,305,133574,12913,146792,"2024-08-01",2024
"24-Aug",서울,금천구,178,85367,6234,91779,"2024-08-01",2024
"24-Aug",서울,노원구,324,143016,8802,152142,"2024-08-01",2024
"24-Aug",서울,도봉구,281,86713,7424,94418,"2024-08-01",2024
"24-Aug",서울,동대문구,303,97009,5336,102648,"2024-08-01",2024
"24-Aug",서울,동작구,311,103457,2622,106390,"2024-08-01",2024
"24-Aug",서울,마포구,348,113834,7578,121760,"2024-08-01",2024
"24-Aug",서울,서대문구,456,85647,5750,91853,"2024-08-01",2024
"24-Aug",서울,서초구,509,167011,9388,176908,"2024-08-01",2024
"24-Aug",서울,성동구,376,92281,12124,104781,"2024-08-01",2024
"24-Aug",서울,성북구,292,116853,4924,122069,"2024-08-01",2024
"24-Aug",서울,송파구,407,228771,14397,243575,"2024-08-01",2024
"24-Aug",서울,양천구,346,141670,8482,150498,"2024-08-01",2024
"24-Aug",서울,영등포구,372,135721,8209,144302,"2024-08-01",2024
"24-Aug",서울,용산구,543,70575,2347,73465,"2024-08-01",2024
"24-Aug",서울,은평구,306,127035,7035,134376,"2024-08-01",2024
"24-Aug",서울,종로구,3642,44562,2145,50349,"2024-08-01",2024
"24-Aug",서울,중구,1353,48581,3131,53065,"2024-08-01",2024
"24-Aug",서울,중랑구,250,106649,9665,116564,"2024-08-01",2024
"24-Aug",서울,계,12923,2972186,197156,3182265,"2024-08-01",2024
"24-Aug",부산,강서구,343,86394,5815,92552,"2024-08-01",2024
"24-Aug",부산,금정구,278,76695,7075,84048,"2024-08-01",2024
"24-Aug",부산,기장군,262,87340,2880,90482,"2024-08-01",2024
"24-Aug",부산,남구,228,92535,9358,102121,"2024-08-01",2024
"24-Aug",부산,동구,195,49029,5329,54553,"2024-08-01",2024
"24-Aug",부산,동래구,164,97391,3793,101348,"2024-08-01",2024
"24-Aug",부산,부산진구,368,133403,26205,159976,"2024-08-01",2024
"24-Aug",부산,북구,291,101686,3712,105689,"2024-08-01",2024
"24-Aug",부산,사상구,262,83525,5274,89061,"2024-08-01",2024
"24-Aug",부산,사하구,269,107812,6048,114129,"2024-08-01",2024
"24-Aug",부산,서구,135,30517,1397,32049,"2024-08-01",2024
"24-Aug",부산,수영구,166,63677,65760,129603,"2024-08-01",2024
"24-Aug",부산,연제구,1048,115121,19020,135189,"2024-08-01",2024
"24-Aug",부산,영도구,225,31741,2013,33979,"2024-08-01",2024
"24-Aug",부산,중구,312,35479,7156,42947,"2024-08-01",2024
"24-Aug",부산,해운대구,329,166189,12666,179184,"2024-08-01",2024
"24-Aug",부산,계,4875,1358534,183501,1546910,"2024-08-01",2024
"24-Aug",대구,군위군,130,15653,249,16032,"2024-08-01",2024
"24-Aug",대구,남구,404,54631,1541,56576,"2024-08-01",2024
"24-Aug",대구,달서구,517,274094,19457,294068,"2024-08-01",2024
"24-Aug",대구,달성군,597,140700,5193,146490,"2024-08-01",2024
"24-Aug",대구,동구,362,164835,10099,175296,"2024-08-01",2024
"24-Aug",대구,북구,547,202507,8084,211138,"2024-08-01",2024
"24-Aug",대구,서구,266,70915,4828,76009,"2024-08-01",2024
"24-Aug",대구,수성구,605,215585,5292,221482,"2024-08-01",2024
"24-Aug",대구,중구,314,59420,2219,61953,"2024-08-01",2024
"24-Aug",대구,계,3742,1198340,56962,1259044,"2024-08-01",2024
"24-Aug",인천,강화군,358,38895,8958,48211,"2024-08-01",2024
"24-Aug",인천,계양구,298,124978,148116,273392,"2024-08-01",2024
"24-Aug",인천,남동구,964,258615,25731,285310,"2024-08-01",2024
"24-Aug",인천,동구,109,24426,2821,27356,"2024-08-01",2024
"24-Aug",인천,미추홀구,444,165231,13974,179649,"2024-08-01",2024
"24-Aug",인천,부평구,342,229492,38491,268325,"2024-08-01",2024
"24-Aug",인천,서구,572,306040,13335,319947,"2024-08-01",2024
"24-Aug",인천,연수구,415,223499,10011,233925,"2024-08-01",2024
"24-Aug",인천,옹진군,253,13324,287,13864,"2024-08-01",2024
"24-Aug",인천,중구,647,80604,12286,93537,"2024-08-01",2024
"24-Aug",인천,계,4402,1465104,274010,1743516,"2024-08-01",2024
"24-Aug",광주,광산구,584,205656,13242,219482,"2024-08-01",2024
"24-Aug",광주,남구,237,93434,2749,96420,"2024-08-01",2024
"24-Aug",광주,동구,260,47194,995,48449,"2024-08-01",2024
"24-Aug",광주,북구,613,201374,9632,211619,"2024-08-01",2024
"24-Aug",광주,서구,751,145068,6299,152118,"2024-08-01",2024
"24-Aug",광주,계,2445,692726,32917,728088,"2024-08-01",2024
"24-Aug",대전,대덕구,247,88678,6820,95745,"2024-08-01",2024
"24-Aug",대전,동구,248,92703,5148,98099,"2024-08-01",2024
"24-Aug",대전,서구,877,208888,23161,232926,"2024-08-01",2024
"24-Aug",대전,유성구,694,195955,5827,202476,"2024-08-01",2024
"24-Aug",대전,중구,226,97565,5291,103082,"2024-08-01",2024
"24-Aug",대전,계,2292,683789,46247,732328,"2024-08-01",2024
"24-Aug",울산,남구,758,157626,7239,165623,"2024-08-01",2024
"24-Aug",울산,동구,193,64390,1336,65919,"2024-08-01",2024
"24-Aug",울산,북구,227,123226,3754,127207,"2024-08-01",2024
"24-Aug",울산,울주군,453,132387,7026,139866,"2024-08-01",2024
"24-Aug",울산,중구,352,103292,2640,106284,"2024-08-01",2024
"24-Aug",울산,계,1983,580921,21995,604899,"2024-08-01",2024
"24-Aug",세종,세종특별자치시,947,196121,3978,201046,"2024-08-01",2024
"24-Aug",세종,계,947,196121,3978,201046,"2024-08-01",2024
"24-Aug",경기,가평군,418,33462,622,34502,"2024-08-01",2024
"24-Aug",경기,고양시 덕양구,687,197686,5201,203574,"2024-08-01",2024
"24-Aug",경기,고양시 일산동구,276,131087,6368,137731,"2024-08-01",2024
"24-Aug",경기,고양시 일산서구,128,117070,4726,121924,"2024-08-01",2024
"24-Aug",경기,과천시,717,33160,811,34688,"2024-08-01",2024
"24-Aug",경기,광명시,314,100819,4760,105893,"2024-08-01",2024
"24-Aug",경기,광주시,432,207737,9062,217231,"2024-08-01",2024
"24-Aug",경기,구리시,278,71527,2954,74759,"2024-08-01",2024
"24-Aug",경기,군포시,309,99080,5161,104550,"2024-08-01",2024
"24-Aug",경기,김포시,578,238936,9450,248964,"2024-08-01",2024
"24-Aug",경기,남양주시,816,320915,10131,331862,"2024-08-01",2024
"24-Aug",경기,동두천시,227,38333,1479,40039,"2024-08-01",2024
"24-Aug",경기,부천시,6,265,22,293,"2024-08-01",2024
"24-Aug",경기,부천시 소사구,99,83897,3294,87290,"2024-08-01",2024
"24-Aug",경기,부천시 오정구,104,63374,3240,66718,"2024-08-01",2024
"24-Aug",경기,부천시 원미구,525,148401,6988,155914,"2024-08-01",2024
"24-Aug",경기,성남시 분당구,372,189215,7819,197406,"2024-08-01",2024
"24-Aug",경기,성남시 수정구,311,81889,3517,85717,"2024-08-01",2024
"24-Aug",경기,성남시 중원구,393,74555,4050,78998,"2024-08-01",2024
"24-Aug",경기,수원시 권선구,488,206267,10037,216792,"2024-08-01",2024
"24-Aug",경기,수원시 영통구,458,152150,3733,156341,"2024-08-01",2024
"24-Aug",경기,수원시 장안구,514,109938,3817,114269,"2024-08-01",2024
"24-Aug",경기,수원시 팔달구,295,82000,3466,85761,"2024-08-01",2024
"24-Aug",경기,시흥시,465,270903,9223,280591,"2024-08-01",2024
"24-Aug",경기,안산시 단원구,592,165379,8018,173989,"2024-08-01",2024
"24-Aug",경기,안산시 상록구,164,144848,5752,150764,"2024-08-01",2024
"24-Aug",경기,안성시,413,117075,4900,122388,"2024-08-01",2024
"24-Aug",경기,안양시 동안구,396,128450,6831,135677,"2024-08-01",2024
"24-Aug",경기,안양시 만안구,158,84949,3969,89076,"2024-08-01",2024
"24-Aug",경기,양주시,461,140099,4348,144908,"2024-08-01",2024
"24-Aug",경기,양평군,609,67896,1943,70448,"2024-08-01",2024
"24-Aug",경기,여주시,491,70067,7840,78398,"2024-08-01",2024
"24-Aug",경기,연천군,322,24692,4902,29916,"2024-08-01",2024
"24-Aug",경기,오산시,227,119597,4442,124266,"2024-08-01",2024
"24-Aug",경기,용인시 기흥구,155,200497,7981,208633,"2024-08-01",2024
"24-Aug",경기,용인시 수지구,62,151358,2300,153720,"2024-08-01",2024
"24-Aug",경기,용인시 처인구,819,147012,8226,156057,"2024-08-01",2024
"24-Aug",경기,의왕시,308,66040,2981,69329,"2024-08-01",2024
"24-Aug",경기,의정부시,778,174631,5736,181145,"2024-08-01",2024
"24-Aug",경기,이천시,445,124714,6646,131805,"2024-08-01",2024
"24-Aug",경기,파주시,563,249721,11702,261986,"2024-08-01",2024
"24-Aug",경기,평택시,806,332834,14482,348122,"2024-08-01",2024
"24-Aug",경기,포천시,429,89993,7744,98166,"2024-08-01",2024
"24-Aug",경기,하남시,456,141371,3766,145593,"2024-08-01",2024
"24-Aug",경기,화성시,996,526656,14460,542112,"2024-08-01",2024
"24-Aug",경기,계,18860,6320545,258900,6598305,"2024-08-01",2024
"24-Aug",충북,괴산군,220,24227,469,24916,"2024-08-01",2024
"24-Aug",충북,단양군,246,16578,853,17677,"2024-08-01",2024
"24-Aug",충북,보은군,254,19147,879,20280,"2024-08-01",2024
"24-Aug",충북,영동군,280,26426,432,27138,"2024-08-01",2024
"24-Aug",충북,옥천군,223,29096,1043,30362,"2024-08-01",2024
"24-Aug",충북,음성군,275,63247,2058,65580,"2024-08-01",2024
"24-Aug",충북,제천시,351,70345,3493,74189,"2024-08-01",2024
"24-Aug",충북,증평군,98,21017,830,21945,"2024-08-01",2024
"24-Aug",충북,진천군,233,56227,1559,58019,"2024-08-01",2024
"24-Aug",충북,청원군,1,19,0,20,"2024-08-01",2024
"24-Aug",충북,청주시 상당구,515,102381,2863,105759,"2024-08-01",2024
"24-Aug",충북,청주시 서원구,252,96831,4583,101666,"2024-08-01",2024
"24-Aug",충북,청주시 청원구,434,108815,5225,114474,"2024-08-01",2024
"24-Aug",충북,청주시 흥덕구,368,148951,7784,157103,"2024-08-01",2024
"24-Aug",충북,충주시,640,117706,7762,126108,"2024-08-01",2024
"24-Aug",충북,계,4390,901013,39833,945236,"2024-08-01",2024
"24-Aug",충남,계룡시,181,26349,622,27152,"2024-08-01",2024
"24-Aug",충남,공주시,590,56882,2405,59877,"2024-08-01",2024
"24-Aug",충남,금산군,217,30339,2606,33162,"2024-08-01",2024
"24-Aug",충남,논산시,412,63120,2332,65864,"2024-08-01",2024
"24-Aug",충남,당진시,435,107446,4275,112156,"2024-08-01",2024
"24-Aug",충남,보령시,417,54724,1394,56535,"2024-08-01",2024
"24-Aug",충남,부여군,331,35486,970,36787,"2024-08-01",2024
"24-Aug",충남,서산시,452,103776,3704,107932,"2024-08-01",2024
"24-Aug",충남,서천군,242,28106,783,29131,"2024-08-01",2024
"24-Aug",충남,아산시,571,202683,6915,210169,"2024-08-01",2024
"24-Aug",충남,예산군,473,47609,1439,49521,"2024-08-01",2024
"24-Aug",충남,천안시 동남구,319,142637,5694,148650,"2024-08-01",2024
"24-Aug",충남,천안시 서북구,570,207507,5415,213492,"2024-08-01",2024
"24-Aug",충남,청양군,267,17980,690,18937,"2024-08-01",2024
"24-Aug",충남,태안군,346,36561,612,37519,"2024-08-01",2024
"24-Aug",충남,홍성군,413,56706,1410,58529,"2024-08-01",2024
"24-Aug",충남,계,6236,1217911,41266,1265413,"2024-08-01",2024
"24-Aug",전남,강진군,258,19498,1009,20765,"2024-08-01",2024
"24-Aug",전남,고흥군,333,34623,554,35510,"2024-08-01",2024
"24-Aug",전남,곡성군,188,16088,615,16891,"2024-08-01",2024
"24-Aug",전남,광양시,264,94719,6202,101185,"2024-08-01",2024
"24-Aug",전남,구례군,181,13610,678,14469,"2024-08-01",2024
"24-Aug",전남,나주시,498,70377,3129,74004,"2024-08-01",2024
"24-Aug",전남,담양군,216,29029,1899,31144,"2024-08-01",2024
"24-Aug",전남,목포시,397,98924,5344,104665,"2024-08-01",2024
"24-Aug",전남,무안군,633,53627,1207,55467,"2024-08-01",2024
"24-Aug",전남,보성군,248,22650,639,23537,"2024-08-01",2024
"24-Aug",전남,순천시,515,149755,5496,155766,"2024-08-01",2024
"24-Aug",전남,신안군,395,24253,102901,127549,"2024-08-01",2024
"24-Aug",전남,여수시,571,138739,7580,146890,"2024-08-01",2024
"24-Aug",전남,영광군,247,30119,791,31157,"2024-08-01",2024
"24-Aug",전남,영암군,280,37155,1096,38531,"2024-08-01",2024
"24-Aug",전남,완도군,301,26629,508,27438,"2024-08-01",2024
"24-Aug",전남,장성군,220,28264,1239,29723,"2024-08-01",2024
"24-Aug",전남,장흥군,276,20952,466,21694,"2024-08-01",2024
"24-Aug",전남,진도군,232,18044,316,18592,"2024-08-01",2024
"24-Aug",전남,함평군,221,19434,6241,25896,"2024-08-01",2024
"24-Aug",전남,해남군,346,41601,85953,127900,"2024-08-01",2024
"24-Aug",전남,화순군,255,34758,2019,37032,"2024-08-01",2024
"24-Aug",전남,계,7075,1022848,235882,1265805,"2024-08-01",2024
"24-Aug",경북,경산시,383,145076,4478,149937,"2024-08-01",2024
"24-Aug",경북,경주시,604,149194,4617,154415,"2024-08-01",2024
"24-Aug",경북,고령군,182,21686,825,22693,"2024-08-01",2024
"24-Aug",경북,구미시,547,223821,7399,231767,"2024-08-01",2024
"24-Aug",경북,군위군,0,45,5,50,"2024-08-01",2024
"24-Aug",경북,김천시,408,78610,2154,81172,"2024-08-01",2024
"24-Aug",경북,문경시,297,38885,888,40070,"2024-08-01",2024
"24-Aug",경북,봉화군,250,18634,193,19077,"2024-08-01",2024
"24-Aug",경북,상주시,418,56292,1872,58582,"2024-08-01",2024
"24-Aug",경북,성주군,215,32490,1303,34008,"2024-08-01",2024
"24-Aug",경북,안동시,829,86244,2650,89723,"2024-08-01",2024
"24-Aug",경북,영덕군,262,19547,305,20114,"2024-08-01",2024
"24-Aug",경북,영양군,147,10266,119,10532,"2024-08-01",2024
"24-Aug",경북,영주시,395,57877,1532,59804,"2024-08-01",2024
"24-Aug",경북,영천시,360,63771,2507,66638,"2024-08-01",2024
"24-Aug",경북,예천군,295,32583,494,33372,"2024-08-01",2024
"24-Aug",경북,울릉군,153,6117,573,6843,"2024-08-01",2024
"24-Aug",경북,울진군,330,27795,363,28488,"2024-08-01",2024
"24-Aug",경북,의성군,294,32796,1117,34207,"2024-08-01",2024
"24-Aug",경북,청도군,227,26367,977,27571,"2024-08-01",2024
"24-Aug",경북,청송군,216,16452,209,16877,"2024-08-01",2024
"24-Aug",경북,칠곡군,317,71245,2493,74055,"2024-08-01",2024
"24-Aug",경북,포항시 남구,447,126094,8091,134632,"2024-08-01",2024
"24-Aug",경북,포항시 북구,384,149379,3852,153615,"2024-08-01",2024
"24-Aug",경북,계,7960,1491266,49016,1548242,"2024-08-01",2024
"24-Aug",경남,거제시,377,110886,2156,113419,"2024-08-01",2024
"24-Aug",경남,거창군,290,34867,792,35949,"2024-08-01",2024
"24-Aug",경남,고성군,233,28017,565,28815,"2024-08-01",2024
"24-Aug",경남,김해시,702,292552,8063,301317,"2024-08-01",2024
"24-Aug",경남,남해군,305,20907,442,21654,"2024-08-01",2024
"24-Aug",경남,밀양시,323,58952,3899,63174,"2024-08-01",2024
"24-Aug",경남,사천시,332,60242,1573,62147,"2024-08-01",2024
"24-Aug",경남,산청군,258,21549,752,22559,"2024-08-01",2024
"24-Aug",경남,양산시,434,180350,10688,191472,"2024-08-01",2024
"24-Aug",경남,의령군,220,15497,752,16469,"2024-08-01",2024
"24-Aug",경남,진주시,660,174497,6682,181839,"2024-08-01",2024
"24-Aug",경남,창녕군,249,36519,776,37544,"2024-08-01",2024
"24-Aug",경남,창원시 마산합포구,358,101858,2881,105097,"2024-08-01",2024
"24-Aug",경남,창원시 마산회원구,155,107950,8427,116532,"2024-08-01",2024
"24-Aug",경남,창원시 성산구,620,173316,62265,236201,"2024-08-01",2024
"24-Aug",경남,창원시 의창구,564,119221,3814,123599,"2024-08-01",2024
"24-Aug",경남,창원시 진해구,233,97415,2137,99785,"2024-08-01",2024
"24-Aug",경남,통영시,321,53776,1339,55436,"2024-08-01",2024
"24-Aug",경남,하동군,242,24673,386,25301,"2024-08-01",2024
"24-Aug",경남,함안군,230,44819,37810,82859,"2024-08-01",2024
"24-Aug",경남,함양군,246,20595,634,21475,"2024-08-01",2024
"24-Aug",경남,합천군,302,24602,685,25589,"2024-08-01",2024
"24-Aug",경남,계,7654,1803060,157518,1968232,"2024-08-01",2024
"24-Aug",제주,서귀포시,772,107628,1905,110305,"2024-08-01",2024
"24-Aug",제주,제주시,1709,319286,278695,599690,"2024-08-01",2024
"24-Aug",제주,계,2481,426914,280600,709995,"2024-08-01",2024
"24-Aug",강원,강릉시,609,115135,4902,120646,"2024-08-01",2024
"24-Aug",강원,고성군,208,16372,232,16812,"2024-08-01",2024
"24-Aug",강원,동해시,330,48034,1589,49953,"2024-08-01",2024
"24-Aug",강원,삼척시,416,34079,829,35324,"2024-08-01",2024
"24-Aug",강원,속초시,321,40835,1507,42663,"2024-08-01",2024
"24-Aug",강원,양구군,224,12548,157,12929,"2024-08-01",2024
"24-Aug",강원,양양군,220,17176,280,17676,"2024-08-01",2024
"24-Aug",강원,영월군,351,22131,391,22873,"2024-08-01",2024
"24-Aug",강원,원주시,647,192417,5849,198913,"2024-08-01",2024
"24-Aug",강원,인제군,242,20166,294,20702,"2024-08-01",2024
"24-Aug",강원,정선군,377,21030,496,21903,"2024-08-01",2024
"24-Aug",강원,철원군,277,24807,416,25500,"2024-08-01",2024
"24-Aug",강원,춘천시,912,143382,6279,150573,"2024-08-01",2024
"24-Aug",강원,태백시,255,20287,672,21214,"2024-08-01",2024
"24-Aug",강원,평창군,335,27224,574,28133,"2024-08-01",2024
"24-Aug",강원,홍천군,448,41361,1047,42856,"2024-08-01",2024
"24-Aug",강원,화천군,230,13545,175,13950,"2024-08-01",2024
"24-Aug",강원,횡성군,292,28984,904,30180,"2024-08-01",2024
"24-Aug",강원,계,6694,839513,26593,872800,"2024-08-01",2024
"24-Aug",전북,고창군,343,32229,582,33154,"2024-08-01",2024
"24-Aug",전북,군산시,568,138783,6407,145758,"2024-08-01",2024
"24-Aug",전북,김제시,334,49303,1883,51520,"2024-08-01",2024
"24-Aug",전북,남원시,440,43251,1191,44882,"2024-08-01",2024
"24-Aug",전북,무주군,219,13862,410,14491,"2024-08-01",2024
"24-Aug",전북,부안군,299,28539,617,29455,"2024-08-01",2024
"24-Aug",전북,순창군,238,16014,192,16444,"2024-08-01",2024
"24-Aug",전북,완주군,461,60667,3214,64342,"2024-08-01",2024
"24-Aug",전북,익산시,562,142495,5908,148965,"2024-08-01",2024
"24-Aug",전북,임실군,269,15142,423,15834,"2024-08-01",2024
"24-Aug",전북,장수군,236,12763,152,13151,"2024-08-01",2024
"24-Aug",전북,전주시 덕진구,387,175814,7244,183445,"2024-08-01",2024
"24-Aug",전북,전주시 완산구,848,156408,4263,161519,"2024-08-01",2024
"24-Aug",전북,정읍시,391,57779,3135,61305,"2024-08-01",2024
"24-Aug",전북,진안군,287,15113,275,15675,"2024-08-01",2024
"24-Aug",전북,계,5882,958162,35896,999940,"2024-08-01",2024
"24-Sep",서울,강남구,433,236832,19584,256849,"2024-09-01",2024
"24-Sep",서울,강동구,302,147496,8608,156406,"2024-09-01",2024
"24-Sep",서울,강북구,320,69262,4202,73784,"2024-09-01",2024
"24-Sep",서울,강서구,365,187808,15012,203185,"2024-09-01",2024
"24-Sep",서울,관악구,283,111309,5771,117363,"2024-09-01",2024
"24-Sep",서울,광진구,318,91152,5152,96622,"2024-09-01",2024
"24-Sep",서울,구로구,307,133614,12842,146763,"2024-09-01",2024
"24-Sep",서울,금천구,179,85346,6185,91710,"2024-09-01",2024
"24-Sep",서울,노원구,325,142918,8795,152038,"2024-09-01",2024
"24-Sep",서울,도봉구,280,86667,7395,94342,"2024-09-01",2024
"24-Sep",서울,동대문구,305,97166,5370,102841,"2024-09-01",2024
"24-Sep",서울,동작구,313,103526,2599,106438,"2024-09-01",2024
"24-Sep",서울,마포구,348,113883,7597,121828,"2024-09-01",2024
"24-Sep",서울,서대문구,456,85630,5747,91833,"2024-09-01",2024
"24-Sep",서울,서초구,508,167333,9415,177256,"2024-09-01",2024
"24-Sep",서울,성동구,374,92144,12132,104650,"2024-09-01",2024
"24-Sep",서울,성북구,293,116768,4909,121970,"2024-09-01",2024
"24-Sep",서울,송파구,413,228889,14352,243654,"2024-09-01",2024
"24-Sep",서울,양천구,344,141688,8504,150536,"2024-09-01",2024
"24-Sep",서울,영등포구,374,135745,8183,144302,"2024-09-01",2024
"24-Sep",서울,용산구,546,70573,2358,73477,"2024-09-01",2024
"24-Sep",서울,은평구,304,127014,7019,134337,"2024-09-01",2024
"24-Sep",서울,종로구,3604,44550,2150,50304,"2024-09-01",2024
"24-Sep",서울,중구,1350,48502,3087,52939,"2024-09-01",2024
"24-Sep",서울,중랑구,250,106602,9648,116500,"2024-09-01",2024
"24-Sep",서울,계,12894,2972417,196616,3181927,"2024-09-01",2024
"24-Sep",부산,강서구,344,86486,5827,92657,"2024-09-01",2024
"24-Sep",부산,금정구,278,76735,7071,84084,"2024-09-01",2024
"24-Sep",부산,기장군,262,87640,2817,90719,"2024-09-01",2024
"24-Sep",부산,남구,228,92578,9375,102181,"2024-09-01",2024
"24-Sep",부산,동구,195,49435,5328,54958,"2024-09-01",2024
"24-Sep",부산,동래구,164,97470,3868,101502,"2024-09-01",2024
"24-Sep",부산,부산진구,368,133529,26817,160714,"2024-09-01",2024
"24-Sep",부산,북구,287,101634,3710,105631,"2024-09-01",2024
"24-Sep",부산,사상구,262,83164,5276,88702,"2024-09-01",2024
"24-Sep",부산,사하구,270,107888,6146,114304,"2024-09-01",2024
"24-Sep",부산,서구,135,30691,1403,32229,"2024-09-01",2024
"24-Sep",부산,수영구,166,63578,66655,130399,"2024-09-01",2024
"24-Sep",부산,연제구,1047,118349,26722,146118,"2024-09-01",2024
"24-Sep",부산,영도구,226,31660,2032,33918,"2024-09-01",2024
"24-Sep",부산,중구,313,36264,7142,43719,"2024-09-01",2024
"24-Sep",부산,해운대구,327,163502,5128,168957,"2024-09-01",2024
"24-Sep",부산,계,4872,1360603,185317,1550792,"2024-09-01",2024
"24-Sep",대구,군위군,131,15675,249,16055,"2024-09-01",2024
"24-Sep",대구,남구,404,54537,1552,56493,"2024-09-01",2024
"24-Sep",대구,달서구,514,273879,19733,294126,"2024-09-01",2024
"24-Sep",대구,달성군,597,140703,5196,146496,"2024-09-01",2024
"24-Sep",대구,동구,367,164917,9982,175266,"2024-09-01",2024
"24-Sep",대구,북구,548,202294,8082,210924,"2024-09-01",2024
"24-Sep",대구,서구,268,71372,4830,76470,"2024-09-01",2024
"24-Sep",대구,수성구,604,215770,5291,221665,"2024-09-01",2024
"24-Sep",대구,중구,317,59351,2215,61883,"2024-09-01",2024
"24-Sep",대구,계,3750,1198498,57130,1259378,"2024-09-01",2024
"24-Sep",인천,강화군,361,39043,8550,47954,"2024-09-01",2024
"24-Sep",인천,계양구,299,124948,148601,273848,"2024-09-01",2024
"24-Sep",인천,남동구,962,258990,25308,285260,"2024-09-01",2024
"24-Sep",인천,동구,110,24461,2793,27364,"2024-09-01",2024
"24-Sep",인천,미추홀구,444,165211,14313,179968,"2024-09-01",2024
"24-Sep",인천,부평구,341,229545,38137,268023,"2024-09-01",2024
"24-Sep",인천,서구,572,306263,13362,320197,"2024-09-01",2024
"24-Sep",인천,연수구,419,224199,10136,234754,"2024-09-01",2024
"24-Sep",인천,옹진군,254,13318,290,13862,"2024-09-01",2024
"24-Sep",인천,중구,639,80857,12273,93769,"2024-09-01",2024
"24-Sep",인천,계,4401,1466835,273763,1744999,"2024-09-01",2024
"24-Sep",광주,광산구,590,205808,13298,219696,"2024-09-01",2024
"24-Sep",광주,남구,237,93506,2744,96487,"2024-09-01",2024
"24-Sep",광주,동구,257,47290,999,48546,"2024-09-01",2024
"24-Sep",광주,북구,617,201771,9615,212003,"2024-09-01",2024
"24-Sep",광주,서구,747,145075,6191,152013,"2024-09-01",2024
"24-Sep",광주,계,2448,693450,32847,728745,"2024-09-01",2024
"24-Sep",대전,대덕구,249,88484,6827,95560,"2024-09-01",2024
"24-Sep",대전,동구,249,93332,5190,98771,"2024-09-01",2024
"24-Sep",대전,서구,876,208598,23566,233040,"2024-09-01",2024
"24-Sep",대전,유성구,697,195874,5864,202435,"2024-09-01",2024
"24-Sep",대전,중구,226,97836,5304,103366,"2024-09-01",2024
"24-Sep",대전,계,2297,684124,46751,733172,"2024-09-01",2024
"24-Sep",울산,남구,760,157918,7256,165934,"2024-09-01",2024
"24-Sep",울산,동구,192,64379,1330,65901,"2024-09-01",2024
"24-Sep",울산,북구,228,123412,3747,127387,"2024-09-01",2024
"24-Sep",울산,울주군,455,132497,7005,139957,"2024-09-01",2024
"24-Sep",울산,중구,349,103398,2640,106387,"2024-09-01",2024
"24-Sep",울산,계,1984,581604,21978,605566,"2024-09-01",2024
"24-Sep",세종,세종특별자치시,961,196401,3977,201339,"2024-09-01",2024
"24-Sep",세종,계,961,196401,3977,201339,"2024-09-01",2024
"24-Sep",경기,가평군,417,33533,624,34574,"2024-09-01",2024
"24-Sep",경기,고양시 덕양구,686,197880,5224,203790,"2024-09-01",2024
"24-Sep",경기,고양시 일산동구,280,131165,6366,137811,"2024-09-01",2024
"24-Sep",경기,고양시 일산서구,128,117131,4750,122009,"2024-09-01",2024
"24-Sep",경기,과천시,721,33275,810,34806,"2024-09-01",2024
"24-Sep",경기,광명시,314,100767,4748,105829,"2024-09-01",2024
"24-Sep",경기,광주시,429,208152,9064,217645,"2024-09-01",2024
"24-Sep",경기,구리시,277,71613,2948,74838,"2024-09-01",2024
"24-Sep",경기,군포시,308,98987,5154,104449,"2024-09-01",2024
"24-Sep",경기,김포시,580,239156,9453,249189,"2024-09-01",2024
"24-Sep",경기,남양주시,816,321014,10177,332007,"2024-09-01",2024
"24-Sep",경기,동두천시,236,38316,1474,40026,"2024-09-01",2024
"24-Sep",경기,부천시,6,263,22,291,"2024-09-01",2024
"24-Sep",경기,부천시 소사구,99,83957,3300,87356,"2024-09-01",2024
"24-Sep",경기,부천시 오정구,103,63229,3266,66598,"2024-09-01",2024
"24-Sep",경기,부천시 원미구,522,148348,6982,155852,"2024-09-01",2024
"24-Sep",경기,성남시 분당구,375,189162,7883,197420,"2024-09-01",2024
"24-Sep",경기,성남시 수정구,311,81819,3546,85676,"2024-09-01",2024
"24-Sep",경기,성남시 중원구,393,74428,4053,78874,"2024-09-01",2024
"24-Sep",경기,수원시 권선구,491,205051,10114,215656,"2024-09-01",2024
"24-Sep",경기,수원시 영통구,454,152272,3743,156469,"2024-09-01",2024
"24-Sep",경기,수원시 장안구,505,110060,3815,114380,"2024-09-01",2024
"24-Sep",경기,수원시 팔달구,291,81933,3450,85674,"2024-09-01",2024
"24-Sep",경기,시흥시,467,271084,9231,280782,"2024-09-01",2024
"24-Sep",경기,안산시 단원구,600,165463,8105,174168,"2024-09-01",2024
"24-Sep",경기,안산시 상록구,164,144989,5737,150890,"2024-09-01",2024
"24-Sep",경기,안성시,411,117642,4890,122943,"2024-09-01",2024
"24-Sep",경기,안양시 동안구,400,129351,6846,136597,"2024-09-01",2024
"24-Sep",경기,안양시 만안구,158,85026,3974,89158,"2024-09-01",2024
"24-Sep",경기,양주시,464,140762,4361,145587,"2024-09-01",2024
"24-Sep",경기,양평군,607,67967,1938,70512,"2024-09-01",2024
"24-Sep",경기,여주시,488,70139,7847,78474,"2024-09-01",2024
"24-Sep",경기,연천군,322,24694,4899,29915,"2024-09-01",2024
"24-Sep",경기,오산시,226,120236,4444,124906,"2024-09-01",2024
"24-Sep",경기,용인시 기흥구,156,200608,8001,208765,"2024-09-01",2024
"24-Sep",경기,용인시 수지구,62,151393,2289,153744,"2024-09-01",2024
"24-Sep",경기,용인시 처인구,820,148082,8270,157172,"2024-09-01",2024
"24-Sep",경기,의왕시,308,66044,2983,69335,"2024-09-01",2024
"24-Sep",경기,의정부시,779,174647,5749,181175,"2024-09-01",2024
"24-Sep",경기,이천시,446,124842,6656,131944,"2024-09-01",2024
"24-Sep",경기,파주시,566,250287,11694,262547,"2024-09-01",2024
"24-Sep",경기,평택시,809,333781,14467,349057,"2024-09-01",2024
"24-Sep",경기,포천시,434,90159,7617,98210,"2024-09-01",2024
"24-Sep",경기,하남시,459,141389,3775,145623,"2024-09-01",2024
"24-Sep",경기,화성시,998,528835,14456,544289,"2024-09-01",2024
"24-Sep",경기,계,18886,6328931,259195,6607012,"2024-09-01",2024
"24-Sep",충북,괴산군,220,24199,461,24880,"2024-09-01",2024
"24-Sep",충북,단양군,245,16553,849,17647,"2024-09-01",2024
"24-Sep",충북,보은군,250,19164,841,20255,"2024-09-01",2024
"24-Sep",충북,영동군,282,26433,431,27146,"2024-09-01",2024
"24-Sep",충북,옥천군,223,29172,1038,30433,"2024-09-01",2024
"24-Sep",충북,음성군,275,63277,2083,65635,"2024-09-01",2024
"24-Sep",충북,제천시,352,70406,3472,74230,"2024-09-01",2024
"24-Sep",충북,증평군,98,21059,832,21989,"2024-09-01",2024
"24-Sep",충북,진천군,231,56380,1560,58171,"2024-09-01",2024
"24-Sep",충북,청원군,1,19,0,20,"2024-09-01",2024
"24-Sep",충북,청주시 상당구,515,102424,2840,105779,"2024-09-01",2024
"24-Sep",충북,청주시 서원구,251,96566,4580,101397,"2024-09-01",2024
"24-Sep",충북,청주시 청원구,437,108954,5275,114666,"2024-09-01",2024
"24-Sep",충북,청주시 흥덕구,372,149441,7808,157621,"2024-09-01",2024
"24-Sep",충북,충주시,637,117913,7645,126195,"2024-09-01",2024
"24-Sep",충북,계,4389,901960,39715,946064,"2024-09-01",2024
"24-Sep",충남,계룡시,180,26411,624,27215,"2024-09-01",2024
"24-Sep",충남,공주시,593,56963,2361,59917,"2024-09-01",2024
"24-Sep",충남,금산군,220,30340,2685,33245,"2024-09-01",2024
"24-Sep",충남,논산시,411,63147,2344,65902,"2024-09-01",2024
"24-Sep",충남,당진시,437,107663,4261,112361,"2024-09-01",2024
"24-Sep",충남,보령시,418,54794,1407,56619,"2024-09-01",2024
"24-Sep",충남,부여군,332,35553,958,36843,"2024-09-01",2024
"24-Sep",충남,서산시,453,103757,3700,107910,"2024-09-01",2024
"24-Sep",충남,서천군,242,28163,779,29184,"2024-09-01",2024
"24-Sep",충남,아산시,573,203413,6925,210911,"2024-09-01",2024
"24-Sep",충남,예산군,474,47666,1460,49600,"2024-09-01",2024
"24-Sep",충남,천안시 동남구,320,142600,5703,148623,"2024-09-01",2024
"24-Sep",충남,천안시 서북구,569,208133,5423,214125,"2024-09-01",2024
"24-Sep",충남,청양군,266,17941,703,18910,"2024-09-01",2024
"24-Sep",충남,태안군,349,36601,610,37560,"2024-09-01",2024
"24-Sep",충남,홍성군,418,56956,1409,58783,"2024-09-01",2024
"24-Sep",충남,계,6255,1220101,41352,1267708,"2024-09-01",2024
"24-Sep",전남,강진군,257,19477,1006,20740,"2024-09-01",2024
"24-Sep",전남,고흥군,332,34688,552,35572,"2024-09-01",2024
"24-Sep",전남,곡성군,188,16132,613,16933,"2024-09-01",2024
"24-Sep",전남,광양시,265,94989,6196,101450,"2024-09-01",2024
"24-Sep",전남,구례군,179,13611,677,14467,"2024-09-01",2024
"24-Sep",전남,나주시,498,70617,3143,74258,"2024-09-01",2024
"24-Sep",전남,담양군,215,29068,1899,31182,"2024-09-01",2024
"24-Sep",전남,목포시,396,98829,5339,104564,"2024-09-01",2024
"24-Sep",전남,무안군,633,53968,1207,55808,"2024-09-01",2024
"24-Sep",전남,보성군,244,22633,629,23506,"2024-09-01",2024
"24-Sep",전남,순천시,513,149756,5499,155768,"2024-09-01",2024
"24-Sep",전남,신안군,398,24273,104513,129184,"2024-09-01",2024
"24-Sep",전남,여수시,568,138810,7574,146952,"2024-09-01",2024
"24-Sep",전남,영광군,244,30316,860,31420,"2024-09-01",2024
"24-Sep",전남,영암군,280,37140,1098,38518,"2024-09-01",2024
"24-Sep",전남,완도군,300,26632,509,27441,"2024-09-01",2024
"24-Sep",전남,장성군,218,28288,1244,29750,"2024-09-01",2024
"24-Sep",전남,장흥군,275,20980,462,21717,"2024-09-01",2024
"24-Sep",전남,진도군,234,18060,317,18611,"2024-09-01",2024
"24-Sep",전남,함평군,220,19376,6117,25713,"2024-09-01",2024
"24-Sep",전남,해남군,345,41632,87019,128996,"2024-09-01",2024
"24-Sep",전남,화순군,256,34825,2029,37110,"2024-09-01",2024
"24-Sep",전남,계,7058,1024100,238502,1269660,"2024-09-01",2024
"24-Sep",경북,경산시,382,145302,4439,150123,"2024-09-01",2024
"24-Sep",경북,경주시,606,149369,4611,154586,"2024-09-01",2024
"24-Sep",경북,고령군,184,21697,827,22708,"2024-09-01",2024
"24-Sep",경북,구미시,552,224169,7402,232123,"2024-09-01",2024
"24-Sep",경북,군위군,0,45,5,50,"2024-09-01",2024
"24-Sep",경북,김천시,410,78665,2153,81228,"2024-09-01",2024
"24-Sep",경북,문경시,298,38888,888,40074,"2024-09-01",2024
"24-Sep",경북,봉화군,253,18647,194,19094,"2024-09-01",2024
"24-Sep",경북,상주시,424,56253,1873,58550,"2024-09-01",2024
"24-Sep",경북,성주군,223,32513,1308,34044,"2024-09-01",2024
"24-Sep",경북,안동시,836,86352,2651,89839,"2024-09-01",2024
"24-Sep",경북,영덕군,265,19547,304,20116,"2024-09-01",2024
"24-Sep",경북,영양군,152,10285,119,10556,"2024-09-01",2024
"24-Sep",경북,영주시,397,57811,1520,59728,"2024-09-01",2024
"24-Sep",경북,영천시,363,63608,2475,66446,"2024-09-01",2024
"24-Sep",경북,예천군,295,32636,490,33421,"2024-09-01",2024
"24-Sep",경북,울릉군,152,6127,572,6851,"2024-09-01",2024
"24-Sep",경북,울진군,335,27786,358,28479,"2024-09-01",2024
"24-Sep",경북,의성군,295,32798,1114,34207,"2024-09-01",2024
"24-Sep",경북,청도군,228,26405,983,27616,"2024-09-01",2024
"24-Sep",경북,청송군,218,16464,208,16890,"2024-09-01",2024
"24-Sep",경북,칠곡군,319,71156,2492,73967,"2024-09-01",2024
"24-Sep",경북,포항시 남구,452,126328,8103,134883,"2024-09-01",2024
"24-Sep",경북,포항시 북구,386,149533,3916,153835,"2024-09-01",2024
"24-Sep",경북,계,8025,1492384,49005,1549414,"2024-09-01",2024
"24-Sep",경남,거제시,374,111061,2153,113588,"2024-09-01",2024
"24-Sep",경남,거창군,295,34895,796,35986,"2024-09-01",2024
"24-Sep",경남,고성군,237,28018,564,28819,"2024-09-01",2024
"24-Sep",경남,김해시,697,292831,8043,301571,"2024-09-01",2024
"24-Sep",경남,남해군,303,20947,441,21691,"2024-09-01",2024
"24-Sep",경남,밀양시,320,58968,3890,63178,"2024-09-01",2024
"24-Sep",경남,사천시,333,60326,1562,62221,"2024-09-01",2024
"24-Sep",경남,산청군,259,21588,752,22599,"2024-09-01",2024
"24-Sep",경남,양산시,435,180768,10666,191869,"2024-09-01",2024
"24-Sep",경남,의령군,220,15500,755,16475,"2024-09-01",2024
"24-Sep",경남,진주시,660,174620,6674,181954,"2024-09-01",2024
"24-Sep",경남,창녕군,250,36559,773,37582,"2024-09-01",2024
"24-Sep",경남,창원시 마산합포구,359,102569,2877,105805,"2024-09-01",2024
"24-Sep",경남,창원시 마산회원구,156,108169,8457,116782,"2024-09-01",2024
"24-Sep",경남,창원시 성산구,618,173702,62943,237263,"2024-09-01",2024
"24-Sep",경남,창원시 의창구,555,119009,3897,123461,"2024-09-01",2024
"24-Sep",경남,창원시 진해구,235,97485,2150,99870,"2024-09-01",2024
"24-Sep",경남,통영시,318,53822,1354,55494,"2024-09-01",2024
"24-Sep",경남,하동군,241,24656,387,25284,"2024-09-01",2024
"24-Sep",경남,함안군,233,44767,38228,83228,"2024-09-01",2024
"24-Sep",경남,함양군,255,20622,631,21508,"2024-09-01",2024
"24-Sep",경남,합천군,296,24569,686,25551,"2024-09-01",2024
"24-Sep",경남,계,7649,1805451,158679,1971779,"2024-09-01",2024
"24-Sep",제주,서귀포시,774,107583,1918,110275,"2024-09-01",2024
"24-Sep",제주,제주시,1707,320063,278969,600739,"2024-09-01",2024
"24-Sep",제주,계,2481,427646,280887,711014,"2024-09-01",2024
"24-Sep",강원,강릉시,612,115273,4871,120756,"2024-09-01",2024
"24-Sep",강원,고성군,212,16397,232,16841,"2024-09-01",2024
"24-Sep",강원,동해시,327,48088,1585,50000,"2024-09-01",2024
"24-Sep",강원,삼척시,416,34078,828,35322,"2024-09-01",2024
"24-Sep",강원,속초시,322,40827,1502,42651,"2024-09-01",2024
"24-Sep",강원,양구군,227,12549,158,12934,"2024-09-01",2024
"24-Sep",강원,양양군,220,17184,280,17684,"2024-09-01",2024
"24-Sep",강원,영월군,353,22105,396,22854,"2024-09-01",2024
"24-Sep",강원,원주시,644,192616,5859,199119,"2024-09-01",2024
"24-Sep",강원,인제군,241,20183,295,20719,"2024-09-01",2024
"24-Sep",강원,정선군,379,21024,496,21899,"2024-09-01",2024
"24-Sep",강원,철원군,278,24800,411,25489,"2024-09-01",2024
"24-Sep",강원,춘천시,920,143525,6284,150729,"2024-09-01",2024
"24-Sep",강원,태백시,255,20318,673,21246,"2024-09-01",2024
"24-Sep",강원,평창군,335,27212,620,28167,"2024-09-01",2024
"24-Sep",강원,홍천군,455,41404,1048,42907,"2024-09-01",2024
"24-Sep",강원,화천군,230,13537,174,13941,"2024-09-01",2024
"24-Sep",강원,횡성군,292,29026,904,30222,"2024-09-01",2024
"24-Sep",강원,계,6718,840146,26616,873480,"2024-09-01",2024
"24-Sep",전북,고창군,343,32221,584,33148,"2024-09-01",2024
"24-Sep",전북,군산시,566,139015,6419,146000,"2024-09-01",2024
"24-Sep",전북,김제시,332,49361,1875,51568,"2024-09-01",2024
"24-Sep",전북,남원시,438,43289,1183,44910,"2024-09-01",2024
"24-Sep",전북,무주군,220,13915,406,14541,"2024-09-01",2024
"24-Sep",전북,부안군,299,28539,611,29449,"2024-09-01",2024
"24-Sep",전북,순창군,239,16043,197,16479,"2024-09-01",2024
"24-Sep",전북,완주군,460,60750,3219,64429,"2024-09-01",2024
"24-Sep",전북,익산시,558,142510,5880,148948,"2024-09-01",2024
"24-Sep",전북,임실군,272,15187,422,15881,"2024-09-01",2024
"24-Sep",전북,장수군,236,12769,155,13160,"2024-09-01",2024
"24-Sep",전북,전주시 덕진구,375,175711,7220,183306,"2024-09-01",2024
"24-Sep",전북,전주시 완산구,843,156505,4284,161632,"2024-09-01",2024
"24-Sep",전북,정읍시,388,57884,3092,61364,"2024-09-01",2024
"24-Sep",전북,진안군,289,15109,279,15677,"2024-09-01",2024
"24-Sep",전북,계,5858,958808,35826,1000492,"2024-09-01",2024
"24-Oct",서울,강남구,434,236914,17545,254893,"2024-10-01",2024
"24-Oct",서울,강동구,302,147876,8583,156761,"2024-10-01",2024
"24-Oct",서울,강북구,320,69342,4198,73860,"2024-10-01",2024
"24-Oct",서울,강서구,362,188194,15042,203598,"2024-10-01",2024
"24-Oct",서울,관악구,285,110988,5742,117015,"2024-10-01",2024
"24-Oct",서울,광진구,314,91007,5106,96427,"2024-10-01",2024
"24-Oct",서울,구로구,309,133537,12738,146584,"2024-10-01",2024
"24-Oct",서울,금천구,178,85248,6157,91583,"2024-10-01",2024
"24-Oct",서울,노원구,326,142647,8798,151771,"2024-10-01",2024
"24-Oct",서울,도봉구,281,86511,7368,94160,"2024-10-01",2024
"24-Oct",서울,동대문구,311,97160,5377,102848,"2024-10-01",2024
"24-Oct",서울,동작구,314,103509,2593,106416,"2024-10-01",2024
"24-Oct",서울,마포구,342,113738,7582,121662,"2024-10-01",2024
"24-Oct",서울,서대문구,456,85470,5757,91683,"2024-10-01",2024
"24-Oct",서울,서초구,504,167506,9332,177342,"2024-10-01",2024
"24-Oct",서울,성동구,375,92068,12033,104476,"2024-10-01",2024
"24-Oct",서울,성북구,289,116720,4900,121909,"2024-10-01",2024
"24-Oct",서울,송파구,411,228980,14324,243715,"2024-10-01",2024
"24-Oct",서울,양천구,341,141572,8527,150440,"2024-10-01",2024
"24-Oct",서울,영등포구,374,135608,8197,144179,"2024-10-01",2024
"24-Oct",서울,용산구,553,70446,2348,73347,"2024-10-01",2024
"24-Oct",서울,은평구,306,126812,7009,134127,"2024-10-01",2024
"24-Oct",서울,종로구,3585,44449,2144,50178,"2024-10-01",2024
"24-Oct",서울,중구,1304,48241,3025,52570,"2024-10-01",2024
"24-Oct",서울,중랑구,247,106436,9637,116320,"2024-10-01",2024
"24-Oct",서울,계,12823,2970979,194062,3177864,"2024-10-01",2024
"24-Oct",부산,강서구,345,86394,5874,92613,"2024-10-01",2024
"24-Oct",부산,금정구,280,76521,7056,83857,"2024-10-01",2024
"24-Oct",부산,기장군,262,87759,2823,90844,"2024-10-01",2024
"24-Oct",부산,남구,229,92500,9291,102020,"2024-10-01",2024
"24-Oct",부산,동구,197,49486,5281,54964,"2024-10-01",2024
"24-Oct",부산,동래구,162,98476,3879,102517,"2024-10-01",2024
"24-Oct",부산,부산진구,368,133816,26964,161148,"2024-10-01",2024
"24-Oct",부산,북구,302,101405,3697,105404,"2024-10-01",2024
"24-Oct",부산,사상구,260,82972,5295,88527,"2024-10-01",2024
"24-Oct",부산,사하구,270,108184,6117,114571,"2024-10-01",2024
"24-Oct",부산,서구,134,30781,1406,32321,"2024-10-01",2024
"24-Oct",부산,수영구,165,63398,67665,131228,"2024-10-01",2024
"24-Oct",부산,연제구,1054,123598,26904,151556,"2024-10-01",2024
"24-Oct",부산,영도구,226,31477,2070,33773,"2024-10-01",2024
"24-Oct",부산,중구,309,36489,7171,43969,"2024-10-01",2024
"24-Oct",부산,해운대구,328,158472,5121,163921,"2024-10-01",2024
"24-Oct",부산,계,4891,1361728,186614,1553233,"2024-10-01",2024
"24-Oct",대구,군위군,131,15664,251,16046,"2024-10-01",2024
"24-Oct",대구,남구,406,54418,1548,56372,"2024-10-01",2024
"24-Oct",대구,달서구,489,273695,19911,294095,"2024-10-01",2024
"24-Oct",대구,달성군,597,140615,5180,146392,"2024-10-01",2024
"24-Oct",대구,동구,368,165187,10040,175595,"2024-10-01",2024
"24-Oct",대구,북구,551,202259,8043,210853,"2024-10-01",2024
"24-Oct",대구,서구,263,71781,4863,76907,"2024-10-01",2024
"24-Oct",대구,수성구,604,215839,5274,221717,"2024-10-01",2024
"24-Oct",대구,중구,316,59371,2212,61899,"2024-10-01",2024
"24-Oct",대구,계,3725,1198829,57322,1259876,"2024-10-01",2024
"24-Oct",인천,강화군,361,39230,8058,47649,"2024-10-01",2024
"24-Oct",인천,계양구,301,124904,148814,274019,"2024-10-01",2024
"24-Oct",인천,남동구,1006,258980,24720,284706,"2024-10-01",2024
"24-Oct",인천,동구,110,24488,2797,27395,"2024-10-01",2024
"24-Oct",인천,미추홀구,443,165562,16705,182710,"2024-10-01",2024
"24-Oct",인천,부평구,341,229253,37887,267481,"2024-10-01",2024
"24-Oct",인천,서구,581,307245,13425,321251,"2024-10-01",2024
"24-Oct",인천,연수구,415,224655,10225,235295,"2024-10-01",2024
"24-Oct",인천,옹진군,259,13345,294,13898,"2024-10-01",2024
"24-Oct",인천,중구,657,81128,12315,94100,"2024-10-01",2024
"24-Oct",인천,계,4474,1468790,275240,1748504,"2024-10-01",2024
"24-Oct",광주,광산구,587,205873,13282,219742,"2024-10-01",2024
"24-Oct",광주,남구,239,93528,2747,96514,"2024-10-01",2024
"24-Oct",광주,동구,256,47385,1017,48658,"2024-10-01",2024
"24-Oct",광주,북구,614,201870,9690,212174,"2024-10-01",2024
"24-Oct",광주,서구,742,145193,6160,152095,"2024-10-01",2024
"24-Oct",광주,계,2438,693849,32896,729183,"2024-10-01",2024
"24-Oct",대전,대덕구,248,88317,6830,95395,"2024-10-01",2024
"24-Oct",대전,동구,253,93822,5250,99325,"2024-10-01",2024
"24-Oct",대전,서구,869,208353,24223,233445,"2024-10-01",2024
"24-Oct",대전,유성구,695,196165,5824,202684,"2024-10-01",2024
"24-Oct",대전,중구,228,98096,5303,103627,"2024-10-01",2024
"24-Oct",대전,계,2293,684753,47430,734476,"2024-10-01",2024
"24-Oct",울산,남구,755,158042,7264,166061,"2024-10-01",2024
"24-Oct",울산,동구,193,64475,1331,65999,"2024-10-01",2024
"24-Oct",울산,북구,228,123532,3768,127528,"2024-10-01",2024
"24-Oct",울산,울주군,450,132699,7103,140252,"2024-10-01",2024
"24-Oct",울산,중구,350,103421,2640,106411,"2024-10-01",2024
"24-Oct",울산,계,1976,582169,22106,606251,"2024-10-01",2024
"24-Oct",세종,세종특별자치시,966,196754,3984,201704,"2024-10-01",2024
"24-Oct",세종,계,966,196754,3984,201704,"2024-10-01",2024
"24-Oct",경기,가평군,417,33565,628,34610,"2024-10-01",2024
"24-Oct",경기,고양시 덕양구,686,197951,5322,203959,"2024-10-01",2024
"24-Oct",경기,고양시 일산동구,282,131078,6375,137735,"2024-10-01",2024
"24-Oct",경기,고양시 일산서구,130,117019,4677,121826,"2024-10-01",2024
"24-Oct",경기,과천시,723,33324,813,34860,"2024-10-01",2024
"24-Oct",경기,광명시,335,100808,4738,105881,"2024-10-01",2024
"24-Oct",경기,광주시,432,208811,9083,218326,"2024-10-01",2024
"24-Oct",경기,구리시,280,71724,2950,74954,"2024-10-01",2024
"24-Oct",경기,군포시,305,98830,5171,104306,"2024-10-01",2024
"24-Oct",경기,김포시,573,239455,9506,249534,"2024-10-01",2024
"24-Oct",경기,남양주시,818,321118,10189,332125,"2024-10-01",2024
"24-Oct",경기,동두천시,238,38345,1469,40052,"2024-10-01",2024
"24-Oct",경기,부천시,6,263,20,289,"2024-10-01",2024
"24-Oct",경기,부천시 소사구,101,83896,3286,87283,"2024-10-01",2024
"24-Oct",경기,부천시 오정구,104,63303,3271,66678,"2024-10-01",2024
"24-Oct",경기,부천시 원미구,522,148426,6907,155855,"2024-10-01",2024
"24-Oct",경기,성남시 분당구,372,189356,7859,197587,"2024-10-01",2024
"24-Oct",경기,성남시 수정구,306,81652,3539,85497,"2024-10-01",2024
"24-Oct",경기,성남시 중원구,390,74288,4047,78725,"2024-10-01",2024
"24-Oct",경기,수원시 권선구,488,207505,10115,218108,"2024-10-01",2024
"24-Oct",경기,수원시 영통구,453,152362,3741,156556,"2024-10-01",2024
"24-Oct",경기,수원시 장안구,503,109914,3809,114226,"2024-10-01",2024
"24-Oct",경기,수원시 팔달구,287,81760,3427,85474,"2024-10-01",2024
"24-Oct",경기,시흥시,466,271447,9228,281141,"2024-10-01",2024
"24-Oct",경기,안산시 단원구,591,165552,7889,174032,"2024-10-01",2024
"24-Oct",경기,안산시 상록구,163,144846,5887,150896,"2024-10-01",2024
"24-Oct",경기,안성시,418,117670,4915,123003,"2024-10-01",2024
"24-Oct",경기,안양시 동안구,399,130087,6833,137319,"2024-10-01",2024
"24-Oct",경기,안양시 만안구,158,85088,3957,89203,"2024-10-01",2024
"24-Oct",경기,양주시,465,141455,4393,146313,"2024-10-01",2024
"24-Oct",경기,양평군,607,68053,1944,70604,"2024-10-01",2024
"24-Oct",경기,여주시,494,70217,7816,78527,"2024-10-01",2024
"24-Oct",경기,연천군,322,24748,4919,29989,"2024-10-01",2024
"24-Oct",경기,오산시,225,120599,4462,125286,"2024-10-01",2024
"24-Oct",경기,용인시 기흥구,157,200928,8043,209128,"2024-10-01",2024
"24-Oct",경기,용인시 수지구,65,151132,2343,153540,"2024-10-01",2024
"24-Oct",경기,용인시 처인구,823,148976,8313,158112,"2024-10-01",2024
"24-Oct",경기,의왕시,308,65998,2982,69288,"2024-10-01",2024
"24-Oct",경기,의정부시,777,174916,5766,181459,"2024-10-01",2024
"24-Oct",경기,이천시,445,125008,6660,132113,"2024-10-01",2024
"24-Oct",경기,파주시,564,250722,11678,262964,"2024-10-01",2024
"24-Oct",경기,평택시,805,334491,14475,349771,"2024-10-01",2024
"24-Oct",경기,포천시,431,90220,7447,98098,"2024-10-01",2024
"24-Oct",경기,하남시,454,141198,3840,145492,"2024-10-01",2024
"24-Oct",경기,화성시,996,531228,14466,546690,"2024-10-01",2024
"24-Oct",경기,계,18884,6339332,259198,6617414,"2024-10-01",2024
"24-Oct",충북,괴산군,220,24205,462,24887,"2024-10-01",2024
"24-Oct",충북,단양군,245,16576,837,17658,"2024-10-01",2024
"24-Oct",충북,보은군,250,19196,761,20207,"2024-10-01",2024
"24-Oct",충북,영동군,283,26473,430,27186,"2024-10-01",2024
"24-Oct",충북,옥천군,225,29215,1038,30478,"2024-10-01",2024
"24-Oct",충북,음성군,276,63481,2078,65835,"2024-10-01",2024
"24-Oct",충북,제천시,350,70514,3475,74339,"2024-10-01",2024
"24-Oct",충북,증평군,99,21059,829,21987,"2024-10-01",2024
"24-Oct",충북,진천군,232,56499,1564,58295,"2024-10-01",2024
"24-Oct",충북,청원군,1,19,0,20,"2024-10-01",2024
"24-Oct",충북,청주시 상당구,515,102501,2844,105860,"2024-10-01",2024
"24-Oct",충북,청주시 서원구,250,96371,4578,101199,"2024-10-01",2024
"24-Oct",충북,청주시 청원구,437,109153,5299,114889,"2024-10-01",2024
"24-Oct",충북,청주시 흥덕구,363,149720,7959,158042,"2024-10-01",2024
"24-Oct",충북,충주시,639,118135,7529,126303,"2024-10-01",2024
"24-Oct",충북,계,4385,903117,39683,947185,"2024-10-01",2024
"24-Oct",충남,계룡시,181,26408,625,27214,"2024-10-01",2024
"24-Oct",충남,공주시,594,56942,2371,59907,"2024-10-01",2024
"24-Oct",충남,금산군,221,30359,2779,33359,"2024-10-01",2024
"24-Oct",충남,논산시,411,63210,2343,65964,"2024-10-01",2024
"24-Oct",충남,당진시,431,108145,4281,112857,"2024-10-01",2024
"24-Oct",충남,보령시,420,54782,1421,56623,"2024-10-01",2024
"24-Oct",충남,부여군,332,35509,971,36812,"2024-10-01",2024
"24-Oct",충남,서산시,453,103760,3728,107941,"2024-10-01",2024
"24-Oct",충남,서천군,243,28177,782,29202,"2024-10-01",2024
"24-Oct",충남,아산시,581,203566,6948,211095,"2024-10-01",2024
"24-Oct",충남,예산군,474,47875,1464,49813,"2024-10-01",2024
"24-Oct",충남,천안시 동남구,295,142944,5753,148992,"2024-10-01",2024
"24-Oct",충남,천안시 서북구,568,208477,5426,214471,"2024-10-01",2024
"24-Oct",충남,청양군,276,17947,707,18930,"2024-10-01",2024
"24-Oct",충남,태안군,349,36609,627,37585,"2024-10-01",2024
"24-Oct",충남,홍성군,417,57077,1433,58927,"2024-10-01",2024
"24-Oct",충남,계,6246,1221787,41659,1269692,"2024-10-01",2024
"24-Oct",전남,강진군,257,19498,1008,20763,"2024-10-01",2024
"24-Oct",전남,고흥군,334,34730,549,35613,"2024-10-01",2024
"24-Oct",전남,곡성군,188,16149,611,16948,"2024-10-01",2024
"24-Oct",전남,광양시,264,95146,6213,101623,"2024-10-01",2024
"24-Oct",전남,구례군,179,13628,674,14481,"2024-10-01",2024
"24-Oct",전남,나주시,492,70574,3158,74224,"2024-10-01",2024
"24-Oct",전남,담양군,215,29007,1857,31079,"2024-10-01",2024
"24-Oct",전남,목포시,402,98807,5272,104481,"2024-10-01",2024
"24-Oct",전남,무안군,631,54159,1208,55998,"2024-10-01",2024
"24-Oct",전남,보성군,245,22685,632,23562,"2024-10-01",2024
"24-Oct",전남,순천시,519,149874,5487,155880,"2024-10-01",2024
"24-Oct",전남,신안군,401,24279,106014,130694,"2024-10-01",2024
"24-Oct",전남,여수시,570,138770,7563,146903,"2024-10-01",2024
"24-Oct",전남,영광군,245,30490,869,31604,"2024-10-01",2024
"24-Oct",전남,영암군,278,37126,1099,38503,"2024-10-01",2024
"24-Oct",전남,완도군,303,26649,506,27458,"2024-10-01",2024
"24-Oct",전남,장성군,218,28249,1242,29709,"2024-10-01",2024
"24-Oct",전남,장흥군,274,21012,474,21760,"2024-10-01",2024
"24-Oct",전남,진도군,234,18095,317,18646,"2024-10-01",2024
"24-Oct",전남,함평군,220,19392,6025,25637,"2024-10-01",2024
"24-Oct",전남,해남군,344,41689,88201,130234,"2024-10-01",2024
"24-Oct",전남,화순군,255,34840,1987,37082,"2024-10-01",2024
"24-Oct",전남,계,7068,1024848,240966,1272882,"2024-10-01",2024
"24-Oct",경북,경산시,385,145297,4443,150125,"2024-10-01",2024
"24-Oct",경북,경주시,601,149622,4653,154876,"2024-10-01",2024
"24-Oct",경북,고령군,183,21734,834,22751,"2024-10-01",2024
"24-Oct",경북,구미시,552,224420,7389,232361,"2024-10-01",2024
"24-Oct",경북,군위군,0,45,5,50,"2024-10-01",2024
"24-Oct",경북,김천시,408,78785,2159,81352,"2024-10-01",2024
"24-Oct",경북,문경시,302,38916,890,40108,"2024-10-01",2024
"24-Oct",경북,봉화군,254,18658,194,19106,"2024-10-01",2024
"24-Oct",경북,상주시,432,56365,1880,58677,"2024-10-01",2024
"24-Oct",경북,성주군,223,32520,1297,34040,"2024-10-01",2024
"24-Oct",경북,안동시,833,86553,2650,90036,"2024-10-01",2024
"24-Oct",경북,영덕군,266,19534,301,20101,"2024-10-01",2024
"24-Oct",경북,영양군,152,10275,118,10545,"2024-10-01",2024
"24-Oct",경북,영주시,395,57837,1518,59750,"2024-10-01",2024
"24-Oct",경북,영천시,364,63565,2484,66413,"2024-10-01",2024
"24-Oct",경북,예천군,296,32682,491,33469,"2024-10-01",2024
"24-Oct",경북,울릉군,152,6134,593,6879,"2024-10-01",2024
"24-Oct",경북,울진군,334,27875,362,28571,"2024-10-01",2024
"24-Oct",경북,의성군,295,32780,1113,34188,"2024-10-01",2024
"24-Oct",경북,청도군,229,26402,985,27616,"2024-10-01",2024
"24-Oct",경북,청송군,218,16504,207,16929,"2024-10-01",2024
"24-Oct",경북,칠곡군,320,71107,2484,73911,"2024-10-01",2024
"24-Oct",경북,포항시 남구,451,126172,8108,134731,"2024-10-01",2024
"24-Oct",경북,포항시 북구,391,149702,3903,153996,"2024-10-01",2024
"24-Oct",경북,계,8036,1493484,49061,1550581,"2024-10-01",2024
"24-Oct",경남,거제시,369,111124,2147,113640,"2024-10-01",2024
"24-Oct",경남,거창군,295,34935,805,36035,"2024-10-01",2024
"24-Oct",경남,고성군,238,28018,560,28816,"2024-10-01",2024
"24-Oct",경남,김해시,693,293303,8091,302087,"2024-10-01",2024
"24-Oct",경남,남해군,299,20962,442,21703,"2024-10-01",2024
"24-Oct",경남,밀양시,322,58995,3838,63155,"2024-10-01",2024
"24-Oct",경남,사천시,332,60394,1556,62282,"2024-10-01",2024
"24-Oct",경남,산청군,256,21580,749,22585,"2024-10-01",2024
"24-Oct",경남,양산시,436,181607,10645,192688,"2024-10-01",2024
"24-Oct",경남,의령군,219,15500,790,16509,"2024-10-01",2024
"24-Oct",경남,진주시,660,174775,6680,182115,"2024-10-01",2024
"24-Oct",경남,창녕군,250,36538,766,37554,"2024-10-01",2024
"24-Oct",경남,창원시 마산합포구,359,102709,2891,105959,"2024-10-01",2024
"24-Oct",경남,창원시 마산회원구,156,108548,8531,117235,"2024-10-01",2024
"24-Oct",경남,창원시 성산구,613,158223,19138,177974,"2024-10-01",2024
"24-Oct",경남,창원시 의창구,552,134955,48845,184352,"2024-10-01",2024
"24-Oct",경남,창원시 진해구,233,97548,2156,99937,"2024-10-01",2024
"24-Oct",경남,통영시,318,53875,1352,55545,"2024-10-01",2024
"24-Oct",경남,하동군,243,24677,391,25311,"2024-10-01",2024
"24-Oct",경남,함안군,225,44695,38420,83340,"2024-10-01",2024
"24-Oct",경남,함양군,255,20638,630,21523,"2024-10-01",2024
"24-Oct",경남,합천군,295,24649,686,25630,"2024-10-01",2024
"24-Oct",경남,계,7618,1808248,160109,1975975,"2024-10-01",2024
"24-Oct",제주,서귀포시,777,107586,1906,110269,"2024-10-01",2024
"24-Oct",제주,제주시,1704,320896,279583,602183,"2024-10-01",2024
"24-Oct",제주,계,2481,428482,281489,712452,"2024-10-01",2024
"24-Oct",강원,강릉시,611,115269,4834,120714,"2024-10-01",2024
"24-Oct",강원,고성군,212,16375,233,16820,"2024-10-01",2024
"24-Oct",강원,동해시,332,48086,1580,49998,"2024-10-01",2024
"24-Oct",강원,삼척시,415,34087,824,35326,"2024-10-01",2024
"24-Oct",강원,속초시,327,40824,1494,42645,"2024-10-01",2024
"24-Oct",강원,양구군,228,12552,159,12939,"2024-10-01",2024
"24-Oct",강원,양양군,222,17182,274,17678,"2024-10-01",2024
"24-Oct",강원,영월군,358,22139,398,22895,"2024-10-01",2024
"24-Oct",강원,원주시,645,193001,5853,199499,"2024-10-01",2024
"24-Oct",강원,인제군,241,20196,293,20730,"2024-10-01",2024
"24-Oct",강원,정선군,380,21029,503,21912,"2024-10-01",2024
"24-Oct",강원,철원군,275,24840,412,25527,"2024-10-01",2024
"24-Oct",강원,춘천시,916,143616,6298,150830,"2024-10-01",2024
"24-Oct",강원,태백시,253,20287,670,21210,"2024-10-01",2024
"24-Oct",강원,평창군,330,27254,566,28150,"2024-10-01",2024
"24-Oct",강원,홍천군,457,41376,1044,42877,"2024-10-01",2024
"24-Oct",강원,화천군,230,13624,174,14028,"2024-10-01",2024
"24-Oct",강원,횡성군,292,29071,900,30263,"2024-10-01",2024
"24-Oct",강원,계,6724,840808,26509,874041,"2024-10-01",2024
"24-Oct",전북,고창군,340,32252,586,33178,"2024-10-01",2024
"24-Oct",전북,군산시,570,139275,6472,146317,"2024-10-01",2024
"24-Oct",전북,김제시,330,49441,1876,51647,"2024-10-01",2024
"24-Oct",전북,남원시,435,43331,1193,44959,"2024-10-01",2024
"24-Oct",전북,무주군,220,13929,409,14558,"2024-10-01",2024
"24-Oct",전북,부안군,301,28549,612,29462,"2024-10-01",2024
"24-Oct",전북,순창군,241,16068,203,16512,"2024-10-01",2024
"24-Oct",전북,완주군,466,60893,3224,64583,"2024-10-01",2024
"24-Oct",전북,익산시,559,142919,5889,149367,"2024-10-01",2024
"24-Oct",전북,임실군,271,15167,422,15860,"2024-10-01",2024
"24-Oct",전북,장수군,235,12753,154,13142,"2024-10-01",2024
"24-Oct",전북,전주시 덕진구,377,175472,7208,183057,"2024-10-01",2024
"24-Oct",전북,전주시 완산구,835,156448,4306,161589,"2024-10-01",2024
"24-Oct",전북,정읍시,388,57913,3048,61349,"2024-10-01",2024
"24-Oct",전북,진안군,288,15107,281,15676,"2024-10-01",2024
"24-Oct",전북,계,5856,959517,35883,1001256,"2024-10-01",2024
"24-Nov",서울,강남구,433,236959,17237,254629,"2024-11-01",2024
"24-Nov",서울,강동구,301,148964,8571,157836,"2024-11-01",2024
"24-Nov",서울,강북구,326,69303,4194,73823,"2024-11-01",2024
"24-Nov",서울,강서구,363,188778,14387,203528,"2024-11-01",2024
"24-Nov",서울,관악구,285,110793,5803,116881,"2024-11-01",2024
"24-Nov",서울,광진구,310,91056,4990,96356,"2024-11-01",2024
"24-Nov",서울,구로구,308,133369,12741,146418,"2024-11-01",2024
"24-Nov",서울,금천구,177,85130,6161,91468,"2024-11-01",2024
"24-Nov",서울,노원구,320,142576,8824,151720,"2024-11-01",2024
"24-Nov",서울,도봉구,280,86475,7348,94103,"2024-11-01",2024
"24-Nov",서울,동대문구,304,96975,5378,102657,"2024-11-01",2024
"24-Nov",서울,동작구,312,103467,2581,106360,"2024-11-01",2024
"24-Nov",서울,마포구,344,113774,7597,121715,"2024-11-01",2024
"24-Nov",서울,서대문구,448,85427,5753,91628,"2024-11-01",2024
"24-Nov",서울,서초구,515,167579,9337,177431,"2024-11-01",2024
"24-Nov",서울,성동구,372,92115,11934,104421,"2024-11-01",2024
"24-Nov",서울,성북구,287,116712,4870,121869,"2024-11-01",2024
"24-Nov",서울,송파구,416,228929,14307,243652,"2024-11-01",2024
"24-Nov",서울,양천구,344,141430,8518,150292,"2024-11-01",2024
"24-Nov",서울,영등포구,375,135602,8213,144190,"2024-11-01",2024
"24-Nov",서울,용산구,556,70394,2274,73224,"2024-11-01",2024
"24-Nov",서울,은평구,304,126725,7015,134044,"2024-11-01",2024
"24-Nov",서울,종로구,3590,44408,2152,50150,"2024-11-01",2024
"24-Nov",서울,중구,1296,47916,3617,52829,"2024-11-01",2024
"24-Nov",서울,중랑구,248,106306,9649,116203,"2024-11-01",2024
"24-Nov",서울,계,12814,2971162,193451,3177427,"2024-11-01",2024
"24-Nov",부산,강서구,350,86403,5894,92647,"2024-11-01",2024
"24-Nov",부산,금정구,280,76431,7059,83770,"2024-11-01",2024
"24-Nov",부산,기장군,262,87835,2842,90939,"2024-11-01",2024
"24-Nov",부산,남구,229,92483,9133,101845,"2024-11-01",2024
"24-Nov",부산,동구,195,49622,5279,55096,"2024-11-01",2024
"24-Nov",부산,동래구,162,99480,3898,103540,"2024-11-01",2024
"24-Nov",부산,부산진구,367,134092,27128,161587,"2024-11-01",2024
"24-Nov",부산,북구,297,101281,3694,105272,"2024-11-01",2024
"24-Nov",부산,사상구,261,83170,5271,88702,"2024-11-01",2024
"24-Nov",부산,사하구,272,108484,6089,114845,"2024-11-01",2024
"24-Nov",부산,서구,133,30769,1407,32309,"2024-11-01",2024
"24-Nov",부산,수영구,164,63427,68587,132178,"2024-11-01",2024
"24-Nov",부산,연제구,1048,123760,27192,152000,"2024-11-01",2024
"24-Nov",부산,영도구,223,31410,2072,33705,"2024-11-01",2024
"24-Nov",부산,중구,308,36612,7093,44013,"2024-11-01",2024
"24-Nov",부산,해운대구,328,158391,5120,163839,"2024-11-01",2024
"24-Nov",부산,계,4879,1363650,187758,1556287,"2024-11-01",2024
"24-Nov",대구,군위군,135,15630,249,16014,"2024-11-01",2024
"24-Nov",대구,남구,403,54533,1556,56492,"2024-11-01",2024
"24-Nov",대구,달서구,483,273660,19952,294095,"2024-11-01",2024
"24-Nov",대구,달성군,593,140756,5181,146530,"2024-11-01",2024
"24-Nov",대구,동구,366,165531,9982,175879,"2024-11-01",2024
"24-Nov",대구,북구,550,202297,8198,211045,"2024-11-01",2024
"24-Nov",대구,서구,264,71925,4875,77064,"2024-11-01",2024
"24-Nov",대구,수성구,600,217002,5181,222783,"2024-11-01",2024
"24-Nov",대구,중구,316,59720,2174,62210,"2024-11-01",2024
"24-Nov",대구,계,3710,1201054,57348,1262112,"2024-11-01",2024
"24-Nov",인천,강화군,363,39347,7529,47239,"2024-11-01",2024
"24-Nov",인천,계양구,303,124843,148914,274060,"2024-11-01",2024
"24-Nov",인천,남동구,1004,258968,24225,284197,"2024-11-01",2024
"24-Nov",인천,동구,110,24517,2782,27409,"2024-11-01",2024
"24-Nov",인천,미추홀구,440,165937,17083,183460,"2024-11-01",2024
"24-Nov",인천,부평구,340,229050,37719,267109,"2024-11-01",2024
"24-Nov",인천,서구,574,308325,13501,322400,"2024-11-01",2024
"24-Nov",인천,연수구,399,225418,10231,236048,"2024-11-01",2024
"24-Nov",인천,옹진군,260,13294,290,13844,"2024-11-01",2024
"24-Nov",인천,중구,662,81596,12275,94533,"2024-11-01",2024
"24-Nov",인천,계,4455,1471295,274549,1750299,"2024-11-01",2024
"24-Nov",광주,광산구,592,206055,13280,219927,"2024-11-01",2024
"24-Nov",광주,남구,237,93557,2753,96547,"2024-11-01",2024
"24-Nov",광주,동구,255,47499,1020,48774,"2024-11-01",2024
"24-Nov",광주,북구,615,202016,9712,212343,"2024-11-01",2024
"24-Nov",광주,서구,738,145766,6114,152618,"2024-11-01",2024
"24-Nov",광주,계,2437,694893,32879,730209,"2024-11-01",2024
"24-Nov",대전,대덕구,249,88395,6822,95466,"2024-11-01",2024
"24-Nov",대전,동구,252,93953,5298,99503,"2024-11-01",2024
"24-Nov",대전,서구,851,208457,24618,233926,"2024-11-01",2024
"24-Nov",대전,유성구,694,197206,5777,203677,"2024-11-01",2024
"24-Nov",대전,중구,223,98296,5310,103829,"2024-11-01",2024
"24-Nov",대전,계,2269,686307,47825,736401,"2024-11-01",2024
"24-Nov",울산,남구,755,158103,7235,166093,"2024-11-01",2024
"24-Nov",울산,동구,193,64500,1318,66011,"2024-11-01",2024
"24-Nov",울산,북구,227,123951,3791,127969,"2024-11-01",2024
"24-Nov",울산,울주군,448,132966,7100,140514,"2024-11-01",2024
"24-Nov",울산,중구,351,103418,2614,106383,"2024-11-01",2024
"24-Nov",울산,계,1974,582938,22058,606970,"2024-11-01",2024
"24-Nov",세종,세종특별자치시,967,197099,4001,202067,"2024-11-01",2024
"24-Nov",세종,계,967,197099,4001,202067,"2024-11-01",2024
"24-Nov",경기,가평군,413,33594,626,34633,"2024-11-01",2024
"24-Nov",경기,고양시 덕양구,684,198119,5379,204182,"2024-11-01",2024
"24-Nov",경기,고양시 일산동구,277,131205,6398,137880,"2024-11-01",2024
"24-Nov",경기,고양시 일산서구,130,116953,4705,121788,"2024-11-01",2024
"24-Nov",경기,과천시,725,33494,814,35033,"2024-11-01",2024
"24-Nov",경기,광명시,336,101234,4728,106298,"2024-11-01",2024
"24-Nov",경기,광주시,439,209189,9181,218809,"2024-11-01",2024
"24-Nov",경기,구리시,281,71860,2899,75040,"2024-11-01",2024
"24-Nov",경기,군포시,306,98719,5178,104203,"2024-11-01",2024
"24-Nov",경기,김포시,572,239729,9545,249846,"2024-11-01",2024
"24-Nov",경기,남양주시,819,321206,10222,332247,"2024-11-01",2024
"24-Nov",경기,동두천시,238,38396,1466,40100,"2024-11-01",2024
"24-Nov",경기,부천시,6,263,20,289,"2024-11-01",2024
"24-Nov",경기,부천시 소사구,100,83870,3273,87243,"2024-11-01",2024
"24-Nov",경기,부천시 오정구,104,63541,3290,66935,"2024-11-01",2024
"24-Nov",경기,부천시 원미구,522,148831,6889,156242,"2024-11-01",2024
"24-Nov",경기,성남시 분당구,372,189630,7911,197913,"2024-11-01",2024
"24-Nov",경기,성남시 수정구,301,81595,3544,85440,"2024-11-01",2024
"24-Nov",경기,성남시 중원구,390,74282,4049,78721,"2024-11-01",2024
"24-Nov",경기,수원시 권선구,453,209901,10122,220476,"2024-11-01",2024
"24-Nov",경기,수원시 영통구,449,152466,3699,156614,"2024-11-01",2024
"24-Nov",경기,수원시 장안구,505,110038,3805,114348,"2024-11-01",2024
"24-Nov",경기,수원시 팔달구,324,81726,3512,85562,"2024-11-01",2024
"24-Nov",경기,시흥시,466,271767,9227,281460,"2024-11-01",2024
"24-Nov",경기,안산시 단원구,591,166077,7885,174553,"2024-11-01",2024
"24-Nov",경기,안산시 상록구,164,144836,5888,150888,"2024-11-01",2024
"24-Nov",경기,안성시,419,118294,4917,123630,"2024-11-01",2024
"24-Nov",경기,안양시 동안구,399,130475,6867,137741,"2024-11-01",2024
"24-Nov",경기,안양시 만안구,158,85744,3946,89848,"2024-11-01",2024
"24-Nov",경기,양주시,456,142253,4414,147123,"2024-11-01",2024
"24-Nov",경기,양평군,608,67919,1923,70450,"2024-11-01",2024
"24-Nov",경기,여주시,496,70362,7815,78673,"2024-11-01",2024
"24-Nov",경기,연천군,319,24778,4904,30001,"2024-11-01",2024
"24-Nov",경기,오산시,232,121437,4503,126172,"2024-11-01",2024
"24-Nov",경기,용인시 기흥구,156,201482,8124,209762,"2024-11-01",2024
"24-Nov",경기,용인시 수지구,67,151276,2286,153629,"2024-11-01",2024
"24-Nov",경기,용인시 처인구,816,149445,8363,158624,"2024-11-01",2024
"24-Nov",경기,의왕시,308,66102,2975,69385,"2024-11-01",2024
"24-Nov",경기,의정부시,766,175340,5774,181880,"2024-11-01",2024
"24-Nov",경기,이천시,441,125328,6656,132425,"2024-11-01",2024
"24-Nov",경기,파주시,562,251422,11640,263624,"2024-11-01",2024
"24-Nov",경기,평택시,802,335531,14528,350861,"2024-11-01",2024
"24-Nov",경기,포천시,427,90415,7267,98109,"2024-11-01",2024
"24-Nov",경기,하남시,451,141355,3781,145587,"2024-11-01",2024
"24-Nov",경기,화성시,995,532782,14480,548257,"2024-11-01",2024
"24-Nov",경기,계,18845,6354261,259418,6632524,"2024-11-01",2024
"24-Nov",충북,괴산군,220,24267,457,24944,"2024-11-01",2024
"24-Nov",충북,단양군,243,16558,832,17633,"2024-11-01",2024
"24-Nov",충북,보은군,253,19241,740,20234,"2024-11-01",2024
"24-Nov",충북,영동군,285,26482,431,27198,"2024-11-01",2024
"24-Nov",충북,옥천군,225,29156,1037,30418,"2024-11-01",2024
"24-Nov",충북,음성군,277,63912,2091,66280,"2024-11-01",2024
"24-Nov",충북,제천시,349,70494,3468,74311,"2024-11-01",2024
"24-Nov",충북,증평군,99,21087,829,22015,"2024-11-01",2024
"24-Nov",충북,진천군,229,56474,1580,58283,"2024-11-01",2024
"24-Nov",충북,청원군,1,19,0,20,"2024-11-01",2024
"24-Nov",충북,청주시 상당구,517,102491,2835,105843,"2024-11-01",2024
"24-Nov",충북,청주시 서원구,251,96265,4599,101115,"2024-11-01",2024
"24-Nov",충북,청주시 청원구,435,109381,5302,115118,"2024-11-01",2024
"24-Nov",충북,청주시 흥덕구,368,150675,7997,159040,"2024-11-01",2024
"24-Nov",충북,충주시,641,118319,7334,126294,"2024-11-01",2024
"24-Nov",충북,계,4393,904821,39532,948746,"2024-11-01",2024
"24-Nov",충남,계룡시,182,26357,623,27162,"2024-11-01",2024
"24-Nov",충남,공주시,598,57012,2358,59968,"2024-11-01",2024
"24-Nov",충남,금산군,221,30324,2840,33385,"2024-11-01",2024
"24-Nov",충남,논산시,414,63257,2345,66016,"2024-11-01",2024
"24-Nov",충남,당진시,433,108377,4294,113104,"2024-11-01",2024
"24-Nov",충남,보령시,420,54770,1421,56611,"2024-11-01",2024
"24-Nov",충남,부여군,335,35469,964,36768,"2024-11-01",2024
"24-Nov",충남,서산시,453,103779,3736,107968,"2024-11-01",2024
"24-Nov",충남,서천군,242,28196,783,29221,"2024-11-01",2024
"24-Nov",충남,아산시,579,204007,6710,211296,"2024-11-01",2024
"24-Nov",충남,예산군,464,48101,1466,50031,"2024-11-01",2024
"24-Nov",충남,천안시 동남구,296,143697,5780,149773,"2024-11-01",2024
"24-Nov",충남,천안시 서북구,566,208903,5521,214990,"2024-11-01",2024
"24-Nov",충남,청양군,278,17984,712,18974,"2024-11-01",2024
"24-Nov",충남,태안군,351,36615,621,37587,"2024-11-01",2024
"24-Nov",충남,홍성군,420,57209,1470,59099,"2024-11-01",2024
"24-Nov",충남,계,6252,1224057,41644,1271953,"2024-11-01",2024
"24-Nov",전남,강진군,256,19522,1008,20786,"2024-11-01",2024
"24-Nov",전남,고흥군,332,34782,552,35666,"2024-11-01",2024
"24-Nov",전남,곡성군,186,16142,609,16937,"2024-11-01",2024
"24-Nov",전남,광양시,266,95388,6210,101864,"2024-11-01",2024
"24-Nov",전남,구례군,179,13657,672,14508,"2024-11-01",2024
"24-Nov",전남,나주시,493,70619,3142,74254,"2024-11-01",2024
"24-Nov",전남,담양군,215,29067,1866,31148,"2024-11-01",2024
"24-Nov",전남,목포시,397,98827,5275,104499,"2024-11-01",2024
"24-Nov",전남,무안군,629,54310,1207,56146,"2024-11-01",2024
"24-Nov",전남,보성군,242,22702,623,23567,"2024-11-01",2024
"24-Nov",전남,순천시,516,150157,5481,156154,"2024-11-01",2024
"24-Nov",전남,신안군,401,24321,106575,131297,"2024-11-01",2024
"24-Nov",전남,여수시,567,138803,7520,146890,"2024-11-01",2024
"24-Nov",전남,영광군,247,30575,876,31698,"2024-11-01",2024
"24-Nov",전남,영암군,279,37177,1089,38545,"2024-11-01",2024
"24-Nov",전남,완도군,302,26720,506,27528,"2024-11-01",2024
"24-Nov",전남,장성군,218,28276,1230,29724,"2024-11-01",2024
"24-Nov",전남,장흥군,275,21065,471,21811,"2024-11-01",2024
"24-Nov",전남,진도군,232,18128,319,18679,"2024-11-01",2024
"24-Nov",전남,함평군,219,19402,5979,25600,"2024-11-01",2024
"24-Nov",전남,해남군,342,41738,88807,130887,"2024-11-01",2024
"24-Nov",전남,화순군,256,34897,1971,37124,"2024-11-01",2024
"24-Nov",전남,계,7049,1026275,241988,1275312,"2024-11-01",2024
"24-Nov",경북,경산시,385,145542,4452,150379,"2024-11-01",2024
"24-Nov",경북,경주시,598,149740,4632,154970,"2024-11-01",2024
"24-Nov",경북,고령군,184,21798,832,22814,"2024-11-01",2024
"24-Nov",경북,구미시,547,224821,7336,232704,"2024-11-01",2024
"24-Nov",경북,군위군,0,45,5,50,"2024-11-01",2024
"24-Nov",경북,김천시,409,78911,2158,81478,"2024-11-01",2024
"24-Nov",경북,문경시,304,38984,884,40172,"2024-11-01",2024
"24-Nov",경북,봉화군,254,18667,198,19119,"2024-11-01",2024
"24-Nov",경북,상주시,432,56356,1889,58677,"2024-11-01",2024
"24-Nov",경북,성주군,223,32531,1302,34056,"2024-11-01",2024
"24-Nov",경북,안동시,828,86723,2641,90192,"2024-11-01",2024
"24-Nov",경북,영덕군,267,19572,300,20139,"2024-11-01",2024
"24-Nov",경북,영양군,152,10299,119,10570,"2024-11-01",2024
"24-Nov",경북,영주시,386,57947,1525,59858,"2024-11-01",2024
"24-Nov",경북,영천시,361,63587,2492,66440,"2024-11-01",2024
"24-Nov",경북,예천군,299,32721,492,33512,"2024-11-01",2024
"24-Nov",경북,울릉군,152,6122,581,6855,"2024-11-01",2024
"24-Nov",경북,울진군,331,27950,360,28641,"2024-11-01",2024
"24-Nov",경북,의성군,295,32831,1114,34240,"2024-11-01",2024
"24-Nov",경북,청도군,231,26455,987,27673,"2024-11-01",2024
"24-Nov",경북,청송군,217,16527,208,16952,"2024-11-01",2024
"24-Nov",경북,칠곡군,314,71033,2474,73821,"2024-11-01",2024
"24-Nov",경북,포항시 남구,446,126151,8051,134648,"2024-11-01",2024
"24-Nov",경북,포항시 북구,390,149943,3894,154227,"2024-11-01",2024
"24-Nov",경북,계,8005,1495256,48926,1552187,"2024-11-01",2024
"24-Nov",경남,거제시,370,111274,2155,113799,"2024-11-01",2024
"24-Nov",경남,거창군,296,34967,806,36069,"2024-11-01",2024
"24-Nov",경남,고성군,232,28046,556,28834,"2024-11-01",2024
"24-Nov",경남,김해시,688,293694,8080,302462,"2024-11-01",2024
"24-Nov",경남,남해군,300,20980,443,21723,"2024-11-01",2024
"24-Nov",경남,밀양시,324,59045,3842,63211,"2024-11-01",2024
"24-Nov",경남,사천시,333,60494,1562,62389,"2024-11-01",2024
"24-Nov",경남,산청군,257,21590,744,22591,"2024-11-01",2024
"24-Nov",경남,양산시,436,182040,10621,193097,"2024-11-01",2024
"24-Nov",경남,의령군,219,15510,788,16517,"2024-11-01",2024
"24-Nov",경남,진주시,661,174726,6694,182081,"2024-11-01",2024
"24-Nov",경남,창녕군,248,36605,766,37619,"2024-11-01",2024
"24-Nov",경남,창원시 마산합포구,363,102592,2894,105849,"2024-11-01",2024
"24-Nov",경남,창원시 마산회원구,156,109098,8513,117767,"2024-11-01",2024
"24-Nov",경남,창원시 성산구,615,159279,19795,179689,"2024-11-01",2024
"24-Nov",경남,창원시 의창구,552,134444,49000,183996,"2024-11-01",2024
"24-Nov",경남,창원시 진해구,229,97668,2176,100073,"2024-11-01",2024
"24-Nov",경남,통영시,316,53845,1349,55510,"2024-11-01",2024
"24-Nov",경남,하동군,244,24655,394,25293,"2024-11-01",2024
"24-Nov",경남,함안군,225,44938,32702,77865,"2024-11-01",2024
"24-Nov",경남,함양군,256,20672,6910,27838,"2024-11-01",2024
"24-Nov",경남,합천군,296,24641,695,25632,"2024-11-01",2024
"24-Nov",경남,계,7616,1810803,161485,1979904,"2024-11-01",2024
"24-Nov",제주,서귀포시,775,107677,1912,110364,"2024-11-01",2024
"24-Nov",제주,제주시,1691,321997,280538,604226,"2024-11-01",2024
"24-Nov",제주,계,2466,429674,282450,714590,"2024-11-01",2024
"24-Nov",강원,강릉시,613,115211,4776,120600,"2024-11-01",2024
"24-Nov",강원,고성군,210,16401,234,16845,"2024-11-01",2024
"24-Nov",강원,동해시,334,48202,1635,50171,"2024-11-01",2024
"24-Nov",강원,삼척시,413,34135,817,35365,"2024-11-01",2024
"24-Nov",강원,속초시,328,40800,1475,42603,"2024-11-01",2024
"24-Nov",강원,양구군,228,12536,156,12920,"2024-11-01",2024
"24-Nov",강원,양양군,223,17162,270,17655,"2024-11-01",2024
"24-Nov",강원,영월군,358,22100,400,22858,"2024-11-01",2024
"24-Nov",강원,원주시,648,193272,5857,199777,"2024-11-01",2024
"24-Nov",강원,인제군,245,20164,292,20701,"2024-11-01",2024
"24-Nov",강원,정선군,382,21025,495,21902,"2024-11-01",2024
"24-Nov",강원,철원군,276,24817,411,25504,"2024-11-01",2024
"24-Nov",강원,춘천시,931,143703,6302,150936,"2024-11-01",2024
"24-Nov",강원,태백시,259,20305,671,21235,"2024-11-01",2024
"24-Nov",강원,평창군,325,27231,507,28063,"2024-11-01",2024
"24-Nov",강원,홍천군,455,41320,1053,42828,"2024-11-01",2024
"24-Nov",강원,화천군,232,13620,175,14027,"2024-11-01",2024
"24-Nov",강원,횡성군,292,29094,906,30292,"2024-11-01",2024
"24-Nov",강원,계,6752,841098,26432,874282,"2024-11-01",2024
"24-Nov",전북,고창군,340,32269,589,33198,"2024-11-01",2024
"24-Nov",전북,군산시,572,139593,6496,146661,"2024-11-01",2024
"24-Nov",전북,김제시,331,49494,1883,51708,"2024-11-01",2024
"24-Nov",전북,남원시,435,43414,1190,45039,"2024-11-01",2024
"24-Nov",전북,무주군,219,13926,408,14553,"2024-11-01",2024
"24-Nov",전북,부안군,299,28552,611,29462,"2024-11-01",2024
"24-Nov",전북,순창군,241,16049,210,16500,"2024-11-01",2024
"24-Nov",전북,완주군,470,60978,3229,64677,"2024-11-01",2024
"24-Nov",전북,익산시,562,143228,5873,149663,"2024-11-01",2024
"24-Nov",전북,임실군,268,15162,424,15854,"2024-11-01",2024
"24-Nov",전북,장수군,237,12731,154,13122,"2024-11-01",2024
"24-Nov",전북,전주시 덕진구,375,175572,7174,183121,"2024-11-01",2024
"24-Nov",전북,전주시 완산구,825,156593,4328,161746,"2024-11-01",2024
"24-Nov",전북,정읍시,390,57970,3007,61367,"2024-11-01",2024
"24-Nov",전북,진안군,290,15082,293,15665,"2024-11-01",2024
"24-Nov",전북,계,5854,960613,35869,1002336,"2024-11-01",2024
"24-Dec",서울,강남구,429,236931,17511,254871,"2024-12-01",2024
"24-Dec",서울,강동구,300,152108,8575,160983,"2024-12-01",2024
"24-Dec",서울,강북구,327,69210,4191,73728,"2024-12-01",2024
"24-Dec",서울,강서구,362,188960,14398,203720,"2024-12-01",2024
"24-Dec",서울,관악구,290,110651,5804,116745,"2024-12-01",2024
"24-Dec",서울,광진구,311,91076,4948,96335,"2024-12-01",2024
"24-Dec",서울,구로구,303,132996,12491,145790,"2024-12-01",2024
"24-Dec",서울,금천구,174,85089,6139,91402,"2024-12-01",2024
"24-Dec",서울,노원구,319,142424,8760,151503,"2024-12-01",2024
"24-Dec",서울,도봉구,276,86425,7340,94041,"2024-12-01",2024
"24-Dec",서울,동대문구,306,96847,5382,102535,"2024-12-01",2024
"24-Dec",서울,동작구,311,103309,2569,106189,"2024-12-01",2024
"24-Dec",서울,마포구,346,113626,7586,121558,"2024-12-01",2024
"24-Dec",서울,서대문구,448,85254,5751,91453,"2024-12-01",2024
"24-Dec",서울,서초구,509,167574,9265,177348,"2024-12-01",2024
"24-Dec",서울,성동구,373,92111,11679,104163,"2024-12-01",2024
"24-Dec",서울,성북구,289,116592,4871,121752,"2024-12-01",2024
"24-Dec",서울,송파구,411,228233,14253,242897,"2024-12-01",2024
"24-Dec",서울,양천구,346,141376,8509,150231,"2024-12-01",2024
"24-Dec",서울,영등포구,377,135338,8252,143967,"2024-12-01",2024
"24-Dec",서울,용산구,554,70281,2274,73109,"2024-12-01",2024
"24-Dec",서울,은평구,302,126691,7024,134017,"2024-12-01",2024
"24-Dec",서울,종로구,3598,44339,2162,50099,"2024-12-01",2024
"24-Dec",서울,중구,1303,47551,3507,52361,"2024-12-01",2024
"24-Dec",서울,중랑구,247,106197,9692,116136,"2024-12-01",2024
"24-Dec",서울,계,12811,2971189,192933,3176933,"2024-12-01",2024
"24-Dec",부산,강서구,351,86536,5853,92740,"2024-12-01",2024
"24-Dec",부산,금정구,276,76299,7081,83656,"2024-12-01",2024
"24-Dec",부산,기장군,262,87965,2864,91091,"2024-12-01",2024
"24-Dec",부산,남구,229,92416,9220,101865,"2024-12-01",2024
"24-Dec",부산,동구,197,49558,5236,54991,"2024-12-01",2024
"24-Dec",부산,동래구,162,99805,3906,103873,"2024-12-01",2024
"24-Dec",부산,부산진구,368,134596,27252,162216,"2024-12-01",2024
"24-Dec",부산,북구,304,101211,3679,105194,"2024-12-01",2024
"24-Dec",부산,사상구,261,83093,5235,88589,"2024-12-01",2024
"24-Dec",부산,사하구,270,108539,6138,114947,"2024-12-01",2024
"24-Dec",부산,서구,134,30822,1360,32316,"2024-12-01",2024
"24-Dec",부산,수영구,164,63451,69800,133415,"2024-12-01",2024
"24-Dec",부산,연제구,1044,124397,27628,153069,"2024-12-01",2024
"24-Dec",부산,영도구,223,31395,2060,33678,"2024-12-01",2024
"24-Dec",부산,중구,309,36576,7087,43972,"2024-12-01",2024
"24-Dec",부산,해운대구,328,158262,5108,163698,"2024-12-01",2024
"24-Dec",부산,계,4882,1364921,189507,1559310,"2024-12-01",2024
"24-Dec",대구,군위군,134,15649,247,16030,"2024-12-01",2024
"24-Dec",대구,남구,403,54898,1559,56860,"2024-12-01",2024
"24-Dec",대구,달서구,487,273573,19989,294049,"2024-12-01",2024
"24-Dec",대구,달성군,585,140813,5205,146603,"2024-12-01",2024
"24-Dec",대구,동구,365,165516,9931,175812,"2024-12-01",2024
"24-Dec",대구,북구,555,202263,8196,211014,"2024-12-01",2024
"24-Dec",대구,서구,265,72025,4885,77175,"2024-12-01",2024
"24-Dec",대구,수성구,604,216842,5219,222665,"2024-12-01",2024
"24-Dec",대구,중구,320,59913,2163,62396,"2024-12-01",2024
"24-Dec",대구,계,3718,1201492,57394,1262604,"2024-12-01",2024
"24-Dec",인천,강화군,360,39459,7027,46846,"2024-12-01",2024
"24-Dec",인천,계양구,303,124737,145709,270749,"2024-12-01",2024
"24-Dec",인천,남동구,1003,259071,23766,283840,"2024-12-01",2024
"24-Dec",인천,동구,108,24508,2780,27396,"2024-12-01",2024
"24-Dec",인천,미추홀구,437,165794,17088,183319,"2024-12-01",2024
"24-Dec",인천,부평구,340,229498,37641,267479,"2024-12-01",2024
"24-Dec",인천,서구,573,309215,13485,323273,"2024-12-01",2024
"24-Dec",인천,연수구,397,225682,10286,236365,"2024-12-01",2024
"24-Dec",인천,옹진군,258,13291,284,13833,"2024-12-01",2024
"24-Dec",인천,중구,647,81914,12266,94827,"2024-12-01",2024
"24-Dec",인천,계,4426,1473169,270332,1747927,"2024-12-01",2024
"24-Dec",광주,광산구,603,206268,13275,220146,"2024-12-01",2024
"24-Dec",광주,남구,239,93789,2755,96783,"2024-12-01",2024
"24-Dec",광주,동구,262,47431,998,48691,"2024-12-01",2024
"24-Dec",광주,북구,614,201951,9668,212233,"2024-12-01",2024
"24-Dec",광주,서구,732,146073,6093,152898,"2024-12-01",2024
"24-Dec",광주,계,2450,695512,32789,730751,"2024-12-01",2024
"24-Dec",대전,대덕구,249,88390,6814,95453,"2024-12-01",2024
"24-Dec",대전,동구,252,93974,5296,99522,"2024-12-01",2024
"24-Dec",대전,서구,850,208344,24557,233751,"2024-12-01",2024
"24-Dec",대전,유성구,689,197773,5723,204185,"2024-12-01",2024
"24-Dec",대전,중구,223,98563,5315,104101,"2024-12-01",2024
"24-Dec",대전,계,2263,687044,47705,737012,"2024-12-01",2024
"24-Dec",울산,남구,757,158200,7248,166205,"2024-12-01",2024
"24-Dec",울산,동구,194,64531,1314,66039,"2024-12-01",2024
"24-Dec",울산,북구,228,124167,3824,128219,"2024-12-01",2024
"24-Dec",울산,울주군,445,133028,7102,140575,"2024-12-01",2024
"24-Dec",울산,중구,352,103480,2611,106443,"2024-12-01",2024
"24-Dec",울산,계,1976,583406,22099,607481,"2024-12-01",2024
"24-Dec",세종,세종특별자치시,967,197269,4021,202257,"2024-12-01",2024
"24-Dec",세종,계,967,197269,4021,202257,"2024-12-01",2024
"24-Dec",경기,가평군,411,33549,627,34587,"2024-12-01",2024
"24-Dec",경기,고양시 덕양구,684,198120,5405,204209,"2024-12-01",2024
"24-Dec",경기,고양시 일산동구,280,131222,6414,137916,"2024-12-01",2024
"24-Dec",경기,고양시 일산서구,130,116928,4703,121761,"2024-12-01",2024
"24-Dec",경기,과천시,724,33496,821,35041,"2024-12-01",2024
"24-Dec",경기,광명시,338,101491,4721,106550,"2024-12-01",2024
"24-Dec",경기,광주시,440,209475,9260,219175,"2024-12-01",2024
"24-Dec",경기,구리시,283,71954,2904,75141,"2024-12-01",2024
"24-Dec",경기,군포시,307,98667,5146,104120,"2024-12-01",2024
"24-Dec",경기,김포시,574,240104,10059,250737,"2024-12-01",2024
"24-Dec",경기,남양주시,812,321268,10321,332401,"2024-12-01",2024
"24-Dec",경기,동두천시,236,38435,1460,40131,"2024-12-01",2024
"24-Dec",경기,부천시,6,263,20,289,"2024-12-01",2024
"24-Dec",경기,부천시 소사구,100,83879,3290,87269,"2024-12-01",2024
"24-Dec",경기,부천시 오정구,104,63425,3306,66835,"2024-12-01",2024
"24-Dec",경기,부천시 원미구,520,148688,6865,156073,"2024-12-01",2024
"24-Dec",경기,성남시 분당구,371,189712,7902,197985,"2024-12-01",2024
"24-Dec",경기,성남시 수정구,302,81545,3551,85398,"2024-12-01",2024
"24-Dec",경기,성남시 중원구,393,74173,4076,78642,"2024-12-01",2024
"24-Dec",경기,수원시 권선구,452,212191,10122,222765,"2024-12-01",2024
"24-Dec",경기,수원시 영통구,445,152500,3817,156762,"2024-12-01",2024
"24-Dec",경기,수원시 장안구,509,110053,3810,114372,"2024-12-01",2024
"24-Dec",경기,수원시 팔달구,324,81721,3493,85538,"2024-12-01",2024
"24-Dec",경기,시흥시,467,272142,9276,281885,"2024-12-01",2024
"24-Dec",경기,안산시 단원구,590,166136,7866,174592,"2024-12-01",2024
"24-Dec",경기,안산시 상록구,164,144797,5975,150936,"2024-12-01",2024
"24-Dec",경기,안성시,419,118278,4929,123626,"2024-12-01",2024
"24-Dec",경기,안양시 동안구,395,130651,6892,137938,"2024-12-01",2024
"24-Dec",경기,안양시 만안구,158,86296,3973,90427,"2024-12-01",2024
"24-Dec",경기,양주시,461,142732,4468,147661,"2024-12-01",2024
"24-Dec",경기,양평군,605,67938,1909,70452,"2024-12-01",2024
"24-Dec",경기,여주시,479,70264,7814,78557,"2024-12-01",2024
"24-Dec",경기,연천군,320,24805,4935,30060,"2024-12-01",2024
"24-Dec",경기,오산시,233,122141,4525,126899,"2024-12-01",2024
"24-Dec",경기,용인시 기흥구,157,201295,8094,209546,"2024-12-01",2024
"24-Dec",경기,용인시 수지구,67,151236,2292,153595,"2024-12-01",2024
"24-Dec",경기,용인시 처인구,820,150506,8423,159749,"2024-12-01",2024
"24-Dec",경기,의왕시,308,66046,2948,69302,"2024-12-01",2024
"24-Dec",경기,의정부시,768,175610,5780,182158,"2024-12-01",2024
"24-Dec",경기,이천시,443,125786,6676,132905,"2024-12-01",2024
"24-Dec",경기,파주시,565,252075,12192,264832,"2024-12-01",2024
"24-Dec",경기,평택시,802,336049,14599,351450,"2024-12-01",2024
"24-Dec",경기,포천시,429,90436,9441,100306,"2024-12-01",2024
"24-Dec",경기,하남시,451,141342,3756,145549,"2024-12-01",2024
"24-Dec",경기,화성시,981,533867,14548,549396,"2024-12-01",2024
"24-Dec",경기,계,18827,6363287,263404,6645518,"2024-12-01",2024
"24-Dec",충북,괴산군,221,24351,455,25027,"2024-12-01",2024
"24-Dec",충북,단양군,243,16569,830,17642,"2024-12-01",2024
"24-Dec",충북,보은군,254,19287,729,20270,"2024-12-01",2024
"24-Dec",충북,영동군,285,26540,426,27251,"2024-12-01",2024
"24-Dec",충북,옥천군,226,29133,1038,30397,"2024-12-01",2024
"24-Dec",충북,음성군,275,64099,2100,66474,"2024-12-01",2024
"24-Dec",충북,제천시,353,70529,3472,74354,"2024-12-01",2024
"24-Dec",충북,증평군,98,21072,825,21995,"2024-12-01",2024
"24-Dec",충북,진천군,229,56521,1571,58321,"2024-12-01",2024
"24-Dec",충북,청원군,1,19,0,20,"2024-12-01",2024
"24-Dec",충북,청주시 상당구,517,102552,2847,105916,"2024-12-01",2024
"24-Dec",충북,청주시 서원구,258,95880,4583,100721,"2024-12-01",2024
"24-Dec",충북,청주시 청원구,437,109660,5284,115381,"2024-12-01",2024
"24-Dec",충북,청주시 흥덕구,369,151221,7954,159544,"2024-12-01",2024
"24-Dec",충북,충주시,639,118381,7170,126190,"2024-12-01",2024
"24-Dec",충북,계,4405,905814,39284,949503,"2024-12-01",2024
"24-Dec",충남,계룡시,181,26316,622,27119,"2024-12-01",2024
"24-Dec",충남,공주시,621,57040,2311,59972,"2024-12-01",2024
"24-Dec",충남,금산군,222,30381,2872,33475,"2024-12-01",2024
"24-Dec",충남,논산시,415,63277,2338,66030,"2024-12-01",2024
"24-Dec",충남,당진시,428,108612,4297,113337,"2024-12-01",2024
"24-Dec",충남,보령시,418,54685,1419,56522,"2024-12-01",2024
"24-Dec",충남,부여군,340,35496,959,36795,"2024-12-01",2024
"24-Dec",충남,서산시,451,103829,3741,108021,"2024-12-01",2024
"24-Dec",충남,서천군,243,28162,784,29189,"2024-12-01",2024
"24-Dec",충남,아산시,576,204271,6714,211561,"2024-12-01",2024
"24-Dec",충남,예산군,472,48194,1461,50127,"2024-12-01",2024
"24-Dec",충남,천안시 동남구,295,144028,5807,150130,"2024-12-01",2024
"24-Dec",충남,천안시 서북구,559,208916,5496,214971,"2024-12-01",2024
"24-Dec",충남,청양군,277,17973,707,18957,"2024-12-01",2024
"24-Dec",충남,태안군,352,36599,619,37570,"2024-12-01",2024
"24-Dec",충남,홍성군,419,57277,1482,59178,"2024-12-01",2024
"24-Dec",충남,계,6269,1225056,41629,1272954,"2024-12-01",2024
"24-Dec",전남,강진군,257,19575,1018,20850,"2024-12-01",2024
"24-Dec",전남,고흥군,335,34845,550,35730,"2024-12-01",2024
"24-Dec",전남,곡성군,186,16178,610,16974,"2024-12-01",2024
"24-Dec",전남,광양시,266,95661,6135,102062,"2024-12-01",2024
"24-Dec",전남,구례군,179,13656,668,14503,"2024-12-01",2024
"24-Dec",전남,나주시,495,70701,3132,74328,"2024-12-01",2024
"24-Dec",전남,담양군,212,29144,1862,31218,"2024-12-01",2024
"24-Dec",전남,목포시,393,98810,5318,104521,"2024-12-01",2024
"24-Dec",전남,무안군,640,54499,1202,56341,"2024-12-01",2024
"24-Dec",전남,보성군,242,22698,625,23565,"2024-12-01",2024
"24-Dec",전남,순천시,523,150472,5499,156494,"2024-12-01",2024
"24-Dec",전남,신안군,402,24346,107001,131749,"2024-12-01",2024
"24-Dec",전남,여수시,566,138712,7514,146792,"2024-12-01",2024
"24-Dec",전남,영광군,247,30603,867,31717,"2024-12-01",2024
"24-Dec",전남,영암군,285,37219,1090,38594,"2024-12-01",2024
"24-Dec",전남,완도군,303,26702,503,27508,"2024-12-01",2024
"24-Dec",전남,장성군,218,28332,1234,29784,"2024-12-01",2024
"24-Dec",전남,장흥군,275,21089,462,21826,"2024-12-01",2024
"24-Dec",전남,진도군,234,18152,318,18704,"2024-12-01",2024
"24-Dec",전남,함평군,220,19440,5969,25629,"2024-12-01",2024
"24-Dec",전남,해남군,340,41787,89730,131857,"2024-12-01",2024
"24-Dec",전남,화순군,256,34922,2002,37180,"2024-12-01",2024
"24-Dec",전남,계,7074,1027543,243309,1277926,"2024-12-01",2024
"24-Dec",경북,경산시,384,145481,4457,150322,"2024-12-01",2024
"24-Dec",경북,경주시,591,149714,4606,154911,"2024-12-01",2024
"24-Dec",경북,고령군,182,21778,832,22792,"2024-12-01",2024
"24-Dec",경북,구미시,552,224949,7347,232848,"2024-12-01",2024
"24-Dec",경북,군위군,0,45,5,50,"2024-12-01",2024
"24-Dec",경북,김천시,406,78905,2152,81463,"2024-12-01",2024
"24-Dec",경북,문경시,297,38947,879,40123,"2024-12-01",2024
"24-Dec",경북,봉화군,256,18633,196,19085,"2024-12-01",2024
"24-Dec",경북,상주시,435,56372,1877,58684,"2024-12-01",2024
"24-Dec",경북,성주군,219,32578,1317,34114,"2024-12-01",2024
"24-Dec",경북,안동시,834,86839,2651,90324,"2024-12-01",2024
"24-Dec",경북,영덕군,265,19626,299,20190,"2024-12-01",2024
"24-Dec",경북,영양군,151,10327,118,10596,"2024-12-01",2024
"24-Dec",경북,영주시,386,57981,1522,59889,"2024-12-01",2024
"24-Dec",경북,영천시,359,63413,2483,66255,"2024-12-01",2024
"24-Dec",경북,예천군,305,32677,488,33470,"2024-12-01",2024
"24-Dec",경북,울릉군,153,6139,578,6870,"2024-12-01",2024
"24-Dec",경북,울진군,329,28021,362,28712,"2024-12-01",2024
"24-Dec",경북,의성군,303,32835,1115,34253,"2024-12-01",2024
"24-Dec",경북,청도군,233,26503,993,27729,"2024-12-01",2024
"24-Dec",경북,청송군,219,16546,210,16975,"2024-12-01",2024
"24-Dec",경북,칠곡군,305,70989,2488,73782,"2024-12-01",2024
"24-Dec",경북,포항시 남구,446,125612,8055,134113,"2024-12-01",2024
"24-Dec",경북,포항시 북구,390,150614,3880,154884,"2024-12-01",2024
"24-Dec",경북,계,8000,1495524,48910,1552434,"2024-12-01",2024
"24-Dec",경남,거제시,371,111577,2164,114112,"2024-12-01",2024
"24-Dec",경남,거창군,299,35017,802,36118,"2024-12-01",2024
"24-Dec",경남,고성군,232,27979,555,28766,"2024-12-01",2024
"24-Dec",경남,김해시,690,293861,8110,302661,"2024-12-01",2024
"24-Dec",경남,남해군,301,20990,432,21723,"2024-12-01",2024
"24-Dec",경남,밀양시,323,58979,3836,63138,"2024-12-01",2024
"24-Dec",경남,사천시,334,60513,1547,62394,"2024-12-01",2024
"24-Dec",경남,산청군,259,21623,747,22629,"2024-12-01",2024
"24-Dec",경남,양산시,436,182296,10630,193362,"2024-12-01",2024
"24-Dec",경남,의령군,221,15551,792,16564,"2024-12-01",2024
"24-Dec",경남,진주시,658,174774,6707,182139,"2024-12-01",2024
"24-Dec",경남,창녕군,247,36714,770,37731,"2024-12-01",2024
"24-Dec",경남,창원시 마산합포구,362,102383,2936,105681,"2024-12-01",2024
"24-Dec",경남,창원시 마산회원구,156,109358,8490,118004,"2024-12-01",2024
"24-Dec",경남,창원시 성산구,611,159680,19888,180179,"2024-12-01",2024
"24-Dec",경남,창원시 의창구,553,134866,49287,184706,"2024-12-01",2024
"24-Dec",경남,창원시 진해구,227,97646,2174,100047,"2024-12-01",2024
"24-Dec",경남,통영시,313,53715,1324,55352,"2024-12-01",2024
"24-Dec",경남,하동군,246,24680,391,25317,"2024-12-01",2024
"24-Dec",경남,함안군,225,44878,22668,67771,"2024-12-01",2024
"24-Dec",경남,함양군,243,20700,17294,38237,"2024-12-01",2024
"24-Dec",경남,합천군,296,24664,729,25689,"2024-12-01",2024
"24-Dec",경남,계,7603,1812444,162273,1982320,"2024-12-01",2024
"24-Dec",제주,서귀포시,774,107736,1918,110428,"2024-12-01",2024
"24-Dec",제주,제주시,1701,322436,280880,605017,"2024-12-01",2024
"24-Dec",제주,계,2475,430172,282798,715445,"2024-12-01",2024
"24-Dec",강원,강릉시,609,115329,4752,120690,"2024-12-01",2024
"24-Dec",강원,고성군,211,16398,237,16846,"2024-12-01",2024
"24-Dec",강원,동해시,331,48209,1614,50154,"2024-12-01",2024
"24-Dec",강원,삼척시,413,34147,809,35369,"2024-12-01",2024
"24-Dec",강원,속초시,327,40754,1466,42547,"2024-12-01",2024
"24-Dec",강원,양구군,229,12565,157,12951,"2024-12-01",2024
"24-Dec",강원,양양군,224,17217,268,17709,"2024-12-01",2024
"24-Dec",강원,영월군,353,22093,401,22847,"2024-12-01",2024
"24-Dec",강원,원주시,645,193430,5878,199953,"2024-12-01",2024
"24-Dec",강원,인제군,244,20199,293,20736,"2024-12-01",2024
"24-Dec",강원,정선군,382,20981,491,21854,"2024-12-01",2024
"24-Dec",강원,철원군,280,24814,415,25509,"2024-12-01",2024
"24-Dec",강원,춘천시,920,143838,6282,151040,"2024-12-01",2024
"24-Dec",강원,태백시,262,20322,664,21248,"2024-12-01",2024
"24-Dec",강원,평창군,326,27232,493,28051,"2024-12-01",2024
"24-Dec",강원,홍천군,450,41347,1058,42855,"2024-12-01",2024
"24-Dec",강원,화천군,233,13613,176,14022,"2024-12-01",2024
"24-Dec",강원,횡성군,290,29081,903,30274,"2024-12-01",2024
"24-Dec",강원,계,6729,841569,26357,874655,"2024-12-01",2024
"24-Dec",전북,고창군,340,32237,585,33162,"2024-12-01",2024
"24-Dec",전북,군산시,574,139661,6456,146691,"2024-12-01",2024
"24-Dec",전북,김제시,330,49560,1890,51780,"2024-12-01",2024
"24-Dec",전북,남원시,439,43557,1189,45185,"2024-12-01",2024
"24-Dec",전북,무주군,218,13911,403,14532,"2024-12-01",2024
"24-Dec",전북,부안군,295,28539,617,29451,"2024-12-01",2024
"24-Dec",전북,순창군,241,16077,224,16542,"2024-12-01",2024
"24-Dec",전북,완주군,469,61077,3235,64781,"2024-12-01",2024
"24-Dec",전북,익산시,557,143582,5911,150050,"2024-12-01",2024
"24-Dec",전북,임실군,269,15178,422,15869,"2024-12-01",2024
"24-Dec",전북,장수군,237,12700,155,13092,"2024-12-01",2024
"24-Dec",전북,전주시 덕진구,381,175613,7135,183129,"2024-12-01",2024
"24-Dec",전북,전주시 완산구,828,156429,4332,161589,"2024-12-01",2024
"24-Dec",전북,정읍시,394,58009,2966,61369,"2024-12-01",2024
"24-Dec",전북,진안군,288,15085,294,15667,"2024-12-01",2024
"24-Dec",전북,계,5860,961215,35814,1002889,"2024-12-01",2024
